LLPerWijk_ID,LLPerWijk_Jaar,LLPerWijk_Brin,LLPerWijk_WijkNr,LLPerWijk_Onderbouw,LLPerWijk_Bovenbouw,LLPerWijk_Totaal,LLPerWijk_InvoerWie,LLPerWijk_InvoerWanneer
200506RM00102,2005,06RM00,102,4,0,4,eneheuvel,26-09-11
200506RM00103,2005,06RM00,103,2,1,3,eneheuvel,26-09-11
200506RM00105,2005,06RM00,105,2,3,5,eneheuvel,26-09-11
200506RM00106,2005,06RM00,106,1,1,2,eneheuvel,26-09-11
200506RM00108,2005,06RM00,108,4,1,5,eneheuvel,26-09-11
200506RM00109,2005,06RM00,109,0,2,2,eneheuvel,26-09-11
200506RM00202,2005,06RM00,202,6,11,17,eneheuvel,26-09-11
200506RM00206,2005,06RM00,206,4,5,9,eneheuvel,26-09-11
200506RM00207,2005,06RM00,207,3,1,4,eneheuvel,26-09-11
200506RM00208,2005,06RM00,208,2,4,6,eneheuvel,26-09-11
200506RM00210,2005,06RM00,210,5,3,8,eneheuvel,26-09-11
200506RM00211,2005,06RM00,211,5,7,12,eneheuvel,26-09-11
200506RM00212,2005,06RM00,212,37,21,58,eneheuvel,26-09-11
200506RM00213,2005,06RM00,213,10,7,17,eneheuvel,26-09-11
200506RM00214,2005,06RM00,214,17,10,27,eneheuvel,26-09-11
200506RM00215,2005,06RM00,215,4,2,6,eneheuvel,26-09-11
200506RM00216,2005,06RM00,216,1,0,1,eneheuvel,26-09-11
200506RM00302,2005,06RM00,302,4,5,9,eneheuvel,26-09-11
200506RM00303,2005,06RM00,303,5,4,9,eneheuvel,26-09-11
200506RM00304,2005,06RM00,304,1,1,2,eneheuvel,26-09-11
200506RM00306,2005,06RM00,306,1,1,2,eneheuvel,26-09-11
200506RM00307,2005,06RM00,307,1,0,1,eneheuvel,26-09-11
200506RM00309,2005,06RM00,309,4,3,7,eneheuvel,26-09-11
200506RM00311,2005,06RM00,311,2,2,4,eneheuvel,26-09-11
200506RM00312,2005,06RM00,312,1,1,2,eneheuvel,26-09-11
200506RM00502,2005,06RM00,502,4,3,7,eneheuvel,26-09-11
200506RM009999,2005,06RM00,9999,9,7,16,eneheuvel,26-09-11
200512HU00103,2005,12HU00,103,1,0,1,eneheuvel,26-09-11
200512HU00104,2005,12HU00,104,0,1,1,eneheuvel,26-09-11
200512HU00106,2005,12HU00,106,0,1,1,eneheuvel,26-09-11
200512HU00201,2005,12HU00,201,4,10,14,eneheuvel,26-09-11
200512HU00202,2005,12HU00,202,1,2,3,eneheuvel,26-09-11
200512HU00203,2005,12HU00,203,1,0,1,eneheuvel,26-09-11
200512HU00204,2005,12HU00,204,1,2,3,eneheuvel,26-09-11
200512HU00205,2005,12HU00,205,1,0,1,eneheuvel,26-09-11
200512HU00206,2005,12HU00,206,1,3,4,eneheuvel,26-09-11
200512HU00209,2005,12HU00,209,1,3,4,eneheuvel,26-09-11
200512HU00210,2005,12HU00,210,3,2,5,eneheuvel,26-09-11
200512HU00211,2005,12HU00,211,56,46,102,eneheuvel,26-09-11
200512HU00212,2005,12HU00,212,1,1,2,eneheuvel,26-09-11
200512HU00213,2005,12HU00,213,1,2,3,eneheuvel,26-09-11
200512HU00214,2005,12HU00,214,1,0,1,eneheuvel,26-09-11
200512HU00312,2005,12HU00,312,0,1,1,eneheuvel,26-09-11
200512HU009999,2005,12HU00,9999,0,3,3,eneheuvel,26-09-11
200512PM00101,2005,12PM00,101,6,6,12,eneheuvel,26-09-11
200512PM00102,2005,12PM00,102,4,6,10,eneheuvel,26-09-11
200512PM00103,2005,12PM00,103,43,23,66,eneheuvel,26-09-11
200512PM00104,2005,12PM00,104,1,1,2,eneheuvel,26-09-11
200512PM00106,2005,12PM00,106,3,3,6,eneheuvel,26-09-11
200512PM00107,2005,12PM00,107,18,14,32,eneheuvel,26-09-11
200512PM00108,2005,12PM00,108,18,8,26,eneheuvel,26-09-11
200512PM00109,2005,12PM00,109,18,19,37,eneheuvel,26-09-11
200512PM00202,2005,12PM00,202,2,0,2,eneheuvel,26-09-11
200512PM00212,2005,12PM00,212,1,1,2,eneheuvel,26-09-11
200512PM00214,2005,12PM00,214,1,0,1,eneheuvel,26-09-11
200512PM00311,2005,12PM00,311,3,0,3,eneheuvel,26-09-11
200512PM009999,2005,12PM00,9999,0,2,2,eneheuvel,26-09-11
200512QK00104,2005,12QK00,104,1,0,1,eneheuvel,26-09-11
200512QK00202,2005,12QK00,202,2,0,2,eneheuvel,26-09-11
200512QK00204,2005,12QK00,204,0,2,2,eneheuvel,26-09-11
200512QK00205,2005,12QK00,205,0,3,3,eneheuvel,26-09-11
200512QK00206,2005,12QK00,206,100,117,217,eneheuvel,26-09-11
200512QK00207,2005,12QK00,207,3,1,4,eneheuvel,26-09-11
200512QK00208,2005,12QK00,208,2,5,7,eneheuvel,26-09-11
200512QK00209,2005,12QK00,209,4,4,8,eneheuvel,26-09-11
200512QK00210,2005,12QK00,210,9,6,15,eneheuvel,26-09-11
200512QK00212,2005,12QK00,212,1,1,2,eneheuvel,26-09-11
200512QK00213,2005,12QK00,213,1,1,2,eneheuvel,26-09-11
200512QK00215,2005,12QK00,215,11,17,28,eneheuvel,26-09-11
200512QK00216,2005,12QK00,216,1,0,1,eneheuvel,26-09-11
200512QK00303,2005,12QK00,303,1,0,1,eneheuvel,26-09-11
200512QK00305,2005,12QK00,305,0,1,1,eneheuvel,26-09-11
200512QK00308,2005,12QK00,308,1,1,2,eneheuvel,26-09-11
200512QK00309,2005,12QK00,309,1,1,2,eneheuvel,26-09-11
200512QK00311,2005,12QK00,311,1,1,2,eneheuvel,26-09-11
200512QK00502,2005,12QK00,502,0,1,1,eneheuvel,26-09-11
200512XA00201,2005,12XA00,201,1,1,2,eneheuvel,26-09-11
200512XA00211,2005,12XA00,211,71,47,118,eneheuvel,26-09-11
200512XA00213,2005,12XA00,213,0,1,1,eneheuvel,26-09-11
200512XA00309,2005,12XA00,309,0,1,1,eneheuvel,26-09-11
200513CW00201,2005,13CW00,201,1,0,1,eneheuvel,26-09-11
200513CW00205,2005,13CW00,205,6,2,8,eneheuvel,26-09-11
200513CW00206,2005,13CW00,206,79,72,151,eneheuvel,26-09-11
200513CW00207,2005,13CW00,207,5,1,6,eneheuvel,26-09-11
200513CW00208,2005,13CW00,208,1,1,2,eneheuvel,26-09-11
200513CW00209,2005,13CW00,209,9,7,16,eneheuvel,26-09-11
200513CW00210,2005,13CW00,210,7,13,20,eneheuvel,26-09-11
200513CW00211,2005,13CW00,211,1,0,1,eneheuvel,26-09-11
200513CW00212,2005,13CW00,212,0,3,3,eneheuvel,26-09-11
200513CW00215,2005,13CW00,215,13,11,24,eneheuvel,26-09-11
200513CW00216,2005,13CW00,216,1,0,1,eneheuvel,26-09-11
200513CW00302,2005,13CW00,302,0,1,1,eneheuvel,26-09-11
200513CW00305,2005,13CW00,305,0,1,1,eneheuvel,26-09-11
200513CW009999,2005,13CW00,9999,3,0,3,eneheuvel,26-09-11
200513IF00105,2005,13IF00,105,3,2,5,eneheuvel,26-09-11
200513IF00208,2005,13IF00,208,0,1,1,eneheuvel,26-09-11
200513IF00211,2005,13IF00,211,0,1,1,eneheuvel,26-09-11
200513IF00301,2005,13IF00,301,8,5,13,eneheuvel,26-09-11
200513IF00302,2005,13IF00,302,1,3,4,eneheuvel,26-09-11
200513IF00303,2005,13IF00,303,13,9,22,eneheuvel,26-09-11
200513IF00304,2005,13IF00,304,43,23,66,eneheuvel,26-09-11
200513IF00305,2005,13IF00,305,17,19,36,eneheuvel,26-09-11
200513IF00306,2005,13IF00,306,8,11,19,eneheuvel,26-09-11
200513IF00307,2005,13IF00,307,0,2,2,eneheuvel,26-09-11
200513IF00308,2005,13IF00,308,0,2,2,eneheuvel,26-09-11
200513IF00309,2005,13IF00,309,1,2,3,eneheuvel,26-09-11
200513IF00311,2005,13IF00,311,0,1,1,eneheuvel,26-09-11
200513IF009999,2005,13IF00,9999,0,1,1,eneheuvel,26-09-11
200513IU00101,2005,13IU00,101,1,1,2,eneheuvel,26-09-11
200513IU00102,2005,13IU00,102,8,6,14,eneheuvel,26-09-11
200513IU00103,2005,13IU00,103,6,2,8,eneheuvel,26-09-11
200513IU00104,2005,13IU00,104,1,0,1,eneheuvel,26-09-11
200513IU00105,2005,13IU00,105,2,4,6,eneheuvel,26-09-11
200513IU00106,2005,13IU00,106,48,38,86,eneheuvel,26-09-11
200513IU00107,2005,13IU00,107,6,4,10,eneheuvel,26-09-11
200513IU00108,2005,13IU00,108,4,2,6,eneheuvel,26-09-11
200513IU00109,2005,13IU00,109,1,2,3,eneheuvel,26-09-11
200513IU00203,2005,13IU00,203,0,1,1,eneheuvel,26-09-11
200513IU00205,2005,13IU00,205,1,0,1,eneheuvel,26-09-11
200513IU00211,2005,13IU00,211,1,1,2,eneheuvel,26-09-11
200513IU00308,2005,13IU00,308,0,1,1,eneheuvel,26-09-11
200513IU00309,2005,13IU00,309,1,1,2,eneheuvel,26-09-11
200513IU00311,2005,13IU00,311,0,1,1,eneheuvel,26-09-11
200513IU009999,2005,13IU00,9999,1,4,5,eneheuvel,26-09-11
200513NH00101,2005,13NH00,101,3,1,4,eneheuvel,26-09-11
200513NH00102,2005,13NH00,102,7,10,17,eneheuvel,26-09-11
200513NH00103,2005,13NH00,103,1,0,1,eneheuvel,26-09-11
200513NH00104,2005,13NH00,104,16,19,35,eneheuvel,26-09-11
200513NH00105,2005,13NH00,105,57,55,112,eneheuvel,26-09-11
200513NH00106,2005,13NH00,106,3,7,10,eneheuvel,26-09-11
200513NH00107,2005,13NH00,107,2,5,7,eneheuvel,26-09-11
200513NH00108,2005,13NH00,108,0,1,1,eneheuvel,26-09-11
200513NH00109,2005,13NH00,109,0,1,1,eneheuvel,26-09-11
200513NH00110,2005,13NH00,110,1,4,5,eneheuvel,26-09-11
200513NH00202,2005,13NH00,202,0,3,3,eneheuvel,26-09-11
200513NH00203,2005,13NH00,203,1,0,1,eneheuvel,26-09-11
200513NH00213,2005,13NH00,213,1,0,1,eneheuvel,26-09-11
200513NH00303,2005,13NH00,303,1,0,1,eneheuvel,26-09-11
200513NH009999,2005,13NH00,9999,1,1,2,eneheuvel,26-09-11
200513NU00205,2005,13NU00,205,0,1,1,eneheuvel,26-09-11
200513NU00207,2005,13NU00,207,1,0,1,eneheuvel,26-09-11
200513NU00208,2005,13NU00,208,1,2,3,eneheuvel,26-09-11
200513NU00210,2005,13NU00,210,1,0,1,eneheuvel,26-09-11
200513NU00211,2005,13NU00,211,1,0,1,eneheuvel,26-09-11
200513NU00213,2005,13NU00,213,1,0,1,eneheuvel,26-09-11
200513NU00214,2005,13NU00,214,1,0,1,eneheuvel,26-09-11
200513NU00301,2005,13NU00,301,12,7,19,eneheuvel,26-09-11
200513NU00302,2005,13NU00,302,0,3,3,eneheuvel,26-09-11
200513NU00303,2005,13NU00,303,38,38,76,eneheuvel,26-09-11
200513NU00304,2005,13NU00,304,67,69,136,eneheuvel,26-09-11
200513NU00305,2005,13NU00,305,15,13,28,eneheuvel,26-09-11
200513NU00306,2005,13NU00,306,8,12,20,eneheuvel,26-09-11
200513NU00307,2005,13NU00,307,1,2,3,eneheuvel,26-09-11
200513NU00308,2005,13NU00,308,3,10,13,eneheuvel,26-09-11
200513NU00309,2005,13NU00,309,0,8,8,eneheuvel,26-09-11
200513NU00311,2005,13NU00,311,1,1,2,eneheuvel,26-09-11
200513NU00502,2005,13NU00,502,0,1,1,eneheuvel,26-09-11
200513NU009999,2005,13NU00,9999,1,1,2,eneheuvel,26-09-11
200514QC00102,2005,14QC00,102,0,1,1,eneheuvel,26-09-11
200514QC00108,2005,14QC00,108,0,1,1,eneheuvel,26-09-11
200514QC00109,2005,14QC00,109,3,0,3,eneheuvel,26-09-11
200514QC00201,2005,14QC00,201,3,1,4,eneheuvel,26-09-11
200514QC00202,2005,14QC00,202,56,70,126,eneheuvel,26-09-11
200514QC00203,2005,14QC00,203,60,38,98,eneheuvel,26-09-11
200514QC00204,2005,14QC00,204,26,26,52,eneheuvel,26-09-11
200514QC00205,2005,14QC00,205,11,12,23,eneheuvel,26-09-11
200514QC00206,2005,14QC00,206,6,2,8,eneheuvel,26-09-11
200514QC00207,2005,14QC00,207,9,6,15,eneheuvel,26-09-11
200514QC00208,2005,14QC00,208,16,15,31,eneheuvel,26-09-11
200514QC00210,2005,14QC00,210,5,1,6,eneheuvel,26-09-11
200514QC00211,2005,14QC00,211,3,1,4,eneheuvel,26-09-11
200514QC00212,2005,14QC00,212,2,7,9,eneheuvel,26-09-11
200514QC00213,2005,14QC00,213,1,0,1,eneheuvel,26-09-11
200514QC00214,2005,14QC00,214,3,6,9,eneheuvel,26-09-11
200514QC00215,2005,14QC00,215,1,1,2,eneheuvel,26-09-11
200514QC00216,2005,14QC00,216,1,0,1,eneheuvel,26-09-11
200514QC00301,2005,14QC00,301,1,0,1,eneheuvel,26-09-11
200514QC00302,2005,14QC00,302,3,6,9,eneheuvel,26-09-11
200514QC00303,2005,14QC00,303,1,1,2,eneheuvel,26-09-11
200514QC00304,2005,14QC00,304,2,0,2,eneheuvel,26-09-11
200514QC00307,2005,14QC00,307,2,1,3,eneheuvel,26-09-11
200514QC00309,2005,14QC00,309,3,1,4,eneheuvel,26-09-11
200514QC00310,2005,14QC00,310,2,0,2,eneheuvel,26-09-11
200514QC00311,2005,14QC00,311,2,1,3,eneheuvel,26-09-11
200514QC00312,2005,14QC00,312,1,0,1,eneheuvel,26-09-11
200514QC00502,2005,14QC00,502,14,9,23,eneheuvel,26-09-11
200514QC009999,2005,14QC00,9999,1,2,3,eneheuvel,26-09-11
200515SJ00102,2005,15SJ00,102,1,0,1,eneheuvel,26-09-11
200515SJ00103,2005,15SJ00,103,1,0,1,eneheuvel,26-09-11
200515SJ00104,2005,15SJ00,104,1,0,1,eneheuvel,26-09-11
200515SJ00108,2005,15SJ00,108,1,0,1,eneheuvel,26-09-11
200515SJ00201,2005,15SJ00,201,1,0,1,eneheuvel,26-09-11
200515SJ00202,2005,15SJ00,202,2,0,2,eneheuvel,26-09-11
200515SJ00204,2005,15SJ00,204,2,0,2,eneheuvel,26-09-11
200515SJ00205,2005,15SJ00,205,1,0,1,eneheuvel,26-09-11
200515SJ00206,2005,15SJ00,206,6,0,6,eneheuvel,26-09-11
200515SJ00208,2005,15SJ00,208,2,0,2,eneheuvel,26-09-11
200515SJ00209,2005,15SJ00,209,4,0,4,eneheuvel,26-09-11
200515SJ00210,2005,15SJ00,210,6,0,6,eneheuvel,26-09-11
200515SJ00211,2005,15SJ00,211,4,0,4,eneheuvel,26-09-11
200515SJ00212,2005,15SJ00,212,4,0,4,eneheuvel,26-09-11
200515SJ00214,2005,15SJ00,214,1,0,1,eneheuvel,26-09-11
200515SJ00302,2005,15SJ00,302,2,0,2,eneheuvel,26-09-11
200515SJ00303,2005,15SJ00,303,2,0,2,eneheuvel,26-09-11
200515SJ00304,2005,15SJ00,304,1,0,1,eneheuvel,26-09-11
200515SJ00305,2005,15SJ00,305,2,0,2,eneheuvel,26-09-11
200515SJ00307,2005,15SJ00,307,1,0,1,eneheuvel,26-09-11
200515ZL00105,2005,15ZL00,105,0,1,1,eneheuvel,26-09-11
200515ZL00202,2005,15ZL00,202,0,2,2,eneheuvel,26-09-11
200515ZL00205,2005,15ZL00,205,1,0,1,eneheuvel,26-09-11
200515ZL00206,2005,15ZL00,206,2,3,5,eneheuvel,26-09-11
200515ZL00207,2005,15ZL00,207,1,5,6,eneheuvel,26-09-11
200515ZL00208,2005,15ZL00,208,1,3,4,eneheuvel,26-09-11
200515ZL00210,2005,15ZL00,210,0,1,1,eneheuvel,26-09-11
200515ZL00211,2005,15ZL00,211,2,0,2,eneheuvel,26-09-11
200515ZL00215,2005,15ZL00,215,0,1,1,eneheuvel,26-09-11
200515ZL00302,2005,15ZL00,302,1,5,6,eneheuvel,26-09-11
200515ZL00303,2005,15ZL00,303,4,7,11,eneheuvel,26-09-11
200515ZL00304,2005,15ZL00,304,2,4,6,eneheuvel,26-09-11
200515ZL00305,2005,15ZL00,305,47,46,93,eneheuvel,26-09-11
200515ZL00306,2005,15ZL00,306,10,19,29,eneheuvel,26-09-11
200515ZL00307,2005,15ZL00,307,1,4,5,eneheuvel,26-09-11
200515ZL00308,2005,15ZL00,308,4,0,4,eneheuvel,26-09-11
200515ZL00309,2005,15ZL00,309,7,8,15,eneheuvel,26-09-11
200515ZL00311,2005,15ZL00,311,2,0,2,eneheuvel,26-09-11
200515ZL00312,2005,15ZL00,312,1,1,2,eneheuvel,26-09-11
200515ZL009999,2005,15ZL00,9999,0,2,2,eneheuvel,26-09-11
200515ZL01106,2005,15ZL01,106,1,0,1,eneheuvel,26-09-11
200515ZL01202,2005,15ZL01,202,2,1,3,eneheuvel,26-09-11
200515ZL01206,2005,15ZL01,206,1,2,3,eneheuvel,26-09-11
200515ZL01207,2005,15ZL01,207,1,0,1,eneheuvel,26-09-11
200515ZL01209,2005,15ZL01,209,7,5,12,eneheuvel,26-09-11
200515ZL01210,2005,15ZL01,210,78,61,139,eneheuvel,26-09-11
200515ZL01212,2005,15ZL01,212,0,4,4,eneheuvel,26-09-11
200515ZL01213,2005,15ZL01,213,1,0,1,eneheuvel,26-09-11
200515ZL01214,2005,15ZL01,214,1,1,2,eneheuvel,26-09-11
200515ZL01215,2005,15ZL01,215,3,8,11,eneheuvel,26-09-11
200515ZL01305,2005,15ZL01,305,0,1,1,eneheuvel,26-09-11
200515ZL019999,2005,15ZL01,9999,1,2,3,eneheuvel,26-09-11
200516CK00106,2005,16CK00,106,1,0,1,eneheuvel,26-09-11
200516CK00202,2005,16CK00,202,3,0,3,eneheuvel,26-09-11
200516CK00203,2005,16CK00,203,1,0,1,eneheuvel,26-09-11
200516CK00204,2005,16CK00,204,1,0,1,eneheuvel,26-09-11
200516CK00205,2005,16CK00,205,2,0,2,eneheuvel,26-09-11
200516CK00208,2005,16CK00,208,1,0,1,eneheuvel,26-09-11
200516CK00209,2005,16CK00,209,2,0,2,eneheuvel,26-09-11
200516CK00210,2005,16CK00,210,1,0,1,eneheuvel,26-09-11
200516CK00211,2005,16CK00,211,1,0,1,eneheuvel,26-09-11
200516CK00302,2005,16CK00,302,2,0,2,eneheuvel,26-09-11
200516CK00304,2005,16CK00,304,4,0,4,eneheuvel,26-09-11
200516CK00305,2005,16CK00,305,2,0,2,eneheuvel,26-09-11
200516CK00306,2005,16CK00,306,2,0,2,eneheuvel,26-09-11
200516CK00308,2005,16CK00,308,1,0,1,eneheuvel,26-09-11
200516CK00309,2005,16CK00,309,2,0,2,eneheuvel,26-09-11
200516CK00311,2005,16CK00,311,3,0,3,eneheuvel,26-09-11
200516CK009999,2005,16CK00,9999,2,0,2,eneheuvel,26-09-11
200516KK00101,2005,16KK00,101,17,12,29,eneheuvel,26-09-11
200516KK00102,2005,16KK00,102,47,47,94,eneheuvel,26-09-11
200516KK00103,2005,16KK00,103,62,43,105,eneheuvel,26-09-11
200516KK00104,2005,16KK00,104,1,3,4,eneheuvel,26-09-11
200516KK00105,2005,16KK00,105,5,1,6,eneheuvel,26-09-11
200516KK00106,2005,16KK00,106,2,6,8,eneheuvel,26-09-11
200516KK00107,2005,16KK00,107,17,16,33,eneheuvel,26-09-11
200516KK00108,2005,16KK00,108,25,35,60,eneheuvel,26-09-11
200516KK00109,2005,16KK00,109,23,16,39,eneheuvel,26-09-11
200516KK00110,2005,16KK00,110,2,0,2,eneheuvel,26-09-11
200516KK00202,2005,16KK00,202,4,0,4,eneheuvel,26-09-11
200516KK00203,2005,16KK00,203,2,0,2,eneheuvel,26-09-11
200516KK00207,2005,16KK00,207,3,0,3,eneheuvel,26-09-11
200516KK00208,2005,16KK00,208,1,0,1,eneheuvel,26-09-11
200516KK00210,2005,16KK00,210,1,0,1,eneheuvel,26-09-11
200516KK00211,2005,16KK00,211,2,2,4,eneheuvel,26-09-11
200516KK00213,2005,16KK00,213,2,0,2,eneheuvel,26-09-11
200516KK00214,2005,16KK00,214,3,1,4,eneheuvel,26-09-11
200516KK00303,2005,16KK00,303,2,0,2,eneheuvel,26-09-11
200516KK00305,2005,16KK00,305,2,0,2,eneheuvel,26-09-11
200516KK00306,2005,16KK00,306,1,0,1,eneheuvel,26-09-11
200516KK00309,2005,16KK00,309,0,1,1,eneheuvel,26-09-11
200516KK00311,2005,16KK00,311,1,1,2,eneheuvel,26-09-11
200516KK00502,2005,16KK00,502,2,2,4,eneheuvel,26-09-11
200516KK009999,2005,16KK00,9999,2,0,2,eneheuvel,26-09-11
200516LJ00101,2005,16LJ00,101,2,2,4,eneheuvel,26-09-11
200516LJ00102,2005,16LJ00,102,3,3,6,eneheuvel,26-09-11
200516LJ00103,2005,16LJ00,103,1,2,3,eneheuvel,26-09-11
200516LJ00104,2005,16LJ00,104,2,5,7,eneheuvel,26-09-11
200516LJ00105,2005,16LJ00,105,0,1,1,eneheuvel,26-09-11
200516LJ00106,2005,16LJ00,106,53,45,98,eneheuvel,26-09-11
200516LJ00107,2005,16LJ00,107,6,3,9,eneheuvel,26-09-11
200516LJ00108,2005,16LJ00,108,5,6,11,eneheuvel,26-09-11
200516LJ00109,2005,16LJ00,109,1,1,2,eneheuvel,26-09-11
200516LJ00202,2005,16LJ00,202,0,3,3,eneheuvel,26-09-11
200516LJ00203,2005,16LJ00,203,1,0,1,eneheuvel,26-09-11
200516LJ00204,2005,16LJ00,204,0,1,1,eneheuvel,26-09-11
200516LJ00205,2005,16LJ00,205,0,1,1,eneheuvel,26-09-11
200516LJ00207,2005,16LJ00,207,0,1,1,eneheuvel,26-09-11
200516LJ00211,2005,16LJ00,211,0,2,2,eneheuvel,26-09-11
200516LJ00213,2005,16LJ00,213,1,0,1,eneheuvel,26-09-11
200516LJ00302,2005,16LJ00,302,0,1,1,eneheuvel,26-09-11
200516LJ00305,2005,16LJ00,305,0,1,1,eneheuvel,26-09-11
200516LJ00308,2005,16LJ00,308,0,1,1,eneheuvel,26-09-11
200516LJ009999,2005,16LJ00,9999,0,2,2,eneheuvel,26-09-11
200516ML00101,2005,16ML00,101,1,7,8,eneheuvel,26-09-11
200516ML00102,2005,16ML00,102,22,19,41,eneheuvel,26-09-11
200516ML00103,2005,16ML00,103,1,1,2,eneheuvel,26-09-11
200516ML00104,2005,16ML00,104,58,72,130,eneheuvel,26-09-11
200516ML00105,2005,16ML00,105,31,34,65,eneheuvel,26-09-11
200516ML00106,2005,16ML00,106,1,2,3,eneheuvel,26-09-11
200516ML00107,2005,16ML00,107,2,1,3,eneheuvel,26-09-11
200516ML00108,2005,16ML00,108,0,4,4,eneheuvel,26-09-11
200516ML00109,2005,16ML00,109,2,5,7,eneheuvel,26-09-11
200516ML00110,2005,16ML00,110,1,1,2,eneheuvel,26-09-11
200516ML00202,2005,16ML00,202,0,1,1,eneheuvel,26-09-11
200516ML00203,2005,16ML00,203,1,0,1,eneheuvel,26-09-11
200516ML00205,2005,16ML00,205,1,0,1,eneheuvel,26-09-11
200516ML00207,2005,16ML00,207,0,1,1,eneheuvel,26-09-11
200516ML00209,2005,16ML00,209,0,1,1,eneheuvel,26-09-11
200516ML00210,2005,16ML00,210,0,2,2,eneheuvel,26-09-11
200516ML00212,2005,16ML00,212,3,0,3,eneheuvel,26-09-11
200516ML00214,2005,16ML00,214,2,0,2,eneheuvel,26-09-11
200516ML00302,2005,16ML00,302,2,0,2,eneheuvel,26-09-11
200516ML00303,2005,16ML00,303,1,1,2,eneheuvel,26-09-11
200516ML00306,2005,16ML00,306,1,1,2,eneheuvel,26-09-11
200516ML00309,2005,16ML00,309,0,2,2,eneheuvel,26-09-11
200516ML00502,2005,16ML00,502,1,0,1,eneheuvel,26-09-11
200516ML009999,2005,16ML00,9999,1,0,1,eneheuvel,26-09-11
200516OC00101,2005,16OC00,101,1,0,1,eneheuvel,26-09-11
200516OC00102,2005,16OC00,102,0,1,1,eneheuvel,26-09-11
200516OC00103,2005,16OC00,103,3,5,8,eneheuvel,26-09-11
200516OC00104,2005,16OC00,104,0,1,1,eneheuvel,26-09-11
200516OC00105,2005,16OC00,105,1,1,2,eneheuvel,26-09-11
200516OC00106,2005,16OC00,106,1,0,1,eneheuvel,26-09-11
200516OC00107,2005,16OC00,107,69,81,150,eneheuvel,26-09-11
200516OC00108,2005,16OC00,108,16,21,37,eneheuvel,26-09-11
200516OC00109,2005,16OC00,109,43,47,90,eneheuvel,26-09-11
200516OC00202,2005,16OC00,202,0,1,1,eneheuvel,26-09-11
200516OC00207,2005,16OC00,207,1,0,1,eneheuvel,26-09-11
200516OC00208,2005,16OC00,208,0,2,2,eneheuvel,26-09-11
200516OC00209,2005,16OC00,209,0,2,2,eneheuvel,26-09-11
200516OC00210,2005,16OC00,210,0,1,1,eneheuvel,26-09-11
200516OC00212,2005,16OC00,212,0,1,1,eneheuvel,26-09-11
200516OC00214,2005,16OC00,214,1,1,2,eneheuvel,26-09-11
200516OC00302,2005,16OC00,302,1,0,1,eneheuvel,26-09-11
200516OC00307,2005,16OC00,307,1,1,2,eneheuvel,26-09-11
200516OC00308,2005,16OC00,308,0,1,1,eneheuvel,26-09-11
200516OC00311,2005,16OC00,311,1,2,3,eneheuvel,26-09-11
200516UK00101,2005,16UK00,101,2,1,3,eneheuvel,26-09-11
200516UK00102,2005,16UK00,102,1,3,4,eneheuvel,26-09-11
200516UK00103,2005,16UK00,103,6,12,18,eneheuvel,26-09-11
200516UK00107,2005,16UK00,107,0,1,1,eneheuvel,26-09-11
200516UK00108,2005,16UK00,108,63,64,127,eneheuvel,26-09-11
200516UK00109,2005,16UK00,109,1,4,5,eneheuvel,26-09-11
200516UK00207,2005,16UK00,207,1,0,1,eneheuvel,26-09-11
200516UK00210,2005,16UK00,210,0,1,1,eneheuvel,26-09-11
200516UK00306,2005,16UK00,306,0,1,1,eneheuvel,26-09-11
200516UK009999,2005,16UK00,9999,1,6,7,eneheuvel,26-09-11
200516WV00201,2005,16WV00,201,4,5,9,eneheuvel,26-09-11
200516WV00202,2005,16WV00,202,0,1,1,eneheuvel,26-09-11
200516WV00205,2005,16WV00,205,0,1,1,eneheuvel,26-09-11
200516WV00209,2005,16WV00,209,15,17,32,eneheuvel,26-09-11
200516WV00210,2005,16WV00,210,1,3,4,eneheuvel,26-09-11
200516WV00211,2005,16WV00,211,49,64,113,eneheuvel,26-09-11
200516WV00305,2005,16WV00,305,1,0,1,eneheuvel,26-09-11
200516YS00201,2005,16YS00,201,9,9,18,eneheuvel,26-09-11
200516YS00208,2005,16YS00,208,1,0,1,eneheuvel,26-09-11
200516YS00209,2005,16YS00,209,0,1,1,eneheuvel,26-09-11
200516YS00210,2005,16YS00,210,0,1,1,eneheuvel,26-09-11
200516YS00211,2005,16YS00,211,86,67,153,eneheuvel,26-09-11
200516YS00212,2005,16YS00,212,0,4,4,eneheuvel,26-09-11
200516YS00213,2005,16YS00,213,1,0,1,eneheuvel,26-09-11
200516YS00303,2005,16YS00,303,0,1,1,eneheuvel,26-09-11
200516YS00311,2005,16YS00,311,0,1,1,eneheuvel,26-09-11
200516YS00312,2005,16YS00,312,1,0,1,eneheuvel,26-09-11
200516YS009999,2005,16YS00,9999,0,1,1,eneheuvel,26-09-11
200516ZG00102,2005,16ZG00,102,0,1,1,eneheuvel,26-09-11
200516ZG00206,2005,16ZG00,206,1,1,2,eneheuvel,26-09-11
200516ZG00208,2005,16ZG00,208,1,0,1,eneheuvel,26-09-11
200516ZG00210,2005,16ZG00,210,1,0,1,eneheuvel,26-09-11
200516ZG00211,2005,16ZG00,211,90,81,171,eneheuvel,26-09-11
200516ZG00212,2005,16ZG00,212,3,1,4,eneheuvel,26-09-11
200516ZG00214,2005,16ZG00,214,0,1,1,eneheuvel,26-09-11
200516ZG00303,2005,16ZG00,303,0,1,1,eneheuvel,26-09-11
200516ZG00308,2005,16ZG00,308,1,0,1,eneheuvel,26-09-11
200516ZG00309,2005,16ZG00,309,1,0,1,eneheuvel,26-09-11
200516ZG00311,2005,16ZG00,311,0,1,1,eneheuvel,26-09-11
200516ZG009999,2005,16ZG00,9999,1,0,1,eneheuvel,26-09-11
200516ZX00108,2005,16ZX00,108,1,1,2,eneheuvel,26-09-11
200516ZX00201,2005,16ZX00,201,2,1,3,eneheuvel,26-09-11
200516ZX00204,2005,16ZX00,204,0,1,1,eneheuvel,26-09-11
200516ZX00206,2005,16ZX00,206,25,43,68,eneheuvel,26-09-11
200516ZX00207,2005,16ZX00,207,38,15,53,eneheuvel,26-09-11
200516ZX00209,2005,16ZX00,209,45,45,90,eneheuvel,26-09-11
200516ZX00210,2005,16ZX00,210,0,1,1,eneheuvel,26-09-11
200516ZX00211,2005,16ZX00,211,1,0,1,eneheuvel,26-09-11
200516ZX00212,2005,16ZX00,212,0,1,1,eneheuvel,26-09-11
200516ZX00304,2005,16ZX00,304,1,0,1,eneheuvel,26-09-11
200516ZX00305,2005,16ZX00,305,0,1,1,eneheuvel,26-09-11
200516ZX009999,2005,16ZX00,9999,3,1,4,eneheuvel,26-09-11
200517AK00202,2005,17AK00,202,0,2,2,eneheuvel,26-09-11
200517AK00203,2005,17AK00,203,0,3,3,eneheuvel,26-09-11
200517AK00204,2005,17AK00,204,0,1,1,eneheuvel,26-09-11
200517AK00205,2005,17AK00,205,1,2,3,eneheuvel,26-09-11
200517AK00206,2005,17AK00,206,66,66,132,eneheuvel,26-09-11
200517AK00207,2005,17AK00,207,0,2,2,eneheuvel,26-09-11
200517AK00209,2005,17AK00,209,2,0,2,eneheuvel,26-09-11
200517AK00210,2005,17AK00,210,4,2,6,eneheuvel,26-09-11
200517AK00212,2005,17AK00,212,0,1,1,eneheuvel,26-09-11
200517AK00215,2005,17AK00,215,2,2,4,eneheuvel,26-09-11
200517AK00301,2005,17AK00,301,1,1,2,eneheuvel,26-09-11
200517AK00302,2005,17AK00,302,2,1,3,eneheuvel,26-09-11
200517AK00303,2005,17AK00,303,1,0,1,eneheuvel,26-09-11
200517AK00304,2005,17AK00,304,1,1,2,eneheuvel,26-09-11
200517AK00305,2005,17AK00,305,3,2,5,eneheuvel,26-09-11
200517AK00306,2005,17AK00,306,1,0,1,eneheuvel,26-09-11
200517AK00307,2005,17AK00,307,1,1,2,eneheuvel,26-09-11
200517AK00309,2005,17AK00,309,1,2,3,eneheuvel,26-09-11
200517AK00312,2005,17AK00,312,1,0,1,eneheuvel,26-09-11
200517AV00103,2005,17AV00,103,1,0,1,eneheuvel,26-09-11
200517AV00201,2005,17AV00,201,0,1,1,eneheuvel,26-09-11
200517AV00203,2005,17AV00,203,0,1,1,eneheuvel,26-09-11
200517AV00204,2005,17AV00,204,0,1,1,eneheuvel,26-09-11
200517AV00205,2005,17AV00,205,1,1,2,eneheuvel,26-09-11
200517AV00206,2005,17AV00,206,76,74,150,eneheuvel,26-09-11
200517AV00207,2005,17AV00,207,1,5,6,eneheuvel,26-09-11
200517AV00208,2005,17AV00,208,0,1,1,eneheuvel,26-09-11
200517AV00209,2005,17AV00,209,1,2,3,eneheuvel,26-09-11
200517AV00210,2005,17AV00,210,0,6,6,eneheuvel,26-09-11
200517AV00211,2005,17AV00,211,0,1,1,eneheuvel,26-09-11
200517AV00305,2005,17AV00,305,0,1,1,eneheuvel,26-09-11
200517AV009999,2005,17AV00,9999,4,3,7,eneheuvel,26-09-11
200517BP00202,2005,17BP00,202,0,1,1,eneheuvel,26-09-11
200517BP00207,2005,17BP00,207,1,0,1,eneheuvel,26-09-11
200517BP00208,2005,17BP00,208,0,1,1,eneheuvel,26-09-11
200517BP00211,2005,17BP00,211,55,59,114,eneheuvel,26-09-11
200517BP00212,2005,17BP00,212,4,5,9,eneheuvel,26-09-11
200517BP00213,2005,17BP00,213,76,90,166,eneheuvel,26-09-11
200517BP00214,2005,17BP00,214,2,7,9,eneheuvel,26-09-11
200517BP00301,2005,17BP00,301,0,1,1,eneheuvel,26-09-11
200517BP00303,2005,17BP00,303,0,3,3,eneheuvel,26-09-11
200517BP00312,2005,17BP00,312,1,0,1,eneheuvel,26-09-11
200517BP009999,2005,17BP00,9999,2,0,2,eneheuvel,26-09-11
200517DA00207,2005,17DA00,207,1,1,2,eneheuvel,26-09-11
200517DA00209,2005,17DA00,209,16,11,27,eneheuvel,26-09-11
200517DA00210,2005,17DA00,210,50,69,119,eneheuvel,26-09-11
200517DA00211,2005,17DA00,211,1,2,3,eneheuvel,26-09-11
200517DA00214,2005,17DA00,214,0,1,1,eneheuvel,26-09-11
200517DA00215,2005,17DA00,215,0,2,2,eneheuvel,26-09-11
200517DA00307,2005,17DA00,307,1,1,2,eneheuvel,26-09-11
200517DA00309,2005,17DA00,309,1,0,1,eneheuvel,26-09-11
200517DA009999,2005,17DA00,9999,2,2,4,eneheuvel,26-09-11
200517DK00201,2005,17DK00,201,0,1,1,eneheuvel,26-09-11
200517DK00206,2005,17DK00,206,1,0,1,eneheuvel,26-09-11
200517DK00207,2005,17DK00,207,1,0,1,eneheuvel,26-09-11
200517DK00208,2005,17DK00,208,0,1,1,eneheuvel,26-09-11
200517DK00301,2005,17DK00,301,5,5,10,eneheuvel,26-09-11
200517DK00302,2005,17DK00,302,1,0,1,eneheuvel,26-09-11
200517DK00303,2005,17DK00,303,1,5,6,eneheuvel,26-09-11
200517DK00304,2005,17DK00,304,35,47,82,eneheuvel,26-09-11
200517DK00305,2005,17DK00,305,0,2,2,eneheuvel,26-09-11
200517DK00306,2005,17DK00,306,0,2,2,eneheuvel,26-09-11
200517DK00309,2005,17DK00,309,3,1,4,eneheuvel,26-09-11
200517DV00103,2005,17DV00,103,0,1,1,eneheuvel,26-09-11
200517DV00106,2005,17DV00,106,1,0,1,eneheuvel,26-09-11
200517DV00108,2005,17DV00,108,1,0,1,eneheuvel,26-09-11
200517DV00202,2005,17DV00,202,1,0,1,eneheuvel,26-09-11
200517DV00203,2005,17DV00,203,2,0,2,eneheuvel,26-09-11
200517DV00204,2005,17DV00,204,3,2,5,eneheuvel,26-09-11
200517DV00205,2005,17DV00,205,1,1,2,eneheuvel,26-09-11
200517DV00206,2005,17DV00,206,0,1,1,eneheuvel,26-09-11
200517DV00207,2005,17DV00,207,0,2,2,eneheuvel,26-09-11
200517DV00208,2005,17DV00,208,0,4,4,eneheuvel,26-09-11
200517DV00209,2005,17DV00,209,1,1,2,eneheuvel,26-09-11
200517DV00211,2005,17DV00,211,1,2,3,eneheuvel,26-09-11
200517DV00301,2005,17DV00,301,13,7,20,eneheuvel,26-09-11
200517DV00302,2005,17DV00,302,4,4,8,eneheuvel,26-09-11
200517DV00303,2005,17DV00,303,37,22,59,eneheuvel,26-09-11
200517DV00304,2005,17DV00,304,43,45,88,eneheuvel,26-09-11
200517DV00305,2005,17DV00,305,6,10,16,eneheuvel,26-09-11
200517DV00306,2005,17DV00,306,12,9,21,eneheuvel,26-09-11
200517DV00307,2005,17DV00,307,10,7,17,eneheuvel,26-09-11
200517DV00308,2005,17DV00,308,10,10,20,eneheuvel,26-09-11
200517DV00309,2005,17DV00,309,10,14,24,eneheuvel,26-09-11
200517DV00310,2005,17DV00,310,0,2,2,eneheuvel,26-09-11
200517DV00311,2005,17DV00,311,3,3,6,eneheuvel,26-09-11
200517DV00312,2005,17DV00,312,2,0,2,eneheuvel,26-09-11
200517DV009999,2005,17DV00,9999,1,0,1,eneheuvel,26-09-11
200517FI00102,2005,17FI00,102,3,0,3,eneheuvel,26-09-11
200517FI00103,2005,17FI00,103,3,0,3,eneheuvel,26-09-11
200517FI00106,2005,17FI00,106,4,0,4,eneheuvel,26-09-11
200517FI00108,2005,17FI00,108,4,0,4,eneheuvel,26-09-11
200517FI00202,2005,17FI00,202,7,0,7,eneheuvel,26-09-11
200517FI00203,2005,17FI00,203,5,0,5,eneheuvel,26-09-11
200517FI00204,2005,17FI00,204,3,0,3,eneheuvel,26-09-11
200517FI00205,2005,17FI00,205,2,0,2,eneheuvel,26-09-11
200517FI00206,2005,17FI00,206,4,0,4,eneheuvel,26-09-11
200517FI00207,2005,17FI00,207,8,0,8,eneheuvel,26-09-11
200517FI00208,2005,17FI00,208,7,0,7,eneheuvel,26-09-11
200517FI00209,2005,17FI00,209,1,0,1,eneheuvel,26-09-11
200517FI00210,2005,17FI00,210,7,0,7,eneheuvel,26-09-11
200517FI00211,2005,17FI00,211,4,0,4,eneheuvel,26-09-11
200517FI00212,2005,17FI00,212,5,0,5,eneheuvel,26-09-11
200517FI00213,2005,17FI00,213,6,0,6,eneheuvel,26-09-11
200517FI00214,2005,17FI00,214,5,0,5,eneheuvel,26-09-11
200517FI00302,2005,17FI00,302,4,0,4,eneheuvel,26-09-11
200517FI00303,2005,17FI00,303,6,0,6,eneheuvel,26-09-11
200517FI00304,2005,17FI00,304,5,0,5,eneheuvel,26-09-11
200517FI00305,2005,17FI00,305,5,0,5,eneheuvel,26-09-11
200517FI00306,2005,17FI00,306,3,0,3,eneheuvel,26-09-11
200517FI00307,2005,17FI00,307,2,0,2,eneheuvel,26-09-11
200517FI00308,2005,17FI00,308,4,0,4,eneheuvel,26-09-11
200517FI00309,2005,17FI00,309,5,0,5,eneheuvel,26-09-11
200517FI00311,2005,17FI00,311,1,0,1,eneheuvel,26-09-11
200517FI00502,2005,17FI00,502,1,0,1,eneheuvel,26-09-11
200517FI009999,2005,17FI00,9999,1,0,1,eneheuvel,26-09-11
200517LP00202,2005,17LP00,202,0,1,1,eneheuvel,26-09-11
200517LP00207,2005,17LP00,207,2,14,16,eneheuvel,26-09-11
200517LP00214,2005,17LP00,214,1,0,1,eneheuvel,26-09-11
200517LP00304,2005,17LP00,304,2,2,4,eneheuvel,26-09-11
200517LP00305,2005,17LP00,305,58,61,119,eneheuvel,26-09-11
200517LP00306,2005,17LP00,306,2,5,7,eneheuvel,26-09-11
200517LP00307,2005,17LP00,307,0,1,1,eneheuvel,26-09-11
200517LP00309,2005,17LP00,309,1,0,1,eneheuvel,26-09-11
200517LP009999,2005,17LP00,9999,1,1,2,eneheuvel,26-09-11
200517MH00207,2005,17MH00,207,9,23,32,eneheuvel,26-09-11
200517MH00210,2005,17MH00,210,3,0,3,eneheuvel,26-09-11
200517MH00211,2005,17MH00,211,0,1,1,eneheuvel,26-09-11
200517MH00212,2005,17MH00,212,1,0,1,eneheuvel,26-09-11
200517MH00216,2005,17MH00,216,1,1,2,eneheuvel,26-09-11
200517MH00302,2005,17MH00,302,2,4,6,eneheuvel,26-09-11
200517MH00303,2005,17MH00,303,1,2,3,eneheuvel,26-09-11
200517MH00304,2005,17MH00,304,0,1,1,eneheuvel,26-09-11
200517MH00305,2005,17MH00,305,74,82,156,eneheuvel,26-09-11
200517MH00306,2005,17MH00,306,2,0,2,eneheuvel,26-09-11
200517MH00307,2005,17MH00,307,0,2,2,eneheuvel,26-09-11
200517MH00311,2005,17MH00,311,0,1,1,eneheuvel,26-09-11
200521KO00209,2005,21KO00,209,3,3,6,eneheuvel,26-09-11
200521KO00210,2005,21KO00,210,87,151,238,eneheuvel,26-09-11
200521KO00212,2005,21KO00,212,0,3,3,eneheuvel,26-09-11
200521KO00216,2005,21KO00,216,0,3,3,eneheuvel,26-09-11
200521KO00302,2005,21KO00,302,1,0,1,eneheuvel,26-09-11
200521KO009999,2005,21KO00,9999,0,1,1,eneheuvel,26-09-11
200521NC00103,2005,21NC00,103,1,0,1,eneheuvel,26-09-11
200521NC00201,2005,21NC00,201,0,2,2,eneheuvel,26-09-11
200521NC00203,2005,21NC00,203,0,1,1,eneheuvel,26-09-11
200521NC00211,2005,21NC00,211,2,0,2,eneheuvel,26-09-11
200521NC00212,2005,21NC00,212,2,0,2,eneheuvel,26-09-11
200521NC00213,2005,21NC00,213,58,47,105,eneheuvel,26-09-11
200521NC00214,2005,21NC00,214,1,2,3,eneheuvel,26-09-11
200521NC00302,2005,21NC00,302,0,1,1,eneheuvel,26-09-11
200521NC00305,2005,21NC00,305,1,0,1,eneheuvel,26-09-11
200521NC00311,2005,21NC00,311,1,0,1,eneheuvel,26-09-11
200521NC009999,2005,21NC00,9999,2,2,4,eneheuvel,26-09-11
200521ND00201,2005,21ND00,201,0,1,1,eneheuvel,26-09-11
200521ND00207,2005,21ND00,207,0,1,1,eneheuvel,26-09-11
200521ND00210,2005,21ND00,210,0,1,1,eneheuvel,26-09-11
200521ND00211,2005,21ND00,211,6,3,9,eneheuvel,26-09-11
200521ND00212,2005,21ND00,212,3,5,8,eneheuvel,26-09-11
200521ND00213,2005,21ND00,213,103,142,245,eneheuvel,26-09-11
200521ND00214,2005,21ND00,214,0,5,5,eneheuvel,26-09-11
200521ND00302,2005,21ND00,302,0,2,2,eneheuvel,26-09-11
200521ND009999,2005,21ND00,9999,1,3,4,eneheuvel,26-09-11
200522KP00201,2005,22KP00,201,2,0,2,eneheuvel,26-09-11
200522KP00203,2005,22KP00,203,1,0,1,eneheuvel,26-09-11
200522KP00207,2005,22KP00,207,0,2,2,eneheuvel,26-09-11
200522KP00208,2005,22KP00,208,0,2,2,eneheuvel,26-09-11
200522KP00211,2005,22KP00,211,1,1,2,eneheuvel,26-09-11
200522KP00301,2005,22KP00,301,3,4,7,eneheuvel,26-09-11
200522KP00302,2005,22KP00,302,2,2,4,eneheuvel,26-09-11
200522KP00303,2005,22KP00,303,2,4,6,eneheuvel,26-09-11
200522KP00304,2005,22KP00,304,1,1,2,eneheuvel,26-09-11
200522KP00306,2005,22KP00,306,1,1,2,eneheuvel,26-09-11
200522KP00308,2005,22KP00,308,5,7,12,eneheuvel,26-09-11
200522KP00309,2005,22KP00,309,150,166,316,eneheuvel,26-09-11
200522KP00310,2005,22KP00,310,3,4,7,eneheuvel,26-09-11
200522KP00311,2005,22KP00,311,11,24,35,eneheuvel,26-09-11
200522KP00312,2005,22KP00,312,1,0,1,eneheuvel,26-09-11
200522KP009999,2005,22KP00,9999,2,1,3,eneheuvel,26-09-11
200522KQ00201,2005,22KQ00,201,1,0,1,eneheuvel,26-09-11
200522KQ00205,2005,22KQ00,205,1,1,2,eneheuvel,26-09-11
200522KQ00208,2005,22KQ00,208,1,0,1,eneheuvel,26-09-11
200522KQ00209,2005,22KQ00,209,1,1,2,eneheuvel,26-09-11
200522KQ00210,2005,22KQ00,210,109,130,239,eneheuvel,26-09-11
200522KQ00212,2005,22KQ00,212,1,5,6,eneheuvel,26-09-11
200522KQ00213,2005,22KQ00,213,1,0,1,eneheuvel,26-09-11
200522KQ00214,2005,22KQ00,214,1,1,2,eneheuvel,26-09-11
200522KQ00215,2005,22KQ00,215,0,1,1,eneheuvel,26-09-11
200522KQ00216,2005,22KQ00,216,2,1,3,eneheuvel,26-09-11
200522KQ00307,2005,22KQ00,307,1,0,1,eneheuvel,26-09-11
200522KQ009999,2005,22KQ00,9999,0,1,1,eneheuvel,26-09-11
200523EP00102,2005,23EP00,102,1,0,1,eneheuvel,26-09-11
200523EP00109,2005,23EP00,109,0,1,1,eneheuvel,26-09-11
200523EP00202,2005,23EP00,202,2,3,5,eneheuvel,26-09-11
200523EP00204,2005,23EP00,204,1,0,1,eneheuvel,26-09-11
200523EP00205,2005,23EP00,205,0,1,1,eneheuvel,26-09-11
200523EP00209,2005,23EP00,209,0,1,1,eneheuvel,26-09-11
200523EP00211,2005,23EP00,211,1,1,2,eneheuvel,26-09-11
200523EP00212,2005,23EP00,212,50,76,126,eneheuvel,26-09-11
200523EP00213,2005,23EP00,213,8,10,18,eneheuvel,26-09-11
200523EP00214,2005,23EP00,214,0,6,6,eneheuvel,26-09-11
200523EP00303,2005,23EP00,303,0,1,1,eneheuvel,26-09-11
200523EP00304,2005,23EP00,304,0,2,2,eneheuvel,26-09-11
200523EP00305,2005,23EP00,305,1,1,2,eneheuvel,26-09-11
200523EP009999,2005,23EP00,9999,0,1,1,eneheuvel,26-09-11
200523ER00208,2005,23ER00,208,3,0,3,eneheuvel,26-09-11
200523ER00210,2005,23ER00,210,0,1,1,eneheuvel,26-09-11
200523ER00211,2005,23ER00,211,1,2,3,eneheuvel,26-09-11
200523ER00212,2005,23ER00,212,98,111,209,eneheuvel,26-09-11
200523ER00213,2005,23ER00,213,1,7,8,eneheuvel,26-09-11
200523ER00214,2005,23ER00,214,4,2,6,eneheuvel,26-09-11
200523ER00311,2005,23ER00,311,0,1,1,eneheuvel,26-09-11
200523ER009999,2005,23ER00,9999,2,0,2,eneheuvel,26-09-11
200523ET00107,2005,23ET00,107,1,1,2,eneheuvel,26-09-11
200523ET00202,2005,23ET00,202,0,3,3,eneheuvel,26-09-11
200523ET00206,2005,23ET00,206,0,2,2,eneheuvel,26-09-11
200523ET00208,2005,23ET00,208,1,0,1,eneheuvel,26-09-11
200523ET00209,2005,23ET00,209,0,1,1,eneheuvel,26-09-11
200523ET00210,2005,23ET00,210,0,1,1,eneheuvel,26-09-11
200523ET00211,2005,23ET00,211,1,2,3,eneheuvel,26-09-11
200523ET00212,2005,23ET00,212,1,0,1,eneheuvel,26-09-11
200523ET00214,2005,23ET00,214,1,0,1,eneheuvel,26-09-11
200523ET00302,2005,23ET00,302,4,5,9,eneheuvel,26-09-11
200523ET00303,2005,23ET00,303,2,3,5,eneheuvel,26-09-11
200523ET00304,2005,23ET00,304,0,1,1,eneheuvel,26-09-11
200523ET00305,2005,23ET00,305,0,1,1,eneheuvel,26-09-11
200523ET00306,2005,23ET00,306,4,3,7,eneheuvel,26-09-11
200523ET00307,2005,23ET00,307,7,13,20,eneheuvel,26-09-11
200523ET00308,2005,23ET00,308,86,107,193,eneheuvel,26-09-11
200523ET00309,2005,23ET00,309,9,6,15,eneheuvel,26-09-11
200523ET00310,2005,23ET00,310,0,1,1,eneheuvel,26-09-11
200523ET00311,2005,23ET00,311,4,0,4,eneheuvel,26-09-11
200523ET00312,2005,23ET00,312,1,1,2,eneheuvel,26-09-11
200523ET00502,2005,23ET00,502,0,1,1,eneheuvel,26-09-11
200523ET009999,2005,23ET00,9999,2,0,2,eneheuvel,26-09-11
200523EU00102,2005,23EU00,102,0,1,1,eneheuvel,26-09-11
200523EU00207,2005,23EU00,207,1,1,2,eneheuvel,26-09-11
200523EU00208,2005,23EU00,208,1,2,3,eneheuvel,26-09-11
200523EU00216,2005,23EU00,216,1,1,2,eneheuvel,26-09-11
200523EU00301,2005,23EU00,301,1,1,2,eneheuvel,26-09-11
200523EU00302,2005,23EU00,302,1,3,4,eneheuvel,26-09-11
200523EU00304,2005,23EU00,304,1,0,1,eneheuvel,26-09-11
200523EU00305,2005,23EU00,305,9,6,15,eneheuvel,26-09-11
200523EU00306,2005,23EU00,306,131,133,264,eneheuvel,26-09-11
200523EU00307,2005,23EU00,307,8,4,12,eneheuvel,26-09-11
200523EU00309,2005,23EU00,309,0,3,3,eneheuvel,26-09-11
200523EU00310,2005,23EU00,310,1,0,1,eneheuvel,26-09-11
200523EU00311,2005,23EU00,311,0,3,3,eneheuvel,26-09-11
200523EU009999,2005,23EU00,9999,2,2,4,eneheuvel,26-09-11
200523EV00102,2005,23EV00,102,0,1,1,eneheuvel,26-09-11
200523EV00201,2005,23EV00,201,1,0,1,eneheuvel,26-09-11
200523EV00203,2005,23EV00,203,1,0,1,eneheuvel,26-09-11
200523EV00204,2005,23EV00,204,0,1,1,eneheuvel,26-09-11
200523EV00208,2005,23EV00,208,2,0,2,eneheuvel,26-09-11
200523EV00209,2005,23EV00,209,1,0,1,eneheuvel,26-09-11
200523EV00210,2005,23EV00,210,12,7,19,eneheuvel,26-09-11
200523EV00211,2005,23EV00,211,16,9,25,eneheuvel,26-09-11
200523EV00212,2005,23EV00,212,141,144,285,eneheuvel,26-09-11
200523EV00213,2005,23EV00,213,21,43,64,eneheuvel,26-09-11
200523EV00214,2005,23EV00,214,5,9,14,eneheuvel,26-09-11
200523EV00215,2005,23EV00,215,2,0,2,eneheuvel,26-09-11
200523EV00216,2005,23EV00,216,1,4,5,eneheuvel,26-09-11
200523EV00303,2005,23EV00,303,1,0,1,eneheuvel,26-09-11
200523EV00306,2005,23EV00,306,0,1,1,eneheuvel,26-09-11
200523EV00307,2005,23EV00,307,2,0,2,eneheuvel,26-09-11
200523EV00311,2005,23EV00,311,1,0,1,eneheuvel,26-09-11
200523EV009999,2005,23EV00,9999,1,0,1,eneheuvel,26-09-11
200523EY00204,2005,23EY00,204,1,0,1,eneheuvel,26-09-11
200523EY00205,2005,23EY00,205,1,0,1,eneheuvel,26-09-11
200523EY00207,2005,23EY00,207,1,1,2,eneheuvel,26-09-11
200523EY00208,2005,23EY00,208,1,2,3,eneheuvel,26-09-11
200523EY00209,2005,23EY00,209,0,1,1,eneheuvel,26-09-11
200523EY00210,2005,23EY00,210,10,3,13,eneheuvel,26-09-11
200523EY00211,2005,23EY00,211,6,2,8,eneheuvel,26-09-11
200523EY00212,2005,23EY00,212,133,133,266,eneheuvel,26-09-11
200523EY00213,2005,23EY00,213,25,21,46,eneheuvel,26-09-11
200523EY00214,2005,23EY00,214,0,12,12,eneheuvel,26-09-11
200523EY00216,2005,23EY00,216,1,1,2,eneheuvel,26-09-11
200523EY00502,2005,23EY00,502,2,0,2,eneheuvel,26-09-11
200523EY009999,2005,23EY00,9999,1,1,2,eneheuvel,26-09-11
200523ZU00110,2005,23ZU00,110,0,1,1,eneheuvel,26-09-11
200523ZU00201,2005,23ZU00,201,2,1,3,eneheuvel,26-09-11
200523ZU00202,2005,23ZU00,202,96,96,192,eneheuvel,26-09-11
200523ZU00203,2005,23ZU00,203,5,5,10,eneheuvel,26-09-11
200523ZU00204,2005,23ZU00,204,41,68,109,eneheuvel,26-09-11
200523ZU00205,2005,23ZU00,205,90,83,173,eneheuvel,26-09-11
200523ZU00206,2005,23ZU00,206,2,1,3,eneheuvel,26-09-11
200523ZU00207,2005,23ZU00,207,15,15,30,eneheuvel,26-09-11
200523ZU00208,2005,23ZU00,208,11,20,31,eneheuvel,26-09-11
200523ZU00209,2005,23ZU00,209,1,0,1,eneheuvel,26-09-11
200523ZU00210,2005,23ZU00,210,1,0,1,eneheuvel,26-09-11
200523ZU00211,2005,23ZU00,211,2,4,6,eneheuvel,26-09-11
200523ZU00212,2005,23ZU00,212,2,1,3,eneheuvel,26-09-11
200523ZU00214,2005,23ZU00,214,1,0,1,eneheuvel,26-09-11
200523ZU00215,2005,23ZU00,215,2,1,3,eneheuvel,26-09-11
200523ZU00216,2005,23ZU00,216,0,1,1,eneheuvel,26-09-11
200523ZU00302,2005,23ZU00,302,1,2,3,eneheuvel,26-09-11
200523ZU00303,2005,23ZU00,303,3,3,6,eneheuvel,26-09-11
200523ZU00306,2005,23ZU00,306,0,2,2,eneheuvel,26-09-11
200523ZU00307,2005,23ZU00,307,0,1,1,eneheuvel,26-09-11
200523ZU00309,2005,23ZU00,309,1,1,2,eneheuvel,26-09-11
200523ZU00310,2005,23ZU00,310,0,1,1,eneheuvel,26-09-11
200523ZU00502,2005,23ZU00,502,2,1,3,eneheuvel,26-09-11
200523ZU009999,2005,23ZU00,9999,2,0,2,eneheuvel,26-09-11
200523ZV00107,2005,23ZV00,107,1,0,1,eneheuvel,26-09-11
200523ZV00201,2005,23ZV00,201,2,0,2,eneheuvel,26-09-11
200523ZV00202,2005,23ZV00,202,40,44,84,eneheuvel,26-09-11
200523ZV00203,2005,23ZV00,203,6,8,14,eneheuvel,26-09-11
200523ZV00204,2005,23ZV00,204,31,48,79,eneheuvel,26-09-11
200523ZV00205,2005,23ZV00,205,60,80,140,eneheuvel,26-09-11
200523ZV00206,2005,23ZV00,206,0,2,2,eneheuvel,26-09-11
200523ZV00207,2005,23ZV00,207,12,12,24,eneheuvel,26-09-11
200523ZV00208,2005,23ZV00,208,10,12,22,eneheuvel,26-09-11
200523ZV00211,2005,23ZV00,211,0,1,1,eneheuvel,26-09-11
200523ZV00212,2005,23ZV00,212,1,0,1,eneheuvel,26-09-11
200523ZV00305,2005,23ZV00,305,0,1,1,eneheuvel,26-09-11
200523ZV00308,2005,23ZV00,308,1,0,1,eneheuvel,26-09-11
200523ZV00309,2005,23ZV00,309,1,1,2,eneheuvel,26-09-11
200523ZV00311,2005,23ZV00,311,0,3,3,eneheuvel,26-09-11
200523ZW00108,2005,23ZW00,108,0,1,1,eneheuvel,26-09-11
200523ZW00202,2005,23ZW00,202,1,0,1,eneheuvel,26-09-11
200523ZW00207,2005,23ZW00,207,0,1,1,eneheuvel,26-09-11
200523ZW00208,2005,23ZW00,208,4,5,9,eneheuvel,26-09-11
200523ZW00211,2005,23ZW00,211,0,1,1,eneheuvel,26-09-11
200523ZW00301,2005,23ZW00,301,1,0,1,eneheuvel,26-09-11
200523ZW00302,2005,23ZW00,302,4,1,5,eneheuvel,26-09-11
200523ZW00303,2005,23ZW00,303,7,8,15,eneheuvel,26-09-11
200523ZW00304,2005,23ZW00,304,3,0,3,eneheuvel,26-09-11
200523ZW00305,2005,23ZW00,305,2,0,2,eneheuvel,26-09-11
200523ZW00306,2005,23ZW00,306,31,38,69,eneheuvel,26-09-11
200523ZW00307,2005,23ZW00,307,78,64,142,eneheuvel,26-09-11
200523ZW00308,2005,23ZW00,308,100,105,205,eneheuvel,26-09-11
200523ZW00309,2005,23ZW00,309,1,3,4,eneheuvel,26-09-11
200523ZW00310,2005,23ZW00,310,2,1,3,eneheuvel,26-09-11
200523ZW00311,2005,23ZW00,311,1,2,3,eneheuvel,26-09-11
200523ZW00312,2005,23ZW00,312,1,1,2,eneheuvel,26-09-11
200523ZW00502,2005,23ZW00,502,1,4,5,eneheuvel,26-09-11
200523ZW009999,2005,23ZW00,9999,2,1,3,eneheuvel,26-09-11
200523ZX00105,2005,23ZX00,105,0,1,1,eneheuvel,26-09-11
200523ZX00201,2005,23ZX00,201,3,4,7,eneheuvel,26-09-11
200523ZX00202,2005,23ZX00,202,149,119,268,eneheuvel,26-09-11
200523ZX00204,2005,23ZX00,204,2,5,7,eneheuvel,26-09-11
200523ZX00205,2005,23ZX00,205,2,2,4,eneheuvel,26-09-11
200523ZX00206,2005,23ZX00,206,0,2,2,eneheuvel,26-09-11
200523ZX00207,2005,23ZX00,207,2,1,3,eneheuvel,26-09-11
200523ZX00208,2005,23ZX00,208,6,3,9,eneheuvel,26-09-11
200523ZX00209,2005,23ZX00,209,1,0,1,eneheuvel,26-09-11
200523ZX00211,2005,23ZX00,211,2,5,7,eneheuvel,26-09-11
200523ZX00214,2005,23ZX00,214,1,1,2,eneheuvel,26-09-11
200523ZY00109,2005,23ZY00,109,0,2,2,eneheuvel,26-09-11
200523ZY00201,2005,23ZY00,201,2,0,2,eneheuvel,26-09-11
200523ZY00202,2005,23ZY00,202,0,1,1,eneheuvel,26-09-11
200523ZY00206,2005,23ZY00,206,0,2,2,eneheuvel,26-09-11
200523ZY00207,2005,23ZY00,207,1,0,1,eneheuvel,26-09-11
200523ZY00208,2005,23ZY00,208,0,1,1,eneheuvel,26-09-11
200523ZY00210,2005,23ZY00,210,1,3,4,eneheuvel,26-09-11
200523ZY00211,2005,23ZY00,211,1,1,2,eneheuvel,26-09-11
200523ZY00212,2005,23ZY00,212,172,245,417,eneheuvel,26-09-11
200523ZY00213,2005,23ZY00,213,2,1,3,eneheuvel,26-09-11
200523ZY00214,2005,23ZY00,214,1,1,2,eneheuvel,26-09-11
200523ZY00216,2005,23ZY00,216,0,4,4,eneheuvel,26-09-11
200523ZY00302,2005,23ZY00,302,0,1,1,eneheuvel,26-09-11
200523ZY00311,2005,23ZY00,311,1,0,1,eneheuvel,26-09-11
200523ZY009999,2005,23ZY00,9999,1,0,1,eneheuvel,26-09-11
200524EJ00,2005,24EJ00,,0,0,0,eneheuvel,26-09-11
200524EJ00102,2005,24EJ00,102,4,3,7,eneheuvel,26-09-11
200524EJ00103,2005,24EJ00,103,4,9,13,eneheuvel,26-09-11
200524EJ00105,2005,24EJ00,105,0,1,1,eneheuvel,26-09-11
200524EJ00106,2005,24EJ00,106,1,3,4,eneheuvel,26-09-11
200524EJ00107,2005,24EJ00,107,1,0,1,eneheuvel,26-09-11
200524EJ00201,2005,24EJ00,201,3,0,3,eneheuvel,26-09-11
200524EJ00202,2005,24EJ00,202,3,6,9,eneheuvel,26-09-11
200524EJ00203,2005,24EJ00,203,2,0,2,eneheuvel,26-09-11
200524EJ00204,2005,24EJ00,204,7,5,12,eneheuvel,26-09-11
200524EJ00205,2005,24EJ00,205,0,2,2,eneheuvel,26-09-11
200524EJ00206,2005,24EJ00,206,5,6,11,eneheuvel,26-09-11
200524EJ00207,2005,24EJ00,207,2,5,7,eneheuvel,26-09-11
200524EJ00208,2005,24EJ00,208,6,7,13,eneheuvel,26-09-11
200524EJ00209,2005,24EJ00,209,16,9,25,eneheuvel,26-09-11
200524EJ00210,2005,24EJ00,210,14,6,20,eneheuvel,26-09-11
200524EJ00211,2005,24EJ00,211,27,20,47,eneheuvel,26-09-11
200524EJ00212,2005,24EJ00,212,12,8,20,eneheuvel,26-09-11
200524EJ00213,2005,24EJ00,213,7,4,11,eneheuvel,26-09-11
200524EJ00214,2005,24EJ00,214,4,7,11,eneheuvel,26-09-11
200524EJ00301,2005,24EJ00,301,1,0,1,eneheuvel,26-09-11
200524EJ00302,2005,24EJ00,302,3,2,5,eneheuvel,26-09-11
200524EJ00303,2005,24EJ00,303,2,2,4,eneheuvel,26-09-11
200524EJ00304,2005,24EJ00,304,2,1,3,eneheuvel,26-09-11
200524EJ00305,2005,24EJ00,305,0,3,3,eneheuvel,26-09-11
200524EJ00306,2005,24EJ00,306,0,1,1,eneheuvel,26-09-11
200524EJ00307,2005,24EJ00,307,1,1,2,eneheuvel,26-09-11
200524EJ00308,2005,24EJ00,308,1,1,2,eneheuvel,26-09-11
200524EJ009999,2005,24EJ00,9999,7,13,20,eneheuvel,26-09-11
200524FT00105,2005,24FT00,105,1,0,1,eneheuvel,26-09-11
200524FT00106,2005,24FT00,106,1,0,1,eneheuvel,26-09-11
200524FT00202,2005,24FT00,202,1,0,1,eneheuvel,26-09-11
200524FT00204,2005,24FT00,204,2,0,2,eneheuvel,26-09-11
200524FT00205,2005,24FT00,205,2,0,2,eneheuvel,26-09-11
200524FT00206,2005,24FT00,206,1,0,1,eneheuvel,26-09-11
200524FT00209,2005,24FT00,209,1,0,1,eneheuvel,26-09-11
200524FT00211,2005,24FT00,211,2,0,2,eneheuvel,26-09-11
200524FT00212,2005,24FT00,212,5,0,5,eneheuvel,26-09-11
200524FT00213,2005,24FT00,213,2,0,2,eneheuvel,26-09-11
200524FT00214,2005,24FT00,214,1,0,1,eneheuvel,26-09-11
200524FT00302,2005,24FT00,302,1,0,1,eneheuvel,26-09-11
200524FT00303,2005,24FT00,303,1,0,1,eneheuvel,26-09-11
200524FT00304,2005,24FT00,304,1,0,1,eneheuvel,26-09-11
200524FT00306,2005,24FT00,306,1,0,1,eneheuvel,26-09-11
200524FT00307,2005,24FT00,307,2,0,2,eneheuvel,26-09-11
200524FT00308,2005,24FT00,308,1,0,1,eneheuvel,26-09-11
200524FT00309,2005,24FT00,309,1,0,1,eneheuvel,26-09-11
200524FT00311,2005,24FT00,311,1,0,1,eneheuvel,26-09-11
200524FT009999,2005,24FT00,9999,1,0,1,eneheuvel,26-09-11
200524MR00102,2005,24MR00,102,1,0,1,eneheuvel,26-09-11
200524MR00109,2005,24MR00,109,0,1,1,eneheuvel,26-09-11
200524MR00201,2005,24MR00,201,2,1,3,eneheuvel,26-09-11
200524MR00202,2005,24MR00,202,1,0,1,eneheuvel,26-09-11
200524MR00207,2005,24MR00,207,2,2,4,eneheuvel,26-09-11
200524MR00208,2005,24MR00,208,2,5,7,eneheuvel,26-09-11
200524MR00209,2005,24MR00,209,1,0,1,eneheuvel,26-09-11
200524MR00211,2005,24MR00,211,1,0,1,eneheuvel,26-09-11
200524MR00302,2005,24MR00,302,2,1,3,eneheuvel,26-09-11
200524MR00303,2005,24MR00,303,0,2,2,eneheuvel,26-09-11
200524MR00304,2005,24MR00,304,2,0,2,eneheuvel,26-09-11
200524MR00305,2005,24MR00,305,1,3,4,eneheuvel,26-09-11
200524MR00306,2005,24MR00,306,16,30,46,eneheuvel,26-09-11
200524MR00307,2005,24MR00,307,159,216,375,eneheuvel,26-09-11
200524MR00308,2005,24MR00,308,9,19,28,eneheuvel,26-09-11
200524MR00309,2005,24MR00,309,0,1,1,eneheuvel,26-09-11
200524MR00310,2005,24MR00,310,0,2,2,eneheuvel,26-09-11
200524MR00311,2005,24MR00,311,1,5,6,eneheuvel,26-09-11
200524MR00502,2005,24MR00,502,2,1,3,eneheuvel,26-09-11
200524MR009999,2005,24MR00,9999,1,0,1,eneheuvel,26-09-11
200524RK00108,2005,24RK00,108,0,1,1,eneheuvel,26-09-11
200524RK00202,2005,24RK00,202,19,18,37,eneheuvel,26-09-11
200524RK00203,2005,24RK00,203,12,13,25,eneheuvel,26-09-11
200524RK00204,2005,24RK00,204,15,12,27,eneheuvel,26-09-11
200524RK00205,2005,24RK00,205,6,7,13,eneheuvel,26-09-11
200524RK00206,2005,24RK00,206,1,2,3,eneheuvel,26-09-11
200524RK00207,2005,24RK00,207,9,7,16,eneheuvel,26-09-11
200524RK00208,2005,24RK00,208,7,2,9,eneheuvel,26-09-11
200524RK00210,2005,24RK00,210,3,2,5,eneheuvel,26-09-11
200524RK00212,2005,24RK00,212,4,4,8,eneheuvel,26-09-11
200524RK00213,2005,24RK00,213,4,0,4,eneheuvel,26-09-11
200524RK00214,2005,24RK00,214,4,0,4,eneheuvel,26-09-11
200524RK00301,2005,24RK00,301,1,1,2,eneheuvel,26-09-11
200524RK00302,2005,24RK00,302,7,1,8,eneheuvel,26-09-11
200524RK00303,2005,24RK00,303,6,2,8,eneheuvel,26-09-11
200524RK00304,2005,24RK00,304,4,2,6,eneheuvel,26-09-11
200524RK00305,2005,24RK00,305,1,3,4,eneheuvel,26-09-11
200524RK00306,2005,24RK00,306,6,7,13,eneheuvel,26-09-11
200524RK00307,2005,24RK00,307,4,3,7,eneheuvel,26-09-11
200524RK00308,2005,24RK00,308,3,3,6,eneheuvel,26-09-11
200524RK009999,2005,24RK00,9999,2,0,2,eneheuvel,26-09-11
200524UN00207,2005,24UN00,207,1,1,2,eneheuvel,26-09-11
200524UN00208,2005,24UN00,208,1,2,3,eneheuvel,26-09-11
200524UN00302,2005,24UN00,302,1,3,4,eneheuvel,26-09-11
200524UN00303,2005,24UN00,303,1,5,6,eneheuvel,26-09-11
200524UN00306,2005,24UN00,306,33,24,57,eneheuvel,26-09-11
200524UN00307,2005,24UN00,307,58,31,89,eneheuvel,26-09-11
200524UN00308,2005,24UN00,308,53,71,124,eneheuvel,26-09-11
200524UN00309,2005,24UN00,309,25,15,40,eneheuvel,26-09-11
200524UN00310,2005,24UN00,310,2,0,2,eneheuvel,26-09-11
200524UN00311,2005,24UN00,311,3,4,7,eneheuvel,26-09-11
200524UN00312,2005,24UN00,312,1,0,1,eneheuvel,26-09-11
200524UN00502,2005,24UN00,502,0,3,3,eneheuvel,26-09-11
200524UN009999,2005,24UN00,9999,1,1,2,eneheuvel,26-09-11
200525CF00108,2005,25CF00,108,0,1,1,eneheuvel,26-09-11
200525CF00202,2005,25CF00,202,12,5,17,eneheuvel,26-09-11
200525CF00203,2005,25CF00,203,12,9,21,eneheuvel,26-09-11
200525CF00204,2005,25CF00,204,72,113,185,eneheuvel,26-09-11
200525CF00205,2005,25CF00,205,46,55,101,eneheuvel,26-09-11
200525CF00206,2005,25CF00,206,1,0,1,eneheuvel,26-09-11
200525CF00207,2005,25CF00,207,7,4,11,eneheuvel,26-09-11
200525CF00208,2005,25CF00,208,7,6,13,eneheuvel,26-09-11
200525CF00209,2005,25CF00,209,0,3,3,eneheuvel,26-09-11
200525CF00210,2005,25CF00,210,3,0,3,eneheuvel,26-09-11
200525CF00211,2005,25CF00,211,0,1,1,eneheuvel,26-09-11
200525CF00302,2005,25CF00,302,0,1,1,eneheuvel,26-09-11
200525CF00307,2005,25CF00,307,0,1,1,eneheuvel,26-09-11
200525CF00308,2005,25CF00,308,0,2,2,eneheuvel,26-09-11
200525CF00502,2005,25CF00,502,0,1,1,eneheuvel,26-09-11
200525CF009999,2005,25CF00,9999,0,2,2,eneheuvel,26-09-11
200525KT00107,2005,25KT00,107,2,0,2,eneheuvel,26-09-11
200525KT00201,2005,25KT00,201,1,0,1,eneheuvel,26-09-11
200525KT00202,2005,25KT00,202,67,50,117,eneheuvel,26-09-11
200525KT00203,2005,25KT00,203,101,50,151,eneheuvel,26-09-11
200525KT00204,2005,25KT00,204,83,83,166,eneheuvel,26-09-11
200525KT00205,2005,25KT00,205,13,3,16,eneheuvel,26-09-11
200525KT00207,2005,25KT00,207,9,3,12,eneheuvel,26-09-11
200525KT00208,2005,25KT00,208,33,18,51,eneheuvel,26-09-11
200525KT00211,2005,25KT00,211,2,0,2,eneheuvel,26-09-11
200525KT00212,2005,25KT00,212,0,1,1,eneheuvel,26-09-11
200525KT00216,2005,25KT00,216,0,1,1,eneheuvel,26-09-11
200525KT00302,2005,25KT00,302,0,1,1,eneheuvel,26-09-11
200525KT00311,2005,25KT00,311,0,2,2,eneheuvel,26-09-11
200525KT00312,2005,25KT00,312,0,1,1,eneheuvel,26-09-11
200525KT00502,2005,25KT00,502,18,10,28,eneheuvel,26-09-11
200525KT009999,2005,25KT00,9999,3,2,5,eneheuvel,26-09-11
200525KU00110,2005,25KU00,110,1,0,1,eneheuvel,26-09-11
200525KU00201,2005,25KU00,201,0,1,1,eneheuvel,26-09-11
200525KU00202,2005,25KU00,202,37,29,66,eneheuvel,26-09-11
200525KU00203,2005,25KU00,203,68,35,103,eneheuvel,26-09-11
200525KU00204,2005,25KU00,204,84,79,163,eneheuvel,26-09-11
200525KU00205,2005,25KU00,205,2,1,3,eneheuvel,26-09-11
200525KU00206,2005,25KU00,206,1,0,1,eneheuvel,26-09-11
200525KU00207,2005,25KU00,207,9,7,16,eneheuvel,26-09-11
200525KU00208,2005,25KU00,208,37,23,60,eneheuvel,26-09-11
200525KU00211,2005,25KU00,211,1,1,2,eneheuvel,26-09-11
200525KU00309,2005,25KU00,309,1,0,1,eneheuvel,26-09-11
200525KU00502,2005,25KU00,502,13,12,25,eneheuvel,26-09-11
200525KV00108,2005,25KV00,108,0,1,1,eneheuvel,26-09-11
200525KV00202,2005,25KV00,202,2,6,8,eneheuvel,26-09-11
200525KV00203,2005,25KV00,203,212,172,384,eneheuvel,26-09-11
200525KV00204,2005,25KV00,204,6,11,17,eneheuvel,26-09-11
200525KV00205,2005,25KV00,205,3,2,5,eneheuvel,26-09-11
200525KV00206,2005,25KV00,206,0,1,1,eneheuvel,26-09-11
200525KV00208,2005,25KV00,208,7,11,18,eneheuvel,26-09-11
200525KV00211,2005,25KV00,211,2,2,4,eneheuvel,26-09-11
200525KV00212,2005,25KV00,212,0,2,2,eneheuvel,26-09-11
200525KV00214,2005,25KV00,214,2,0,2,eneheuvel,26-09-11
200525KV00302,2005,25KV00,302,0,2,2,eneheuvel,26-09-11
200525KV009999,2005,25KV00,9999,3,1,4,eneheuvel,26-09-11
200526AB00103,2005,26AB00,103,1,0,1,eneheuvel,26-09-11
200526AB00201,2005,26AB00,201,3,0,3,eneheuvel,26-09-11
200526AB00206,2005,26AB00,206,0,1,1,eneheuvel,26-09-11
200526AB00209,2005,26AB00,209,1,0,1,eneheuvel,26-09-11
200526AB00212,2005,26AB00,212,1,1,2,eneheuvel,26-09-11
200526AB00301,2005,26AB00,301,0,2,2,eneheuvel,26-09-11
200526AB00302,2005,26AB00,302,17,12,29,eneheuvel,26-09-11
200526AB00303,2005,26AB00,303,215,199,414,eneheuvel,26-09-11
200526AB00304,2005,26AB00,304,3,2,5,eneheuvel,26-09-11
200526AB00305,2005,26AB00,305,2,2,4,eneheuvel,26-09-11
200526AB00306,2005,26AB00,306,3,2,5,eneheuvel,26-09-11
200526AB00308,2005,26AB00,308,2,3,5,eneheuvel,26-09-11
200526AB00309,2005,26AB00,309,3,3,6,eneheuvel,26-09-11
200526AB00310,2005,26AB00,310,2,3,5,eneheuvel,26-09-11
200526AB00311,2005,26AB00,311,5,3,8,eneheuvel,26-09-11
200526AB00312,2005,26AB00,312,0,1,1,eneheuvel,26-09-11
200526AB009999,2005,26AB00,9999,2,1,3,eneheuvel,26-09-11
200526AC00101,2005,26AC00,101,0,1,1,eneheuvel,26-09-11
200526AC00103,2005,26AC00,103,1,0,1,eneheuvel,26-09-11
200526AC00109,2005,26AC00,109,12,2,14,eneheuvel,26-09-11
200526AC00201,2005,26AC00,201,1,1,2,eneheuvel,26-09-11
200526AC00202,2005,26AC00,202,2,0,2,eneheuvel,26-09-11
200526AC00203,2005,26AC00,203,1,1,2,eneheuvel,26-09-11
200526AC00205,2005,26AC00,205,1,0,1,eneheuvel,26-09-11
200526AC00206,2005,26AC00,206,1,0,1,eneheuvel,26-09-11
200526AC00207,2005,26AC00,207,1,0,1,eneheuvel,26-09-11
200526AC00208,2005,26AC00,208,0,3,3,eneheuvel,26-09-11
200526AC00209,2005,26AC00,209,1,0,1,eneheuvel,26-09-11
200526AC00211,2005,26AC00,211,3,3,6,eneheuvel,26-09-11
200526AC00212,2005,26AC00,212,20,23,43,eneheuvel,26-09-11
200526AC00213,2005,26AC00,213,20,23,43,eneheuvel,26-09-11
200526AC00214,2005,26AC00,214,454,299,753,eneheuvel,26-09-11
200526AC00216,2005,26AC00,216,1,0,1,eneheuvel,26-09-11
200526AC00302,2005,26AC00,302,1,0,1,eneheuvel,26-09-11
200526AC00307,2005,26AC00,307,3,0,3,eneheuvel,26-09-11
200526AC00308,2005,26AC00,308,1,0,1,eneheuvel,26-09-11
200526AC00311,2005,26AC00,311,1,1,2,eneheuvel,26-09-11
200526AC00312,2005,26AC00,312,0,1,1,eneheuvel,26-09-11
200526AC009999,2005,26AC00,9999,6,0,6,eneheuvel,26-09-11
200526AD00203,2005,26AD00,203,1,0,1,eneheuvel,26-09-11
200526AD00204,2005,26AD00,204,1,0,1,eneheuvel,26-09-11
200526AD00207,2005,26AD00,207,2,0,2,eneheuvel,26-09-11
200526AD00208,2005,26AD00,208,3,0,3,eneheuvel,26-09-11
200526AD00214,2005,26AD00,214,1,0,1,eneheuvel,26-09-11
200526AD00301,2005,26AD00,301,0,1,1,eneheuvel,26-09-11
200526AD00302,2005,26AD00,302,101,69,170,eneheuvel,26-09-11
200526AD00303,2005,26AD00,303,32,23,55,eneheuvel,26-09-11
200526AD00305,2005,26AD00,305,2,0,2,eneheuvel,26-09-11
200526AD00306,2005,26AD00,306,4,0,4,eneheuvel,26-09-11
200526AD00307,2005,26AD00,307,0,1,1,eneheuvel,26-09-11
200526AD00308,2005,26AD00,308,1,0,1,eneheuvel,26-09-11
200526AD00309,2005,26AD00,309,61,39,100,eneheuvel,26-09-11
200526AD00310,2005,26AD00,310,7,5,12,eneheuvel,26-09-11
200526AD00311,2005,26AD00,311,52,46,98,eneheuvel,26-09-11
200526AD00312,2005,26AD00,312,1,0,1,eneheuvel,26-09-11
200526AD00313,2005,26AD00,313,2,2,4,eneheuvel,26-09-11
200526AD00502,2005,26AD00,502,1,2,3,eneheuvel,26-09-11
200526AD009999,2005,26AD00,9999,0,1,1,eneheuvel,26-09-11
200526PD00203,2005,26PD00,203,1,2,3,eneheuvel,26-09-11
200526PD00204,2005,26PD00,204,1,1,2,eneheuvel,26-09-11
200526PD00205,2005,26PD00,205,4,8,12,eneheuvel,26-09-11
200526PD00206,2005,26PD00,206,1,0,1,eneheuvel,26-09-11
200526PD00207,2005,26PD00,207,188,218,406,eneheuvel,26-09-11
200526PD00208,2005,26PD00,208,60,69,129,eneheuvel,26-09-11
200526PD00210,2005,26PD00,210,1,0,1,eneheuvel,26-09-11
200526PD00211,2005,26PD00,211,1,0,1,eneheuvel,26-09-11
200526PD00303,2005,26PD00,303,1,0,1,eneheuvel,26-09-11
200526PD00306,2005,26PD00,306,0,2,2,eneheuvel,26-09-11
200526PD00309,2005,26PD00,309,0,3,3,eneheuvel,26-09-11
200526PD00311,2005,26PD00,311,0,1,1,eneheuvel,26-09-11
200526PD00312,2005,26PD00,312,0,1,1,eneheuvel,26-09-11
200526PD00502,2005,26PD00,502,1,1,2,eneheuvel,26-09-11
200526PD009999,2005,26PD00,9999,6,2,8,eneheuvel,26-09-11
200526PE00108,2005,26PE00,108,1,0,1,eneheuvel,26-09-11
200526PE00109,2005,26PE00,109,1,0,1,eneheuvel,26-09-11
200526PE00207,2005,26PE00,207,0,1,1,eneheuvel,26-09-11
200526PE00208,2005,26PE00,208,0,1,1,eneheuvel,26-09-11
200526PE00210,2005,26PE00,210,1,0,1,eneheuvel,26-09-11
200526PE00212,2005,26PE00,212,0,1,1,eneheuvel,26-09-11
200526PE00301,2005,26PE00,301,1,0,1,eneheuvel,26-09-11
200526PE00302,2005,26PE00,302,271,249,520,eneheuvel,26-09-11
200526PE00303,2005,26PE00,303,14,8,22,eneheuvel,26-09-11
200526PE00304,2005,26PE00,304,0,1,1,eneheuvel,26-09-11
200526PE00306,2005,26PE00,306,0,1,1,eneheuvel,26-09-11
200526PE00308,2005,26PE00,308,0,1,1,eneheuvel,26-09-11
200526PE00309,2005,26PE00,309,3,1,4,eneheuvel,26-09-11
200526PE00310,2005,26PE00,310,0,1,1,eneheuvel,26-09-11
200526PE00311,2005,26PE00,311,3,5,8,eneheuvel,26-09-11
200526PE00312,2005,26PE00,312,0,3,3,eneheuvel,26-09-11
200526PE009999,2005,26PE00,9999,2,1,3,eneheuvel,26-09-11
200526PF00101,2005,26PF00,101,0,1,1,eneheuvel,26-09-11
200526PF00102,2005,26PF00,102,0,1,1,eneheuvel,26-09-11
200526PF00201,2005,26PF00,201,1,0,1,eneheuvel,26-09-11
200526PF00202,2005,26PF00,202,0,2,2,eneheuvel,26-09-11
200526PF00206,2005,26PF00,206,2,1,3,eneheuvel,26-09-11
200526PF00207,2005,26PF00,207,2,1,3,eneheuvel,26-09-11
200526PF00208,2005,26PF00,208,3,1,4,eneheuvel,26-09-11
200526PF00211,2005,26PF00,211,5,3,8,eneheuvel,26-09-11
200526PF00212,2005,26PF00,212,4,5,9,eneheuvel,26-09-11
200526PF00213,2005,26PF00,213,0,6,6,eneheuvel,26-09-11
200526PF00214,2005,26PF00,214,211,192,403,eneheuvel,26-09-11
200526PF00216,2005,26PF00,216,0,1,1,eneheuvel,26-09-11
200526PF00302,2005,26PF00,302,0,1,1,eneheuvel,26-09-11
200526PF00303,2005,26PF00,303,0,2,2,eneheuvel,26-09-11
200526PF00305,2005,26PF00,305,0,1,1,eneheuvel,26-09-11
200526PF00311,2005,26PF00,311,1,0,1,eneheuvel,26-09-11
200526PF00312,2005,26PF00,312,0,1,1,eneheuvel,26-09-11
200526PF009999,2005,26PF00,9999,2,0,2,eneheuvel,26-09-11
200526PG00103,2005,26PG00,103,1,1,2,eneheuvel,26-09-11
200526PG00201,2005,26PG00,201,0,1,1,eneheuvel,26-09-11
200526PG00207,2005,26PG00,207,1,0,1,eneheuvel,26-09-11
200526PG00209,2005,26PG00,209,1,1,2,eneheuvel,26-09-11
200526PG00210,2005,26PG00,210,1,0,1,eneheuvel,26-09-11
200526PG00211,2005,26PG00,211,0,3,3,eneheuvel,26-09-11
200526PG00212,2005,26PG00,212,0,3,3,eneheuvel,26-09-11
200526PG00213,2005,26PG00,213,1,1,2,eneheuvel,26-09-11
200526PG00214,2005,26PG00,214,87,130,217,eneheuvel,26-09-11
200526PG00304,2005,26PG00,304,0,1,1,eneheuvel,26-09-11
200526PG009999,2005,26PG00,9999,2,0,2,eneheuvel,26-09-11
200526PH00108,2005,26PH00,108,0,1,1,eneheuvel,26-09-11
200526PH00203,2005,26PH00,203,1,0,1,eneheuvel,26-09-11
200526PH00208,2005,26PH00,208,1,0,1,eneheuvel,26-09-11
200526PH00216,2005,26PH00,216,1,0,1,eneheuvel,26-09-11
200526PH00302,2005,26PH00,302,22,10,32,eneheuvel,26-09-11
200526PH00303,2005,26PH00,303,5,5,10,eneheuvel,26-09-11
200526PH00305,2005,26PH00,305,3,0,3,eneheuvel,26-09-11
200526PH00306,2005,26PH00,306,2,0,2,eneheuvel,26-09-11
200526PH00308,2005,26PH00,308,2,0,2,eneheuvel,26-09-11
200526PH00309,2005,26PH00,309,51,11,62,eneheuvel,26-09-11
200526PH00311,2005,26PH00,311,281,149,430,eneheuvel,26-09-11
200526PH00312,2005,26PH00,312,6,0,6,eneheuvel,26-09-11
200526PH00313,2005,26PH00,313,0,3,3,eneheuvel,26-09-11
200526PH009999,2005,26PH00,9999,1,1,2,eneheuvel,26-09-11
200526PW00207,2005,26PW00,207,1,0,1,eneheuvel,26-09-11
200526PW00208,2005,26PW00,208,2,0,2,eneheuvel,26-09-11
200526PW00214,2005,26PW00,214,1,0,1,eneheuvel,26-09-11
200526PW00216,2005,26PW00,216,2,0,2,eneheuvel,26-09-11
200526PW00302,2005,26PW00,302,58,34,92,eneheuvel,26-09-11
200526PW00303,2005,26PW00,303,32,11,43,eneheuvel,26-09-11
200526PW00305,2005,26PW00,305,1,0,1,eneheuvel,26-09-11
200526PW00306,2005,26PW00,306,0,1,1,eneheuvel,26-09-11
200526PW00307,2005,26PW00,307,3,2,5,eneheuvel,26-09-11
200526PW00308,2005,26PW00,308,3,0,3,eneheuvel,26-09-11
200526PW00309,2005,26PW00,309,37,23,60,eneheuvel,26-09-11
200526PW00310,2005,26PW00,310,3,4,7,eneheuvel,26-09-11
200526PW00311,2005,26PW00,311,29,32,61,eneheuvel,26-09-11
200526PW00312,2005,26PW00,312,1,0,1,eneheuvel,26-09-11
200526PW00502,2005,26PW00,502,1,0,1,eneheuvel,26-09-11
200526PW009999,2005,26PW00,9999,2,1,3,eneheuvel,26-09-11
200526ZZ00201,2005,26ZZ00,201,1,0,1,eneheuvel,26-09-11
200526ZZ00202,2005,26ZZ00,202,219,215,434,eneheuvel,26-09-11
200526ZZ00203,2005,26ZZ00,203,9,6,15,eneheuvel,26-09-11
200526ZZ00204,2005,26ZZ00,204,1,1,2,eneheuvel,26-09-11
200526ZZ00205,2005,26ZZ00,205,1,0,1,eneheuvel,26-09-11
200526ZZ00208,2005,26ZZ00,208,4,8,12,eneheuvel,26-09-11
200526ZZ00209,2005,26ZZ00,209,1,0,1,eneheuvel,26-09-11
200526ZZ00210,2005,26ZZ00,210,2,0,2,eneheuvel,26-09-11
200526ZZ00211,2005,26ZZ00,211,0,2,2,eneheuvel,26-09-11
200526ZZ00213,2005,26ZZ00,213,0,1,1,eneheuvel,26-09-11
200526ZZ00214,2005,26ZZ00,214,0,1,1,eneheuvel,26-09-11
200526ZZ00302,2005,26ZZ00,302,0,1,1,eneheuvel,26-09-11
200526ZZ00304,2005,26ZZ00,304,1,1,2,eneheuvel,26-09-11
200526ZZ00307,2005,26ZZ00,307,1,1,2,eneheuvel,26-09-11
200526ZZ00308,2005,26ZZ00,308,1,2,3,eneheuvel,26-09-11
200526ZZ00309,2005,26ZZ00,309,0,2,2,eneheuvel,26-09-11
200526ZZ00311,2005,26ZZ00,311,0,1,1,eneheuvel,26-09-11
200526ZZ00502,2005,26ZZ00,502,1,1,2,eneheuvel,26-09-11
200526ZZ009999,2005,26ZZ00,9999,1,1,2,eneheuvel,26-09-11
200527AA00102,2005,27AA00,102,1,1,2,eneheuvel,26-09-11
200527AA00106,2005,27AA00,106,0,1,1,eneheuvel,26-09-11
200527AA00107,2005,27AA00,107,1,0,1,eneheuvel,26-09-11
200527AA00202,2005,27AA00,202,1,1,2,eneheuvel,26-09-11
200527AA00203,2005,27AA00,203,4,2,6,eneheuvel,26-09-11
200527AA00204,2005,27AA00,204,10,2,12,eneheuvel,26-09-11
200527AA00205,2005,27AA00,205,8,0,8,eneheuvel,26-09-11
200527AA00206,2005,27AA00,206,2,0,2,eneheuvel,26-09-11
200527AA00207,2005,27AA00,207,72,41,113,eneheuvel,26-09-11
200527AA00208,2005,27AA00,208,169,126,295,eneheuvel,26-09-11
200527AA00209,2005,27AA00,209,1,0,1,eneheuvel,26-09-11
200527AA00210,2005,27AA00,210,1,0,1,eneheuvel,26-09-11
200527AA00211,2005,27AA00,211,2,1,3,eneheuvel,26-09-11
200527AA00212,2005,27AA00,212,3,1,4,eneheuvel,26-09-11
200527AA00214,2005,27AA00,214,1,0,1,eneheuvel,26-09-11
200527AA00302,2005,27AA00,302,1,0,1,eneheuvel,26-09-11
200527AA00303,2005,27AA00,303,1,0,1,eneheuvel,26-09-11
200527AA00305,2005,27AA00,305,0,2,2,eneheuvel,26-09-11
200527AA00306,2005,27AA00,306,1,1,2,eneheuvel,26-09-11
200527AA00307,2005,27AA00,307,3,1,4,eneheuvel,26-09-11
200527AA00308,2005,27AA00,308,2,1,3,eneheuvel,26-09-11
200527AA00312,2005,27AA00,312,1,2,3,eneheuvel,26-09-11
200527AA00502,2005,27AA00,502,2,1,3,eneheuvel,26-09-11
200527AA009999,2005,27AA00,9999,5,2,7,eneheuvel,26-09-11
200527NU00201,2005,27NU00,201,0,1,1,eneheuvel,26-09-11
200527NU00202,2005,27NU00,202,0,1,1,eneheuvel,26-09-11
200527NU00203,2005,27NU00,203,6,2,8,eneheuvel,26-09-11
200527NU00204,2005,27NU00,204,2,0,2,eneheuvel,26-09-11
200527NU00205,2005,27NU00,205,1,0,1,eneheuvel,26-09-11
200527NU00206,2005,27NU00,206,1,0,1,eneheuvel,26-09-11
200527NU00207,2005,27NU00,207,14,6,20,eneheuvel,26-09-11
200527NU00208,2005,27NU00,208,170,82,252,eneheuvel,26-09-11
200527NU00210,2005,27NU00,210,1,0,1,eneheuvel,26-09-11
200527NU00303,2005,27NU00,303,0,1,1,eneheuvel,26-09-11
200527NU00307,2005,27NU00,307,1,1,2,eneheuvel,26-09-11
200527NU00502,2005,27NU00,502,1,0,1,eneheuvel,26-09-11
200527NU009999,2005,27NU00,9999,2,1,3,eneheuvel,26-09-11
200527UB00201,2005,27UB00,201,0,1,1,eneheuvel,26-09-11
200527UB00202,2005,27UB00,202,0,1,1,eneheuvel,26-09-11
200527UB00203,2005,27UB00,203,2,0,2,eneheuvel,26-09-11
200527UB00204,2005,27UB00,204,0,1,1,eneheuvel,26-09-11
200527UB00205,2005,27UB00,205,0,1,1,eneheuvel,26-09-11
200527UB00207,2005,27UB00,207,4,1,5,eneheuvel,26-09-11
200527UB00208,2005,27UB00,208,113,63,176,eneheuvel,26-09-11
200527UB00210,2005,27UB00,210,1,0,1,eneheuvel,26-09-11
200527UB00212,2005,27UB00,212,1,0,1,eneheuvel,26-09-11
200527UB00306,2005,27UB00,306,0,2,2,eneheuvel,26-09-11
200527UB00307,2005,27UB00,307,1,0,1,eneheuvel,26-09-11
200527UB00310,2005,27UB00,310,1,0,1,eneheuvel,26-09-11
200527UB009999,2005,27UB00,9999,1,0,1,eneheuvel,26-09-11
200527XH00210,2005,27XH00,210,2,0,2,eneheuvel,26-09-11
200527XH00211,2005,27XH00,211,0,2,2,eneheuvel,26-09-11
200527XH00212,2005,27XH00,212,4,2,6,eneheuvel,26-09-11
200527XH00214,2005,27XH00,214,1,2,3,eneheuvel,26-09-11
200527XH00215,2005,27XH00,215,3,5,8,eneheuvel,26-09-11
200527XH00216,2005,27XH00,216,23,14,37,eneheuvel,26-09-11
200527XH00302,2005,27XH00,302,0,1,1,eneheuvel,26-09-11
200527XJ00207,2005,27XJ00,207,2,0,2,eneheuvel,26-09-11
200527XJ00302,2005,27XJ00,302,5,3,8,eneheuvel,26-09-11
200527XJ00307,2005,27XJ00,307,2,0,2,eneheuvel,26-09-11
200527XJ00308,2005,27XJ00,308,1,0,1,eneheuvel,26-09-11
200527XJ00309,2005,27XJ00,309,3,0,3,eneheuvel,26-09-11
200527XJ00310,2005,27XJ00,310,0,1,1,eneheuvel,26-09-11
200527XJ00311,2005,27XJ00,311,10,1,11,eneheuvel,26-09-11
200527XJ00312,2005,27XJ00,312,26,13,39,eneheuvel,26-09-11
200527XJ00502,2005,27XJ00,502,0,1,1,eneheuvel,26-09-11
200527XJ009999,2005,27XJ00,9999,1,0,1,eneheuvel,26-09-11
200527YN00202,2005,27YN00,202,1,1,2,eneheuvel,26-09-11
200527YN00206,2005,27YN00,206,0,2,2,eneheuvel,26-09-11
200527YN00207,2005,27YN00,207,1,0,1,eneheuvel,26-09-11
200527YN00210,2005,27YN00,210,0,2,2,eneheuvel,26-09-11
200527YN00212,2005,27YN00,212,1,6,7,eneheuvel,26-09-11
200527YN00214,2005,27YN00,214,0,2,2,eneheuvel,26-09-11
200527YN00215,2005,27YN00,215,1,0,1,eneheuvel,26-09-11
200527YN00216,2005,27YN00,216,23,29,52,eneheuvel,26-09-11
200527YN00302,2005,27YN00,302,1,0,1,eneheuvel,26-09-11
200528AM00207,2005,28AM00,207,2,0,2,eneheuvel,26-09-11
200528AM00211,2005,28AM00,211,0,1,1,eneheuvel,26-09-11
200528AM00311,2005,28AM00,311,1,0,1,eneheuvel,26-09-11
200528AM00312,2005,28AM00,312,13,6,19,eneheuvel,26-09-11
200528BR00207,2005,28BR00,207,0,1,1,eneheuvel,26-09-11
200528BR00208,2005,28BR00,208,1,1,2,eneheuvel,26-09-11
200528BR00211,2005,28BR00,211,1,1,2,eneheuvel,26-09-11
200528BR00212,2005,28BR00,212,2,3,5,eneheuvel,26-09-11
200528BR00213,2005,28BR00,213,0,1,1,eneheuvel,26-09-11
200528BR00302,2005,28BR00,302,1,2,3,eneheuvel,26-09-11
200528BR00303,2005,28BR00,303,2,0,2,eneheuvel,26-09-11
200528BR00306,2005,28BR00,306,2,1,3,eneheuvel,26-09-11
200528BR00307,2005,28BR00,307,1,0,1,eneheuvel,26-09-11
200528BR00309,2005,28BR00,309,1,0,1,eneheuvel,26-09-11
200528BR00311,2005,28BR00,311,5,2,7,eneheuvel,26-09-11
200528BR009999,2005,28BR00,9999,1,0,1,eneheuvel,26-09-11
200606RM00102,2006,06RM00,102,5,0,5,eneheuvel,26-09-11
200606RM00103,2006,06RM00,103,5,0,5,eneheuvel,26-09-11
200606RM00105,2006,06RM00,105,2,1,3,eneheuvel,26-09-11
200606RM00106,2006,06RM00,106,1,0,1,eneheuvel,26-09-11
200606RM00108,2006,06RM00,108,3,1,4,eneheuvel,26-09-11
200606RM00109,2006,06RM00,109,0,3,3,eneheuvel,26-09-11
200606RM00202,2006,06RM00,202,6,10,16,eneheuvel,26-09-11
200606RM00203,2006,06RM00,203,1,0,1,eneheuvel,26-09-11
200606RM00206,2006,06RM00,206,4,6,10,eneheuvel,26-09-11
200606RM00207,2006,06RM00,207,3,2,5,eneheuvel,26-09-11
200606RM00208,2006,06RM00,208,1,5,6,eneheuvel,26-09-11
200606RM00209,2006,06RM00,209,1,0,1,eneheuvel,26-09-11
200606RM00210,2006,06RM00,210,10,4,14,eneheuvel,26-09-11
200606RM00211,2006,06RM00,211,6,5,11,eneheuvel,26-09-11
200606RM00212,2006,06RM00,212,27,37,64,eneheuvel,26-09-11
200606RM00213,2006,06RM00,213,9,5,14,eneheuvel,26-09-11
200606RM00214,2006,06RM00,214,18,12,30,eneheuvel,26-09-11
200606RM00215,2006,06RM00,215,2,2,4,eneheuvel,26-09-11
200606RM00216,2006,06RM00,216,6,4,10,eneheuvel,26-09-11
200606RM00302,2006,06RM00,302,3,6,9,eneheuvel,26-09-11
200606RM00303,2006,06RM00,303,5,5,10,eneheuvel,26-09-11
200606RM00304,2006,06RM00,304,4,2,6,eneheuvel,26-09-11
200606RM00305,2006,06RM00,305,1,0,1,eneheuvel,26-09-11
200606RM00306,2006,06RM00,306,2,1,3,eneheuvel,26-09-11
200606RM00309,2006,06RM00,309,3,4,7,eneheuvel,26-09-11
200606RM00311,2006,06RM00,311,0,4,4,eneheuvel,26-09-11
200606RM00312,2006,06RM00,312,1,2,3,eneheuvel,26-09-11
200606RM00502,2006,06RM00,502,2,4,6,eneheuvel,26-09-11
200606RM009999,2006,06RM00,9999,17,6,23,eneheuvel,26-09-11
200612HU00103,2006,12HU00,103,1,0,1,eneheuvel,26-09-11
200612HU00104,2006,12HU00,104,0,1,1,eneheuvel,26-09-11
200612HU00201,2006,12HU00,201,4,13,17,eneheuvel,26-09-11
200612HU00202,2006,12HU00,202,2,2,4,eneheuvel,26-09-11
200612HU00203,2006,12HU00,203,1,0,1,eneheuvel,26-09-11
200612HU00204,2006,12HU00,204,0,1,1,eneheuvel,26-09-11
200612HU00205,2006,12HU00,205,1,0,1,eneheuvel,26-09-11
200612HU00206,2006,12HU00,206,0,3,3,eneheuvel,26-09-11
200612HU00207,2006,12HU00,207,1,0,1,eneheuvel,26-09-11
200612HU00208,2006,12HU00,208,1,1,2,eneheuvel,26-09-11
200612HU00209,2006,12HU00,209,2,0,2,eneheuvel,26-09-11
200612HU00210,2006,12HU00,210,3,1,4,eneheuvel,26-09-11
200612HU00211,2006,12HU00,211,54,48,102,eneheuvel,26-09-11
200612HU00212,2006,12HU00,212,0,1,1,eneheuvel,26-09-11
200612HU00213,2006,12HU00,213,0,1,1,eneheuvel,26-09-11
200612PM00101,2006,12PM00,101,11,6,17,eneheuvel,26-09-11
200612PM00102,2006,12PM00,102,6,3,9,eneheuvel,26-09-11
200612PM00103,2006,12PM00,103,42,29,71,eneheuvel,26-09-11
200612PM00104,2006,12PM00,104,1,3,4,eneheuvel,26-09-11
200612PM00106,2006,12PM00,106,2,6,8,eneheuvel,26-09-11
200612PM00107,2006,12PM00,107,22,14,36,eneheuvel,26-09-11
200612PM00108,2006,12PM00,108,19,11,30,eneheuvel,26-09-11
200612PM00109,2006,12PM00,109,16,17,33,eneheuvel,26-09-11
200612PM00202,2006,12PM00,202,2,0,2,eneheuvel,26-09-11
200612PM00212,2006,12PM00,212,1,1,2,eneheuvel,26-09-11
200612PM00214,2006,12PM00,214,1,0,1,eneheuvel,26-09-11
200612PM00216,2006,12PM00,216,1,0,1,eneheuvel,26-09-11
200612PM00311,2006,12PM00,311,2,0,2,eneheuvel,26-09-11
200612QK00101,2006,12QK00,101,1,0,1,eneheuvel,26-09-11
200612QK00104,2006,12QK00,104,0,1,1,eneheuvel,26-09-11
200612QK00201,2006,12QK00,201,1,0,1,eneheuvel,26-09-11
200612QK00202,2006,12QK00,202,2,0,2,eneheuvel,26-09-11
200612QK00204,2006,12QK00,204,0,1,1,eneheuvel,26-09-11
200612QK00205,2006,12QK00,205,0,2,2,eneheuvel,26-09-11
200612QK00206,2006,12QK00,206,108,102,210,eneheuvel,26-09-11
200612QK00207,2006,12QK00,207,2,1,3,eneheuvel,26-09-11
200612QK00208,2006,12QK00,208,1,5,6,eneheuvel,26-09-11
200612QK00209,2006,12QK00,209,3,3,6,eneheuvel,26-09-11
200612QK00210,2006,12QK00,210,9,6,15,eneheuvel,26-09-11
200612QK00213,2006,12QK00,213,0,2,2,eneheuvel,26-09-11
200612QK00214,2006,12QK00,214,1,0,1,eneheuvel,26-09-11
200612QK00215,2006,12QK00,215,8,15,23,eneheuvel,26-09-11
200612QK00216,2006,12QK00,216,0,1,1,eneheuvel,26-09-11
200612QK00303,2006,12QK00,303,0,1,1,eneheuvel,26-09-11
200612QK00307,2006,12QK00,307,0,1,1,eneheuvel,26-09-11
200612QK00309,2006,12QK00,309,0,1,1,eneheuvel,26-09-11
200612QK00311,2006,12QK00,311,2,2,4,eneheuvel,26-09-11
200612QK00312,2006,12QK00,312,0,1,1,eneheuvel,26-09-11
200612XA00201,2006,12XA00,201,0,1,1,eneheuvel,26-09-11
200612XA00207,2006,12XA00,207,1,0,1,eneheuvel,26-09-11
200612XA00211,2006,12XA00,211,66,54,120,eneheuvel,26-09-11
200612XA00213,2006,12XA00,213,1,1,2,eneheuvel,26-09-11
200612XA00303,2006,12XA00,303,1,0,1,eneheuvel,26-09-11
200612XA00309,2006,12XA00,309,0,1,1,eneheuvel,26-09-11
200613CW00201,2006,13CW00,201,1,0,1,eneheuvel,26-09-11
200613CW00203,2006,13CW00,203,1,0,1,eneheuvel,26-09-11
200613CW00205,2006,13CW00,205,3,3,6,eneheuvel,26-09-11
200613CW00206,2006,13CW00,206,75,67,142,eneheuvel,26-09-11
200613CW00207,2006,13CW00,207,1,2,3,eneheuvel,26-09-11
200613CW00208,2006,13CW00,208,2,0,2,eneheuvel,26-09-11
200613CW00209,2006,13CW00,209,13,6,19,eneheuvel,26-09-11
200613CW00210,2006,13CW00,210,5,9,14,eneheuvel,26-09-11
200613CW00211,2006,13CW00,211,1,0,1,eneheuvel,26-09-11
200613CW00212,2006,13CW00,212,0,2,2,eneheuvel,26-09-11
200613CW00215,2006,13CW00,215,2,5,7,eneheuvel,26-09-11
200613CW00216,2006,13CW00,216,1,0,1,eneheuvel,26-09-11
200613CW00308,2006,13CW00,308,1,1,2,eneheuvel,26-09-11
200613IF00105,2006,13IF00,105,0,1,1,eneheuvel,26-09-11
200613IF00207,2006,13IF00,207,1,0,1,eneheuvel,26-09-11
200613IF00208,2006,13IF00,208,1,1,2,eneheuvel,26-09-11
200613IF00211,2006,13IF00,211,0,1,1,eneheuvel,26-09-11
200613IF00301,2006,13IF00,301,9,8,17,eneheuvel,26-09-11
200613IF00302,2006,13IF00,302,2,3,5,eneheuvel,26-09-11
200613IF00303,2006,13IF00,303,14,6,20,eneheuvel,26-09-11
200613IF00304,2006,13IF00,304,42,28,70,eneheuvel,26-09-11
200613IF00305,2006,13IF00,305,13,11,24,eneheuvel,26-09-11
200613IF00306,2006,13IF00,306,7,15,22,eneheuvel,26-09-11
200613IF00307,2006,13IF00,307,0,2,2,eneheuvel,26-09-11
200613IF00308,2006,13IF00,308,1,3,4,eneheuvel,26-09-11
200613IF00309,2006,13IF00,309,0,2,2,eneheuvel,26-09-11
200613IF00311,2006,13IF00,311,0,1,1,eneheuvel,26-09-11
200613IU00101,2006,13IU00,101,0,1,1,eneheuvel,26-09-11
200613IU00102,2006,13IU00,102,11,6,17,eneheuvel,26-09-11
200613IU00103,2006,13IU00,103,4,5,9,eneheuvel,26-09-11
200613IU00104,2006,13IU00,104,2,0,2,eneheuvel,26-09-11
200613IU00105,2006,13IU00,105,2,4,6,eneheuvel,26-09-11
200613IU00106,2006,13IU00,106,53,35,88,eneheuvel,26-09-11
200613IU00107,2006,13IU00,107,5,3,8,eneheuvel,26-09-11
200613IU00108,2006,13IU00,108,5,2,7,eneheuvel,26-09-11
200613IU00109,2006,13IU00,109,2,1,3,eneheuvel,26-09-11
200613IU00203,2006,13IU00,203,0,1,1,eneheuvel,26-09-11
200613IU00205,2006,13IU00,205,1,0,1,eneheuvel,26-09-11
200613IU00211,2006,13IU00,211,1,1,2,eneheuvel,26-09-11
200613IU00212,2006,13IU00,212,2,0,2,eneheuvel,26-09-11
200613IU009999,2006,13IU00,9999,0,4,4,eneheuvel,26-09-11
200613NH00101,2006,13NH00,101,6,1,7,eneheuvel,26-09-11
200613NH00102,2006,13NH00,102,10,7,17,eneheuvel,26-09-11
200613NH00103,2006,13NH00,103,3,0,3,eneheuvel,26-09-11
200613NH00104,2006,13NH00,104,21,27,48,eneheuvel,26-09-11
200613NH00105,2006,13NH00,105,55,60,115,eneheuvel,26-09-11
200613NH00106,2006,13NH00,106,3,8,11,eneheuvel,26-09-11
200613NH00107,2006,13NH00,107,2,2,4,eneheuvel,26-09-11
200613NH00109,2006,13NH00,109,0,1,1,eneheuvel,26-09-11
200613NH00110,2006,13NH00,110,3,2,5,eneheuvel,26-09-11
200613NH00202,2006,13NH00,202,0,1,1,eneheuvel,26-09-11
200613NH00203,2006,13NH00,203,0,2,2,eneheuvel,26-09-11
200613NH00211,2006,13NH00,211,1,0,1,eneheuvel,26-09-11
200613NH00213,2006,13NH00,213,1,0,1,eneheuvel,26-09-11
200613NH00301,2006,13NH00,301,1,0,1,eneheuvel,26-09-11
200613NH00305,2006,13NH00,305,0,1,1,eneheuvel,26-09-11
200613NH00502,2006,13NH00,502,1,0,1,eneheuvel,26-09-11
200613NH009999,2006,13NH00,9999,3,0,3,eneheuvel,26-09-11
200613NU00205,2006,13NU00,205,0,1,1,eneheuvel,26-09-11
200613NU00207,2006,13NU00,207,2,0,2,eneheuvel,26-09-11
200613NU00208,2006,13NU00,208,1,1,2,eneheuvel,26-09-11
200613NU00211,2006,13NU00,211,1,0,1,eneheuvel,26-09-11
200613NU00213,2006,13NU00,213,1,1,2,eneheuvel,26-09-11
200613NU00301,2006,13NU00,301,12,9,21,eneheuvel,26-09-11
200613NU00303,2006,13NU00,303,36,43,79,eneheuvel,26-09-11
200613NU00304,2006,13NU00,304,75,63,138,eneheuvel,26-09-11
200613NU00305,2006,13NU00,305,18,16,34,eneheuvel,26-09-11
200613NU00306,2006,13NU00,306,12,9,21,eneheuvel,26-09-11
200613NU00307,2006,13NU00,307,1,2,3,eneheuvel,26-09-11
200613NU00308,2006,13NU00,308,2,12,14,eneheuvel,26-09-11
200613NU00309,2006,13NU00,309,3,3,6,eneheuvel,26-09-11
200613NU00310,2006,13NU00,310,1,2,3,eneheuvel,26-09-11
200613NU00502,2006,13NU00,502,0,1,1,eneheuvel,26-09-11
200613NU009999,2006,13NU00,9999,1,0,1,eneheuvel,26-09-11
200614QC00105,2006,14QC00,105,0,1,1,eneheuvel,26-09-11
200614QC00109,2006,14QC00,109,2,1,3,eneheuvel,26-09-11
200614QC00201,2006,14QC00,201,2,1,3,eneheuvel,26-09-11
200614QC00202,2006,14QC00,202,52,67,119,eneheuvel,26-09-11
200614QC00203,2006,14QC00,203,57,40,97,eneheuvel,26-09-11
200614QC00204,2006,14QC00,204,19,31,50,eneheuvel,26-09-11
200614QC00205,2006,14QC00,205,13,12,25,eneheuvel,26-09-11
200614QC00206,2006,14QC00,206,9,4,13,eneheuvel,26-09-11
200614QC00207,2006,14QC00,207,12,7,19,eneheuvel,26-09-11
200614QC00208,2006,14QC00,208,15,17,32,eneheuvel,26-09-11
200614QC00210,2006,14QC00,210,6,1,7,eneheuvel,26-09-11
200614QC00211,2006,14QC00,211,1,1,2,eneheuvel,26-09-11
200614QC00212,2006,14QC00,212,4,7,11,eneheuvel,26-09-11
200614QC00213,2006,14QC00,213,3,2,5,eneheuvel,26-09-11
200614QC00214,2006,14QC00,214,3,5,8,eneheuvel,26-09-11
200614QC00215,2006,14QC00,215,1,0,1,eneheuvel,26-09-11
200614QC00216,2006,14QC00,216,2,0,2,eneheuvel,26-09-11
200614QC00302,2006,14QC00,302,4,5,9,eneheuvel,26-09-11
200614QC00303,2006,14QC00,303,3,1,4,eneheuvel,26-09-11
200614QC00304,2006,14QC00,304,5,0,5,eneheuvel,26-09-11
200614QC00307,2006,14QC00,307,2,1,3,eneheuvel,26-09-11
200614QC00308,2006,14QC00,308,1,0,1,eneheuvel,26-09-11
200614QC00309,2006,14QC00,309,4,2,6,eneheuvel,26-09-11
200614QC00311,2006,14QC00,311,4,1,5,eneheuvel,26-09-11
200614QC00312,2006,14QC00,312,1,0,1,eneheuvel,26-09-11
200614QC00502,2006,14QC00,502,12,14,26,eneheuvel,26-09-11
200614QC009999,2006,14QC00,9999,0,1,1,eneheuvel,26-09-11
200615SJ00101,2006,15SJ00,101,0,2,2,eneheuvel,26-09-11
200615SJ00102,2006,15SJ00,102,1,2,3,eneheuvel,26-09-11
200615SJ00103,2006,15SJ00,103,0,7,7,eneheuvel,26-09-11
200615SJ00104,2006,15SJ00,104,0,4,4,eneheuvel,26-09-11
200615SJ00105,2006,15SJ00,105,0,1,1,eneheuvel,26-09-11
200615SJ00106,2006,15SJ00,106,0,5,5,eneheuvel,26-09-11
200615SJ00107,2006,15SJ00,107,0,2,2,eneheuvel,26-09-11
200615SJ00108,2006,15SJ00,108,1,4,5,eneheuvel,26-09-11
200615SJ00201,2006,15SJ00,201,1,1,2,eneheuvel,26-09-11
200615SJ00202,2006,15SJ00,202,2,6,8,eneheuvel,26-09-11
200615SJ00203,2006,15SJ00,203,1,8,9,eneheuvel,26-09-11
200615SJ00204,2006,15SJ00,204,2,10,12,eneheuvel,26-09-11
200615SJ00205,2006,15SJ00,205,1,7,8,eneheuvel,26-09-11
200615SJ00206,2006,15SJ00,206,4,26,30,eneheuvel,26-09-11
200615SJ00207,2006,15SJ00,207,4,14,18,eneheuvel,26-09-11
200615SJ00208,2006,15SJ00,208,2,14,16,eneheuvel,26-09-11
200615SJ00209,2006,15SJ00,209,2,12,14,eneheuvel,26-09-11
200615SJ00210,2006,15SJ00,210,4,17,21,eneheuvel,26-09-11
200615SJ00211,2006,15SJ00,211,5,13,18,eneheuvel,26-09-11
200615SJ00212,2006,15SJ00,212,3,18,21,eneheuvel,26-09-11
200615SJ00213,2006,15SJ00,213,1,7,8,eneheuvel,26-09-11
200615SJ00214,2006,15SJ00,214,4,10,14,eneheuvel,26-09-11
200615SJ00301,2006,15SJ00,301,0,4,4,eneheuvel,26-09-11
200615SJ00302,2006,15SJ00,302,1,9,10,eneheuvel,26-09-11
200615SJ00303,2006,15SJ00,303,4,7,11,eneheuvel,26-09-11
200615SJ00304,2006,15SJ00,304,3,7,10,eneheuvel,26-09-11
200615SJ00305,2006,15SJ00,305,2,4,6,eneheuvel,26-09-11
200615SJ00306,2006,15SJ00,306,1,7,8,eneheuvel,26-09-11
200615SJ00307,2006,15SJ00,307,1,8,9,eneheuvel,26-09-11
200615SJ00308,2006,15SJ00,308,1,4,5,eneheuvel,26-09-11
200615SJ00309,2006,15SJ00,309,0,5,5,eneheuvel,26-09-11
200615SJ00311,2006,15SJ00,311,0,6,6,eneheuvel,26-09-11
200615SJ00312,2006,15SJ00,312,0,4,4,eneheuvel,26-09-11
200615SJ009999,2006,15SJ00,9999,1,1,2,eneheuvel,26-09-11
200615ZL00103,2006,15ZL00,103,0,1,1,eneheuvel,26-09-11
200615ZL00107,2006,15ZL00,107,0,1,1,eneheuvel,26-09-11
200615ZL00108,2006,15ZL00,108,1,0,1,eneheuvel,26-09-11
200615ZL00201,2006,15ZL00,201,0,2,2,eneheuvel,26-09-11
200615ZL00204,2006,15ZL00,204,1,1,2,eneheuvel,26-09-11
200615ZL00205,2006,15ZL00,205,1,1,2,eneheuvel,26-09-11
200615ZL00206,2006,15ZL00,206,1,3,4,eneheuvel,26-09-11
200615ZL00207,2006,15ZL00,207,0,1,1,eneheuvel,26-09-11
200615ZL00208,2006,15ZL00,208,0,1,1,eneheuvel,26-09-11
200615ZL00210,2006,15ZL00,210,0,2,2,eneheuvel,26-09-11
200615ZL00302,2006,15ZL00,302,1,7,8,eneheuvel,26-09-11
200615ZL00303,2006,15ZL00,303,4,7,11,eneheuvel,26-09-11
200615ZL00304,2006,15ZL00,304,2,2,4,eneheuvel,26-09-11
200615ZL00305,2006,15ZL00,305,58,43,101,eneheuvel,26-09-11
200615ZL00306,2006,15ZL00,306,9,15,24,eneheuvel,26-09-11
200615ZL00307,2006,15ZL00,307,1,8,9,eneheuvel,26-09-11
200615ZL00308,2006,15ZL00,308,4,3,7,eneheuvel,26-09-11
200615ZL00309,2006,15ZL00,309,7,8,15,eneheuvel,26-09-11
200615ZL00311,2006,15ZL00,311,3,0,3,eneheuvel,26-09-11
200615ZL00313,2006,15ZL00,313,0,2,2,eneheuvel,26-09-11
200615ZL009999,2006,15ZL00,9999,0,2,2,eneheuvel,26-09-11
200615ZL01201,2006,15ZL01,201,0,1,1,eneheuvel,26-09-11
200615ZL01206,2006,15ZL01,206,1,3,4,eneheuvel,26-09-11
200615ZL01207,2006,15ZL01,207,0,1,1,eneheuvel,26-09-11
200615ZL01209,2006,15ZL01,209,10,3,13,eneheuvel,26-09-11
200615ZL01210,2006,15ZL01,210,73,72,145,eneheuvel,26-09-11
200615ZL01212,2006,15ZL01,212,1,6,7,eneheuvel,26-09-11
200615ZL01213,2006,15ZL01,213,1,0,1,eneheuvel,26-09-11
200615ZL01214,2006,15ZL01,214,1,0,1,eneheuvel,26-09-11
200615ZL01215,2006,15ZL01,215,2,7,9,eneheuvel,26-09-11
200615ZL01303,2006,15ZL01,303,1,0,1,eneheuvel,26-09-11
200616CK00102,2006,16CK00,102,0,2,2,eneheuvel,26-09-11
200616CK00103,2006,16CK00,103,0,2,2,eneheuvel,26-09-11
200616CK00104,2006,16CK00,104,0,1,1,eneheuvel,26-09-11
200616CK00106,2006,16CK00,106,0,1,1,eneheuvel,26-09-11
200616CK00201,2006,16CK00,201,1,0,1,eneheuvel,26-09-11
200616CK00202,2006,16CK00,202,5,8,13,eneheuvel,26-09-11
200616CK00203,2006,16CK00,203,3,2,5,eneheuvel,26-09-11
200616CK00204,2006,16CK00,204,1,1,2,eneheuvel,26-09-11
200616CK00205,2006,16CK00,205,1,1,2,eneheuvel,26-09-11
200616CK00206,2006,16CK00,206,0,2,2,eneheuvel,26-09-11
200616CK00207,2006,16CK00,207,0,2,2,eneheuvel,26-09-11
200616CK00208,2006,16CK00,208,3,1,4,eneheuvel,26-09-11
200616CK00209,2006,16CK00,209,1,1,2,eneheuvel,26-09-11
200616CK00210,2006,16CK00,210,2,2,4,eneheuvel,26-09-11
200616CK00211,2006,16CK00,211,4,5,9,eneheuvel,26-09-11
200616CK00212,2006,16CK00,212,0,3,3,eneheuvel,26-09-11
200616CK00213,2006,16CK00,213,2,0,2,eneheuvel,26-09-11
200616CK00214,2006,16CK00,214,2,4,6,eneheuvel,26-09-11
200616CK00216,2006,16CK00,216,0,1,1,eneheuvel,26-09-11
200616CK00302,2006,16CK00,302,2,1,3,eneheuvel,26-09-11
200616CK00303,2006,16CK00,303,0,3,3,eneheuvel,26-09-11
200616CK00304,2006,16CK00,304,3,2,5,eneheuvel,26-09-11
200616CK00305,2006,16CK00,305,4,2,6,eneheuvel,26-09-11
200616CK00306,2006,16CK00,306,2,3,5,eneheuvel,26-09-11
200616CK00307,2006,16CK00,307,0,2,2,eneheuvel,26-09-11
200616CK00308,2006,16CK00,308,0,1,1,eneheuvel,26-09-11
200616CK00309,2006,16CK00,309,2,6,8,eneheuvel,26-09-11
200616CK00311,2006,16CK00,311,2,3,5,eneheuvel,26-09-11
200616CK00312,2006,16CK00,312,0,1,1,eneheuvel,26-09-11
200616CK009999,2006,16CK00,9999,0,1,1,eneheuvel,26-09-11
200616KK00101,2006,16KK00,101,24,10,34,eneheuvel,26-09-11
200616KK00102,2006,16KK00,102,44,50,94,eneheuvel,26-09-11
200616KK00103,2006,16KK00,103,56,48,104,eneheuvel,26-09-11
200616KK00104,2006,16KK00,104,2,3,5,eneheuvel,26-09-11
200616KK00105,2006,16KK00,105,2,3,5,eneheuvel,26-09-11
200616KK00106,2006,16KK00,106,5,5,10,eneheuvel,26-09-11
200616KK00107,2006,16KK00,107,15,14,29,eneheuvel,26-09-11
200616KK00108,2006,16KK00,108,24,31,55,eneheuvel,26-09-11
200616KK00109,2006,16KK00,109,21,14,35,eneheuvel,26-09-11
200616KK00202,2006,16KK00,202,2,0,2,eneheuvel,26-09-11
200616KK00203,2006,16KK00,203,1,1,2,eneheuvel,26-09-11
200616KK00204,2006,16KK00,204,2,1,3,eneheuvel,26-09-11
200616KK00206,2006,16KK00,206,2,0,2,eneheuvel,26-09-11
200616KK00207,2006,16KK00,207,3,0,3,eneheuvel,26-09-11
200616KK00208,2006,16KK00,208,2,0,2,eneheuvel,26-09-11
200616KK00210,2006,16KK00,210,4,0,4,eneheuvel,26-09-11
200616KK00211,2006,16KK00,211,3,1,4,eneheuvel,26-09-11
200616KK00212,2006,16KK00,212,1,1,2,eneheuvel,26-09-11
200616KK00213,2006,16KK00,213,3,1,4,eneheuvel,26-09-11
200616KK00214,2006,16KK00,214,2,3,5,eneheuvel,26-09-11
200616KK00303,2006,16KK00,303,1,0,1,eneheuvel,26-09-11
200616KK00309,2006,16KK00,309,1,0,1,eneheuvel,26-09-11
200616KK00311,2006,16KK00,311,0,2,2,eneheuvel,26-09-11
200616KK00502,2006,16KK00,502,2,2,4,eneheuvel,26-09-11
200616KK009999,2006,16KK00,9999,3,0,3,eneheuvel,26-09-11
200616LJ00101,2006,16LJ00,101,3,3,6,eneheuvel,26-09-11
200616LJ00102,2006,16LJ00,102,3,4,7,eneheuvel,26-09-11
200616LJ00103,2006,16LJ00,103,1,1,2,eneheuvel,26-09-11
200616LJ00104,2006,16LJ00,104,2,4,6,eneheuvel,26-09-11
200616LJ00105,2006,16LJ00,105,2,1,3,eneheuvel,26-09-11
200616LJ00106,2006,16LJ00,106,60,37,97,eneheuvel,26-09-11
200616LJ00107,2006,16LJ00,107,6,5,11,eneheuvel,26-09-11
200616LJ00108,2006,16LJ00,108,2,6,8,eneheuvel,26-09-11
200616LJ00109,2006,16LJ00,109,2,0,2,eneheuvel,26-09-11
200616LJ00201,2006,16LJ00,201,0,1,1,eneheuvel,26-09-11
200616LJ00202,2006,16LJ00,202,1,1,2,eneheuvel,26-09-11
200616LJ00203,2006,16LJ00,203,3,0,3,eneheuvel,26-09-11
200616LJ00205,2006,16LJ00,205,0,1,1,eneheuvel,26-09-11
200616LJ00206,2006,16LJ00,206,0,1,1,eneheuvel,26-09-11
200616LJ00208,2006,16LJ00,208,1,1,2,eneheuvel,26-09-11
200616LJ00209,2006,16LJ00,209,0,2,2,eneheuvel,26-09-11
200616LJ00211,2006,16LJ00,211,0,3,3,eneheuvel,26-09-11
200616LJ00213,2006,16LJ00,213,1,0,1,eneheuvel,26-09-11
200616LJ00214,2006,16LJ00,214,1,0,1,eneheuvel,26-09-11
200616LJ00304,2006,16LJ00,304,0,1,1,eneheuvel,26-09-11
200616LJ00305,2006,16LJ00,305,0,1,1,eneheuvel,26-09-11
200616LJ009999,2006,16LJ00,9999,0,1,1,eneheuvel,26-09-11
200616ML00101,2006,16ML00,101,4,10,14,eneheuvel,26-09-11
200616ML00102,2006,16ML00,102,25,19,44,eneheuvel,26-09-11
200616ML00103,2006,16ML00,103,1,0,1,eneheuvel,26-09-11
200616ML00104,2006,16ML00,104,55,68,123,eneheuvel,26-09-11
200616ML00105,2006,16ML00,105,28,28,56,eneheuvel,26-09-11
200616ML00106,2006,16ML00,106,2,4,6,eneheuvel,26-09-11
200616ML00107,2006,16ML00,107,1,2,3,eneheuvel,26-09-11
200616ML00108,2006,16ML00,108,1,4,5,eneheuvel,26-09-11
200616ML00109,2006,16ML00,109,3,4,7,eneheuvel,26-09-11
200616ML00110,2006,16ML00,110,0,2,2,eneheuvel,26-09-11
200616ML00203,2006,16ML00,203,1,1,2,eneheuvel,26-09-11
200616ML00205,2006,16ML00,205,1,0,1,eneheuvel,26-09-11
200616ML00210,2006,16ML00,210,0,1,1,eneheuvel,26-09-11
200616ML00211,2006,16ML00,211,1,2,3,eneheuvel,26-09-11
200616ML00212,2006,16ML00,212,2,1,3,eneheuvel,26-09-11
200616ML00214,2006,16ML00,214,2,1,3,eneheuvel,26-09-11
200616ML00302,2006,16ML00,302,0,1,1,eneheuvel,26-09-11
200616ML00303,2006,16ML00,303,1,1,2,eneheuvel,26-09-11
200616ML00309,2006,16ML00,309,0,1,1,eneheuvel,26-09-11
200616ML00502,2006,16ML00,502,2,0,2,eneheuvel,26-09-11
200616ML009999,2006,16ML00,9999,2,1,3,eneheuvel,26-09-11
200616OC00101,2006,16OC00,101,1,0,1,eneheuvel,26-09-11
200616OC00102,2006,16OC00,102,2,2,4,eneheuvel,26-09-11
200616OC00103,2006,16OC00,103,4,6,10,eneheuvel,26-09-11
200616OC00104,2006,16OC00,104,0,1,1,eneheuvel,26-09-11
200616OC00105,2006,16OC00,105,0,1,1,eneheuvel,26-09-11
200616OC00106,2006,16OC00,106,1,1,2,eneheuvel,26-09-11
200616OC00107,2006,16OC00,107,61,74,135,eneheuvel,26-09-11
200616OC00108,2006,16OC00,108,19,17,36,eneheuvel,26-09-11
200616OC00109,2006,16OC00,109,49,45,94,eneheuvel,26-09-11
200616OC00201,2006,16OC00,201,0,1,1,eneheuvel,26-09-11
200616OC00203,2006,16OC00,203,0,1,1,eneheuvel,26-09-11
200616OC00204,2006,16OC00,204,0,1,1,eneheuvel,26-09-11
200616OC00207,2006,16OC00,207,1,1,2,eneheuvel,26-09-11
200616OC00208,2006,16OC00,208,0,2,2,eneheuvel,26-09-11
200616OC00211,2006,16OC00,211,1,4,5,eneheuvel,26-09-11
200616OC00214,2006,16OC00,214,1,1,2,eneheuvel,26-09-11
200616OC00302,2006,16OC00,302,1,1,2,eneheuvel,26-09-11
200616OC00304,2006,16OC00,304,1,1,2,eneheuvel,26-09-11
200616OC00307,2006,16OC00,307,0,1,1,eneheuvel,26-09-11
200616OC00309,2006,16OC00,309,1,1,2,eneheuvel,26-09-11
200616OC00311,2006,16OC00,311,0,2,2,eneheuvel,26-09-11
200616UK00101,2006,16UK00,101,0,1,1,eneheuvel,26-09-11
200616UK00102,2006,16UK00,102,0,1,1,eneheuvel,26-09-11
200616UK00103,2006,16UK00,103,3,8,11,eneheuvel,26-09-11
200616UK00106,2006,16UK00,106,0,1,1,eneheuvel,26-09-11
200616UK00108,2006,16UK00,108,75,77,152,eneheuvel,26-09-11
200616UK00109,2006,16UK00,109,1,2,3,eneheuvel,26-09-11
200616UK00210,2006,16UK00,210,1,0,1,eneheuvel,26-09-11
200616UK00212,2006,16UK00,212,1,2,3,eneheuvel,26-09-11
200616UK00306,2006,16UK00,306,0,1,1,eneheuvel,26-09-11
200616UK00311,2006,16UK00,311,1,0,1,eneheuvel,26-09-11
200616UK009999,2006,16UK00,9999,4,0,4,eneheuvel,26-09-11
200616WV00201,2006,16WV00,201,2,4,6,eneheuvel,26-09-11
200616WV00202,2006,16WV00,202,0,1,1,eneheuvel,26-09-11
200616WV00209,2006,16WV00,209,21,20,41,eneheuvel,26-09-11
200616WV00210,2006,16WV00,210,1,3,4,eneheuvel,26-09-11
200616WV00211,2006,16WV00,211,59,52,111,eneheuvel,26-09-11
200616WV00214,2006,16WV00,214,1,0,1,eneheuvel,26-09-11
200616WV00216,2006,16WV00,216,0,1,1,eneheuvel,26-09-11
200616WV009999,2006,16WV00,9999,3,1,4,eneheuvel,26-09-11
200616YS00108,2006,16YS00,108,0,1,1,eneheuvel,26-09-11
200616YS00201,2006,16YS00,201,16,5,21,eneheuvel,26-09-11
200616YS00208,2006,16YS00,208,0,1,1,eneheuvel,26-09-11
200616YS00210,2006,16YS00,210,1,0,1,eneheuvel,26-09-11
200616YS00211,2006,16YS00,211,87,66,153,eneheuvel,26-09-11
200616YS00212,2006,16YS00,212,0,2,2,eneheuvel,26-09-11
200616YS00213,2006,16YS00,213,1,0,1,eneheuvel,26-09-11
200616YS00309,2006,16YS00,309,1,0,1,eneheuvel,26-09-11
200616YS00312,2006,16YS00,312,1,0,1,eneheuvel,26-09-11
200616YS009999,2006,16YS00,9999,1,0,1,eneheuvel,26-09-11
200616ZG00102,2006,16ZG00,102,1,1,2,eneheuvel,26-09-11
200616ZG00202,2006,16ZG00,202,1,1,2,eneheuvel,26-09-11
200616ZG00204,2006,16ZG00,204,0,1,1,eneheuvel,26-09-11
200616ZG00206,2006,16ZG00,206,0,1,1,eneheuvel,26-09-11
200616ZG00208,2006,16ZG00,208,1,0,1,eneheuvel,26-09-11
200616ZG00210,2006,16ZG00,210,1,0,1,eneheuvel,26-09-11
200616ZG00211,2006,16ZG00,211,78,78,156,eneheuvel,26-09-11
200616ZG00212,2006,16ZG00,212,4,1,5,eneheuvel,26-09-11
200616ZG00214,2006,16ZG00,214,2,3,5,eneheuvel,26-09-11
200616ZG00308,2006,16ZG00,308,1,0,1,eneheuvel,26-09-11
200616ZG00309,2006,16ZG00,309,0,1,1,eneheuvel,26-09-11
200616ZX00201,2006,16ZX00,201,1,1,2,eneheuvel,26-09-11
200616ZX00203,2006,16ZX00,203,1,2,3,eneheuvel,26-09-11
200616ZX00204,2006,16ZX00,204,1,0,1,eneheuvel,26-09-11
200616ZX00206,2006,16ZX00,206,20,35,55,eneheuvel,26-09-11
200616ZX00209,2006,16ZX00,209,39,38,77,eneheuvel,26-09-11
200616ZX00210,2006,16ZX00,210,0,2,2,eneheuvel,26-09-11
200616ZX00211,2006,16ZX00,211,0,1,1,eneheuvel,26-09-11
200616ZX00304,2006,16ZX00,304,1,0,1,eneheuvel,26-09-11
200616ZX00305,2006,16ZX00,305,1,0,1,eneheuvel,26-09-11
200616ZX009999,2006,16ZX00,9999,1,1,2,eneheuvel,26-09-11
200617AK00202,2006,17AK00,202,0,1,1,eneheuvel,26-09-11
200617AK00203,2006,17AK00,203,0,3,3,eneheuvel,26-09-11
200617AK00205,2006,17AK00,205,2,2,4,eneheuvel,26-09-11
200617AK00206,2006,17AK00,206,56,55,111,eneheuvel,26-09-11
200617AK00209,2006,17AK00,209,2,0,2,eneheuvel,26-09-11
200617AK00210,2006,17AK00,210,3,2,5,eneheuvel,26-09-11
200617AK00212,2006,17AK00,212,0,1,1,eneheuvel,26-09-11
200617AK00215,2006,17AK00,215,2,2,4,eneheuvel,26-09-11
200617AK00301,2006,17AK00,301,1,0,1,eneheuvel,26-09-11
200617AK00302,2006,17AK00,302,1,1,2,eneheuvel,26-09-11
200617AK00304,2006,17AK00,304,1,1,2,eneheuvel,26-09-11
200617AK00305,2006,17AK00,305,3,4,7,eneheuvel,26-09-11
200617AK00306,2006,17AK00,306,1,0,1,eneheuvel,26-09-11
200617AK00307,2006,17AK00,307,1,1,2,eneheuvel,26-09-11
200617AK00309,2006,17AK00,309,1,2,3,eneheuvel,26-09-11
200617AK00312,2006,17AK00,312,1,0,1,eneheuvel,26-09-11
200617AK009999,2006,17AK00,9999,1,0,1,eneheuvel,26-09-11
200617AV00204,2006,17AV00,204,0,2,2,eneheuvel,26-09-11
200617AV00205,2006,17AV00,205,1,0,1,eneheuvel,26-09-11
200617AV00206,2006,17AV00,206,69,80,149,eneheuvel,26-09-11
200617AV00207,2006,17AV00,207,0,1,1,eneheuvel,26-09-11
200617AV00208,2006,17AV00,208,0,1,1,eneheuvel,26-09-11
200617AV00209,2006,17AV00,209,2,2,4,eneheuvel,26-09-11
200617AV00210,2006,17AV00,210,0,3,3,eneheuvel,26-09-11
200617AV00211,2006,17AV00,211,0,1,1,eneheuvel,26-09-11
200617AV00302,2006,17AV00,302,1,0,1,eneheuvel,26-09-11
200617AV00305,2006,17AV00,305,1,0,1,eneheuvel,26-09-11
200617AV00312,2006,17AV00,312,0,1,1,eneheuvel,26-09-11
200617AV009999,2006,17AV00,9999,2,0,2,eneheuvel,26-09-11
200617BP00201,2006,17BP00,201,0,2,2,eneheuvel,26-09-11
200617BP00203,2006,17BP00,203,2,0,2,eneheuvel,26-09-11
200617BP00208,2006,17BP00,208,1,2,3,eneheuvel,26-09-11
200617BP00211,2006,17BP00,211,49,73,122,eneheuvel,26-09-11
200617BP00212,2006,17BP00,212,4,4,8,eneheuvel,26-09-11
200617BP00213,2006,17BP00,213,77,94,171,eneheuvel,26-09-11
200617BP00214,2006,17BP00,214,0,11,11,eneheuvel,26-09-11
200617BP00303,2006,17BP00,303,0,1,1,eneheuvel,26-09-11
200617BP00312,2006,17BP00,312,1,0,1,eneheuvel,26-09-11
200617DA00102,2006,17DA00,102,0,2,2,eneheuvel,26-09-11
200617DA00201,2006,17DA00,201,1,0,1,eneheuvel,26-09-11
200617DA00209,2006,17DA00,209,17,4,21,eneheuvel,26-09-11
200617DA00210,2006,17DA00,210,55,52,107,eneheuvel,26-09-11
200617DA00211,2006,17DA00,211,0,2,2,eneheuvel,26-09-11
200617DA00215,2006,17DA00,215,0,1,1,eneheuvel,26-09-11
200617DA00302,2006,17DA00,302,2,1,3,eneheuvel,26-09-11
200617DA00307,2006,17DA00,307,1,1,2,eneheuvel,26-09-11
200617DA00309,2006,17DA00,309,1,0,1,eneheuvel,26-09-11
200617DK00206,2006,17DK00,206,1,0,1,eneheuvel,26-09-11
200617DK00207,2006,17DK00,207,1,0,1,eneheuvel,26-09-11
200617DK00301,2006,17DK00,301,4,8,12,eneheuvel,26-09-11
200617DK00302,2006,17DK00,302,1,0,1,eneheuvel,26-09-11
200617DK00303,2006,17DK00,303,1,3,4,eneheuvel,26-09-11
200617DK00304,2006,17DK00,304,25,46,71,eneheuvel,26-09-11
200617DK00305,2006,17DK00,305,1,1,2,eneheuvel,26-09-11
200617DK00306,2006,17DK00,306,0,2,2,eneheuvel,26-09-11
200617DK00309,2006,17DK00,309,3,1,4,eneheuvel,26-09-11
200617DK00311,2006,17DK00,311,0,1,1,eneheuvel,26-09-11
200617DV00106,2006,17DV00,106,0,1,1,eneheuvel,26-09-11
200617DV00108,2006,17DV00,108,1,0,1,eneheuvel,26-09-11
200617DV00202,2006,17DV00,202,1,0,1,eneheuvel,26-09-11
200617DV00203,2006,17DV00,203,0,1,1,eneheuvel,26-09-11
200617DV00204,2006,17DV00,204,2,3,5,eneheuvel,26-09-11
200617DV00207,2006,17DV00,207,0,1,1,eneheuvel,26-09-11
200617DV00208,2006,17DV00,208,1,2,3,eneheuvel,26-09-11
200617DV00209,2006,17DV00,209,1,1,2,eneheuvel,26-09-11
200617DV00211,2006,17DV00,211,1,2,3,eneheuvel,26-09-11
200617DV00301,2006,17DV00,301,12,8,20,eneheuvel,26-09-11
200617DV00302,2006,17DV00,302,3,5,8,eneheuvel,26-09-11
200617DV00303,2006,17DV00,303,29,26,55,eneheuvel,26-09-11
200617DV00304,2006,17DV00,304,46,36,82,eneheuvel,26-09-11
200617DV00305,2006,17DV00,305,7,10,17,eneheuvel,26-09-11
200617DV00306,2006,17DV00,306,11,9,20,eneheuvel,26-09-11
200617DV00307,2006,17DV00,307,11,11,22,eneheuvel,26-09-11
200617DV00308,2006,17DV00,308,13,8,21,eneheuvel,26-09-11
200617DV00309,2006,17DV00,309,16,14,30,eneheuvel,26-09-11
200617DV00310,2006,17DV00,310,1,0,1,eneheuvel,26-09-11
200617DV00311,2006,17DV00,311,6,2,8,eneheuvel,26-09-11
200617DV00312,2006,17DV00,312,0,1,1,eneheuvel,26-09-11
200617DV00502,2006,17DV00,502,1,1,2,eneheuvel,26-09-11
200617DV009999,2006,17DV00,9999,1,0,1,eneheuvel,26-09-11
200617FI00101,2006,17FI00,101,1,1,2,eneheuvel,26-09-11
200617FI00102,2006,17FI00,102,1,2,3,eneheuvel,26-09-11
200617FI00103,2006,17FI00,103,4,7,11,eneheuvel,26-09-11
200617FI00105,2006,17FI00,105,0,1,1,eneheuvel,26-09-11
200617FI00106,2006,17FI00,106,4,2,6,eneheuvel,26-09-11
200617FI00107,2006,17FI00,107,0,2,2,eneheuvel,26-09-11
200617FI00108,2006,17FI00,108,4,2,6,eneheuvel,26-09-11
200617FI00109,2006,17FI00,109,0,1,1,eneheuvel,26-09-11
200617FI00201,2006,17FI00,201,3,0,3,eneheuvel,26-09-11
200617FI00202,2006,17FI00,202,8,20,28,eneheuvel,26-09-11
200617FI00203,2006,17FI00,203,11,7,18,eneheuvel,26-09-11
200617FI00204,2006,17FI00,204,1,7,8,eneheuvel,26-09-11
200617FI00205,2006,17FI00,205,1,5,6,eneheuvel,26-09-11
200617FI00206,2006,17FI00,206,4,11,15,eneheuvel,26-09-11
200617FI00207,2006,17FI00,207,8,2,10,eneheuvel,26-09-11
200617FI00208,2006,17FI00,208,6,11,17,eneheuvel,26-09-11
200617FI00209,2006,17FI00,209,1,2,3,eneheuvel,26-09-11
200617FI00210,2006,17FI00,210,5,9,14,eneheuvel,26-09-11
200617FI00211,2006,17FI00,211,1,4,5,eneheuvel,26-09-11
200617FI00212,2006,17FI00,212,5,7,12,eneheuvel,26-09-11
200617FI00213,2006,17FI00,213,6,5,11,eneheuvel,26-09-11
200617FI00214,2006,17FI00,214,3,7,10,eneheuvel,26-09-11
200617FI00216,2006,17FI00,216,1,1,2,eneheuvel,26-09-11
200617FI00302,2006,17FI00,302,3,5,8,eneheuvel,26-09-11
200617FI00303,2006,17FI00,303,5,2,7,eneheuvel,26-09-11
200617FI00304,2006,17FI00,304,4,4,8,eneheuvel,26-09-11
200617FI00305,2006,17FI00,305,7,9,16,eneheuvel,26-09-11
200617FI00306,2006,17FI00,306,3,4,7,eneheuvel,26-09-11
200617FI00307,2006,17FI00,307,5,5,10,eneheuvel,26-09-11
200617FI00308,2006,17FI00,308,1,3,4,eneheuvel,26-09-11
200617FI00309,2006,17FI00,309,7,6,13,eneheuvel,26-09-11
200617FI00310,2006,17FI00,310,0,1,1,eneheuvel,26-09-11
200617FI00311,2006,17FI00,311,2,3,5,eneheuvel,26-09-11
200617FI00312,2006,17FI00,312,2,1,3,eneheuvel,26-09-11
200617FI00502,2006,17FI00,502,1,1,2,eneheuvel,26-09-11
200617FI009999,2006,17FI00,9999,2,2,4,eneheuvel,26-09-11
200617LP00202,2006,17LP00,202,0,2,2,eneheuvel,26-09-11
200617LP00207,2006,17LP00,207,3,2,5,eneheuvel,26-09-11
200617LP00211,2006,17LP00,211,1,0,1,eneheuvel,26-09-11
200617LP00302,2006,17LP00,302,1,0,1,eneheuvel,26-09-11
200617LP00304,2006,17LP00,304,5,0,5,eneheuvel,26-09-11
200617LP00305,2006,17LP00,305,49,55,104,eneheuvel,26-09-11
200617LP00306,2006,17LP00,306,3,4,7,eneheuvel,26-09-11
200617LP00307,2006,17LP00,307,0,2,2,eneheuvel,26-09-11
200617LP00308,2006,17LP00,308,1,1,2,eneheuvel,26-09-11
200617LP00309,2006,17LP00,309,1,0,1,eneheuvel,26-09-11
200617LP009999,2006,17LP00,9999,5,3,8,eneheuvel,26-09-11
200617MH00202,2006,17MH00,202,2,0,2,eneheuvel,26-09-11
200617MH00207,2006,17MH00,207,0,1,1,eneheuvel,26-09-11
200617MH00210,2006,17MH00,210,2,1,3,eneheuvel,26-09-11
200617MH00212,2006,17MH00,212,1,0,1,eneheuvel,26-09-11
200617MH00216,2006,17MH00,216,1,0,1,eneheuvel,26-09-11
200617MH00302,2006,17MH00,302,1,4,5,eneheuvel,26-09-11
200617MH00303,2006,17MH00,303,0,1,1,eneheuvel,26-09-11
200617MH00304,2006,17MH00,304,0,2,2,eneheuvel,26-09-11
200617MH00305,2006,17MH00,305,70,73,143,eneheuvel,26-09-11
200617MH00306,2006,17MH00,306,6,0,6,eneheuvel,26-09-11
200617MH00307,2006,17MH00,307,0,1,1,eneheuvel,26-09-11
200617MH00311,2006,17MH00,311,0,1,1,eneheuvel,26-09-11
200621KO00106,2006,21KO00,106,0,1,1,eneheuvel,26-09-11
200621KO00202,2006,21KO00,202,1,1,2,eneheuvel,26-09-11
200621KO00209,2006,21KO00,209,2,5,7,eneheuvel,26-09-11
200621KO00210,2006,21KO00,210,87,116,203,eneheuvel,26-09-11
200621KO00211,2006,21KO00,211,2,0,2,eneheuvel,26-09-11
200621KO00212,2006,21KO00,212,0,3,3,eneheuvel,26-09-11
200621KO00216,2006,21KO00,216,1,3,4,eneheuvel,26-09-11
200621KO00309,2006,21KO00,309,0,2,2,eneheuvel,26-09-11
200621KO009999,2006,21KO00,9999,0,1,1,eneheuvel,26-09-11
200621NC00103,2006,21NC00,103,1,0,1,eneheuvel,26-09-11
200621NC00208,2006,21NC00,208,0,1,1,eneheuvel,26-09-11
200621NC00211,2006,21NC00,211,3,0,3,eneheuvel,26-09-11
200621NC00212,2006,21NC00,212,3,2,5,eneheuvel,26-09-11
200621NC00213,2006,21NC00,213,48,52,100,eneheuvel,26-09-11
200621NC00214,2006,21NC00,214,3,1,4,eneheuvel,26-09-11
200621NC00215,2006,21NC00,215,0,2,2,eneheuvel,26-09-11
200621NC00302,2006,21NC00,302,1,0,1,eneheuvel,26-09-11
200621NC00303,2006,21NC00,303,1,0,1,eneheuvel,26-09-11
200621NC00305,2006,21NC00,305,1,0,1,eneheuvel,26-09-11
200621NC00308,2006,21NC00,308,0,1,1,eneheuvel,26-09-11
200621NC00309,2006,21NC00,309,1,0,1,eneheuvel,26-09-11
200621NC009999,2006,21NC00,9999,0,1,1,eneheuvel,26-09-11
200621ND00201,2006,21ND00,201,0,1,1,eneheuvel,26-09-11
200621ND00209,2006,21ND00,209,1,0,1,eneheuvel,26-09-11
200621ND00210,2006,21ND00,210,0,2,2,eneheuvel,26-09-11
200621ND00211,2006,21ND00,211,8,6,14,eneheuvel,26-09-11
200621ND00212,2006,21ND00,212,4,3,7,eneheuvel,26-09-11
200621ND00213,2006,21ND00,213,90,112,202,eneheuvel,26-09-11
200621ND00214,2006,21ND00,214,0,5,5,eneheuvel,26-09-11
200621ND00302,2006,21ND00,302,0,1,1,eneheuvel,26-09-11
200621ND00304,2006,21ND00,304,0,1,1,eneheuvel,26-09-11
200621ND00312,2006,21ND00,312,3,0,3,eneheuvel,26-09-11
200621ND009999,2006,21ND00,9999,1,1,2,eneheuvel,26-09-11
200622KP00203,2006,22KP00,203,1,0,1,eneheuvel,26-09-11
200622KP00207,2006,22KP00,207,0,2,2,eneheuvel,26-09-11
200622KP00208,2006,22KP00,208,0,2,2,eneheuvel,26-09-11
200622KP00211,2006,22KP00,211,0,1,1,eneheuvel,26-09-11
200622KP00301,2006,22KP00,301,3,3,6,eneheuvel,26-09-11
200622KP00302,2006,22KP00,302,5,4,9,eneheuvel,26-09-11
200622KP00303,2006,22KP00,303,3,5,8,eneheuvel,26-09-11
200622KP00304,2006,22KP00,304,1,1,2,eneheuvel,26-09-11
200622KP00306,2006,22KP00,306,1,2,3,eneheuvel,26-09-11
200622KP00308,2006,22KP00,308,3,5,8,eneheuvel,26-09-11
200622KP00309,2006,22KP00,309,151,154,305,eneheuvel,26-09-11
200622KP00310,2006,22KP00,310,2,3,5,eneheuvel,26-09-11
200622KP00311,2006,22KP00,311,13,20,33,eneheuvel,26-09-11
200622KP00312,2006,22KP00,312,1,2,3,eneheuvel,26-09-11
200622KP00313,2006,22KP00,313,0,1,1,eneheuvel,26-09-11
200622KP009999,2006,22KP00,9999,1,0,1,eneheuvel,26-09-11
200622KQ00105,2006,22KQ00,105,0,1,1,eneheuvel,26-09-11
200622KQ00202,2006,22KQ00,202,0,1,1,eneheuvel,26-09-11
200622KQ00205,2006,22KQ00,205,1,1,2,eneheuvel,26-09-11
200622KQ00206,2006,22KQ00,206,1,0,1,eneheuvel,26-09-11
200622KQ00208,2006,22KQ00,208,1,0,1,eneheuvel,26-09-11
200622KQ00209,2006,22KQ00,209,1,1,2,eneheuvel,26-09-11
200622KQ00210,2006,22KQ00,210,91,111,202,eneheuvel,26-09-11
200622KQ00211,2006,22KQ00,211,1,1,2,eneheuvel,26-09-11
200622KQ00212,2006,22KQ00,212,0,2,2,eneheuvel,26-09-11
200622KQ00213,2006,22KQ00,213,0,1,1,eneheuvel,26-09-11
200622KQ00214,2006,22KQ00,214,1,1,2,eneheuvel,26-09-11
200622KQ00215,2006,22KQ00,215,0,1,1,eneheuvel,26-09-11
200622KQ00216,2006,22KQ00,216,1,1,2,eneheuvel,26-09-11
200622KQ00307,2006,22KQ00,307,1,0,1,eneheuvel,26-09-11
200622KQ00312,2006,22KQ00,312,3,1,4,eneheuvel,26-09-11
200622KQ009999,2006,22KQ00,9999,0,1,1,eneheuvel,26-09-11
200623EP00201,2006,23EP00,201,1,1,2,eneheuvel,26-09-11
200623EP00202,2006,23EP00,202,1,2,3,eneheuvel,26-09-11
200623EP00205,2006,23EP00,205,0,1,1,eneheuvel,26-09-11
200623EP00209,2006,23EP00,209,2,1,3,eneheuvel,26-09-11
200623EP00211,2006,23EP00,211,1,0,1,eneheuvel,26-09-11
200623EP00212,2006,23EP00,212,31,60,91,eneheuvel,26-09-11
200623EP00213,2006,23EP00,213,5,9,14,eneheuvel,26-09-11
200623EP00214,2006,23EP00,214,1,3,4,eneheuvel,26-09-11
200623EP009999,2006,23EP00,9999,1,0,1,eneheuvel,26-09-11
200623ER00101,2006,23ER00,101,1,1,2,eneheuvel,26-09-11
200623ER00202,2006,23ER00,202,1,0,1,eneheuvel,26-09-11
200623ER00208,2006,23ER00,208,1,0,1,eneheuvel,26-09-11
200623ER00210,2006,23ER00,210,0,1,1,eneheuvel,26-09-11
200623ER00211,2006,23ER00,211,0,2,2,eneheuvel,26-09-11
200623ER00212,2006,23ER00,212,105,106,211,eneheuvel,26-09-11
200623ER00213,2006,23ER00,213,0,3,3,eneheuvel,26-09-11
200623ER00214,2006,23ER00,214,4,2,6,eneheuvel,26-09-11
200623ET00107,2006,23ET00,107,0,2,2,eneheuvel,26-09-11
200623ET00201,2006,23ET00,201,1,0,1,eneheuvel,26-09-11
200623ET00202,2006,23ET00,202,0,2,2,eneheuvel,26-09-11
200623ET00203,2006,23ET00,203,1,0,1,eneheuvel,26-09-11
200623ET00206,2006,23ET00,206,0,1,1,eneheuvel,26-09-11
200623ET00208,2006,23ET00,208,1,0,1,eneheuvel,26-09-11
200623ET00210,2006,23ET00,210,0,1,1,eneheuvel,26-09-11
200623ET00211,2006,23ET00,211,2,2,4,eneheuvel,26-09-11
200623ET00212,2006,23ET00,212,2,0,2,eneheuvel,26-09-11
200623ET00214,2006,23ET00,214,1,0,1,eneheuvel,26-09-11
200623ET00302,2006,23ET00,302,2,2,4,eneheuvel,26-09-11
200623ET00303,2006,23ET00,303,2,2,4,eneheuvel,26-09-11
200623ET00304,2006,23ET00,304,0,1,1,eneheuvel,26-09-11
200623ET00305,2006,23ET00,305,0,1,1,eneheuvel,26-09-11
200623ET00306,2006,23ET00,306,2,6,8,eneheuvel,26-09-11
200623ET00307,2006,23ET00,307,10,11,21,eneheuvel,26-09-11
200623ET00308,2006,23ET00,308,71,103,174,eneheuvel,26-09-11
200623ET00309,2006,23ET00,309,11,3,14,eneheuvel,26-09-11
200623ET00311,2006,23ET00,311,2,3,5,eneheuvel,26-09-11
200623ET00312,2006,23ET00,312,2,1,3,eneheuvel,26-09-11
200623ET00502,2006,23ET00,502,0,1,1,eneheuvel,26-09-11
200623EU00102,2006,23EU00,102,0,1,1,eneheuvel,26-09-11
200623EU00107,2006,23EU00,107,1,0,1,eneheuvel,26-09-11
200623EU00207,2006,23EU00,207,2,1,3,eneheuvel,26-09-11
200623EU00208,2006,23EU00,208,0,2,2,eneheuvel,26-09-11
200623EU00301,2006,23EU00,301,1,2,3,eneheuvel,26-09-11
200623EU00303,2006,23EU00,303,2,0,2,eneheuvel,26-09-11
200623EU00305,2006,23EU00,305,6,8,14,eneheuvel,26-09-11
200623EU00306,2006,23EU00,306,111,125,236,eneheuvel,26-09-11
200623EU00307,2006,23EU00,307,8,5,13,eneheuvel,26-09-11
200623EU00309,2006,23EU00,309,2,4,6,eneheuvel,26-09-11
200623EU00310,2006,23EU00,310,1,0,1,eneheuvel,26-09-11
200623EU00311,2006,23EU00,311,0,1,1,eneheuvel,26-09-11
200623EU00313,2006,23EU00,313,0,2,2,eneheuvel,26-09-11
200623EU009999,2006,23EU00,9999,2,0,2,eneheuvel,26-09-11
200623EV00102,2006,23EV00,102,0,1,1,eneheuvel,26-09-11
200623EV00201,2006,23EV00,201,1,0,1,eneheuvel,26-09-11
200623EV00203,2006,23EV00,203,2,0,2,eneheuvel,26-09-11
200623EV00207,2006,23EV00,207,1,1,2,eneheuvel,26-09-11
200623EV00208,2006,23EV00,208,0,1,1,eneheuvel,26-09-11
200623EV00209,2006,23EV00,209,2,1,3,eneheuvel,26-09-11
200623EV00210,2006,23EV00,210,16,8,24,eneheuvel,26-09-11
200623EV00211,2006,23EV00,211,10,9,19,eneheuvel,26-09-11
200623EV00212,2006,23EV00,212,133,141,274,eneheuvel,26-09-11
200623EV00213,2006,23EV00,213,22,36,58,eneheuvel,26-09-11
200623EV00214,2006,23EV00,214,4,7,11,eneheuvel,26-09-11
200623EV00215,2006,23EV00,215,1,1,2,eneheuvel,26-09-11
200623EV00216,2006,23EV00,216,2,3,5,eneheuvel,26-09-11
200623EV00303,2006,23EV00,303,1,0,1,eneheuvel,26-09-11
200623EV00306,2006,23EV00,306,0,1,1,eneheuvel,26-09-11
200623EV00307,2006,23EV00,307,2,0,2,eneheuvel,26-09-11
200623EV00309,2006,23EV00,309,1,0,1,eneheuvel,26-09-11
200623EV009999,2006,23EV00,9999,1,0,1,eneheuvel,26-09-11
200623EY00102,2006,23EY00,102,1,0,1,eneheuvel,26-09-11
200623EY00201,2006,23EY00,201,2,0,2,eneheuvel,26-09-11
200623EY00204,2006,23EY00,204,1,0,1,eneheuvel,26-09-11
200623EY00206,2006,23EY00,206,1,1,2,eneheuvel,26-09-11
200623EY00207,2006,23EY00,207,1,2,3,eneheuvel,26-09-11
200623EY00208,2006,23EY00,208,2,1,3,eneheuvel,26-09-11
200623EY00209,2006,23EY00,209,0,1,1,eneheuvel,26-09-11
200623EY00210,2006,23EY00,210,11,2,13,eneheuvel,26-09-11
200623EY00211,2006,23EY00,211,9,4,13,eneheuvel,26-09-11
200623EY00212,2006,23EY00,212,130,126,256,eneheuvel,26-09-11
200623EY00213,2006,23EY00,213,28,19,47,eneheuvel,26-09-11
200623EY00214,2006,23EY00,214,2,6,8,eneheuvel,26-09-11
200623EY00215,2006,23EY00,215,1,0,1,eneheuvel,26-09-11
200623EY00216,2006,23EY00,216,0,1,1,eneheuvel,26-09-11
200623EY00312,2006,23EY00,312,0,1,1,eneheuvel,26-09-11
200623EY00502,2006,23EY00,502,0,1,1,eneheuvel,26-09-11
200623EY009999,2006,23EY00,9999,1,1,2,eneheuvel,26-09-11
200623ZU00201,2006,23ZU00,201,2,2,4,eneheuvel,26-09-11
200623ZU00202,2006,23ZU00,202,88,94,182,eneheuvel,26-09-11
200623ZU00203,2006,23ZU00,203,5,6,11,eneheuvel,26-09-11
200623ZU00204,2006,23ZU00,204,45,56,101,eneheuvel,26-09-11
200623ZU00205,2006,23ZU00,205,103,90,193,eneheuvel,26-09-11
200623ZU00206,2006,23ZU00,206,1,2,3,eneheuvel,26-09-11
200623ZU00207,2006,23ZU00,207,21,14,35,eneheuvel,26-09-11
200623ZU00208,2006,23ZU00,208,17,22,39,eneheuvel,26-09-11
200623ZU00209,2006,23ZU00,209,0,1,1,eneheuvel,26-09-11
200623ZU00210,2006,23ZU00,210,1,0,1,eneheuvel,26-09-11
200623ZU00211,2006,23ZU00,211,2,5,7,eneheuvel,26-09-11
200623ZU00212,2006,23ZU00,212,0,2,2,eneheuvel,26-09-11
200623ZU00214,2006,23ZU00,214,1,0,1,eneheuvel,26-09-11
200623ZU00215,2006,23ZU00,215,2,1,3,eneheuvel,26-09-11
200623ZU00302,2006,23ZU00,302,3,1,4,eneheuvel,26-09-11
200623ZU00303,2006,23ZU00,303,1,4,5,eneheuvel,26-09-11
200623ZU00306,2006,23ZU00,306,2,2,4,eneheuvel,26-09-11
200623ZU00307,2006,23ZU00,307,0,1,1,eneheuvel,26-09-11
200623ZU00309,2006,23ZU00,309,1,1,2,eneheuvel,26-09-11
200623ZU00310,2006,23ZU00,310,0,1,1,eneheuvel,26-09-11
200623ZU00311,2006,23ZU00,311,0,1,1,eneheuvel,26-09-11
200623ZU00502,2006,23ZU00,502,1,4,5,eneheuvel,26-09-11
200623ZU009999,2006,23ZU00,9999,1,3,4,eneheuvel,26-09-11
200623ZV00107,2006,23ZV00,107,1,0,1,eneheuvel,26-09-11
200623ZV00110,2006,23ZV00,110,0,1,1,eneheuvel,26-09-11
200623ZV00201,2006,23ZV00,201,2,1,3,eneheuvel,26-09-11
200623ZV00202,2006,23ZV00,202,42,46,88,eneheuvel,26-09-11
200623ZV00203,2006,23ZV00,203,5,8,13,eneheuvel,26-09-11
200623ZV00204,2006,23ZV00,204,23,43,66,eneheuvel,26-09-11
200623ZV00205,2006,23ZV00,205,53,76,129,eneheuvel,26-09-11
200623ZV00206,2006,23ZV00,206,0,1,1,eneheuvel,26-09-11
200623ZV00207,2006,23ZV00,207,8,13,21,eneheuvel,26-09-11
200623ZV00208,2006,23ZV00,208,6,10,16,eneheuvel,26-09-11
200623ZV00210,2006,23ZV00,210,1,0,1,eneheuvel,26-09-11
200623ZV00211,2006,23ZV00,211,1,0,1,eneheuvel,26-09-11
200623ZV00214,2006,23ZV00,214,1,0,1,eneheuvel,26-09-11
200623ZV00216,2006,23ZV00,216,1,0,1,eneheuvel,26-09-11
200623ZV00303,2006,23ZV00,303,1,1,2,eneheuvel,26-09-11
200623ZV00305,2006,23ZV00,305,0,1,1,eneheuvel,26-09-11
200623ZV00308,2006,23ZV00,308,1,0,1,eneheuvel,26-09-11
200623ZV009999,2006,23ZV00,9999,1,0,1,eneheuvel,26-09-11
200623ZW00206,2006,23ZW00,206,0,1,1,eneheuvel,26-09-11
200623ZW00207,2006,23ZW00,207,1,0,1,eneheuvel,26-09-11
200623ZW00208,2006,23ZW00,208,3,5,8,eneheuvel,26-09-11
200623ZW00210,2006,23ZW00,210,0,1,1,eneheuvel,26-09-11
200623ZW00301,2006,23ZW00,301,1,0,1,eneheuvel,26-09-11
200623ZW00302,2006,23ZW00,302,4,3,7,eneheuvel,26-09-11
200623ZW00303,2006,23ZW00,303,5,9,14,eneheuvel,26-09-11
200623ZW00304,2006,23ZW00,304,4,0,4,eneheuvel,26-09-11
200623ZW00305,2006,23ZW00,305,2,0,2,eneheuvel,26-09-11
200623ZW00306,2006,23ZW00,306,31,35,66,eneheuvel,26-09-11
200623ZW00307,2006,23ZW00,307,82,73,155,eneheuvel,26-09-11
200623ZW00308,2006,23ZW00,308,103,95,198,eneheuvel,26-09-11
200623ZW00309,2006,23ZW00,309,5,3,8,eneheuvel,26-09-11
200623ZW00310,2006,23ZW00,310,2,0,2,eneheuvel,26-09-11
200623ZW00312,2006,23ZW00,312,2,1,3,eneheuvel,26-09-11
200623ZW00313,2006,23ZW00,313,0,2,2,eneheuvel,26-09-11
200623ZW00502,2006,23ZW00,502,1,3,4,eneheuvel,26-09-11
200623ZW009999,2006,23ZW00,9999,2,2,4,eneheuvel,26-09-11
200623ZX00103,2006,23ZX00,103,0,1,1,eneheuvel,26-09-11
200623ZX00105,2006,23ZX00,105,0,1,1,eneheuvel,26-09-11
200623ZX00106,2006,23ZX00,106,1,0,1,eneheuvel,26-09-11
200623ZX00110,2006,23ZX00,110,1,1,2,eneheuvel,26-09-11
200623ZX00201,2006,23ZX00,201,7,3,10,eneheuvel,26-09-11
200623ZX00202,2006,23ZX00,202,141,129,270,eneheuvel,26-09-11
200623ZX00204,2006,23ZX00,204,3,5,8,eneheuvel,26-09-11
200623ZX00205,2006,23ZX00,205,1,2,3,eneheuvel,26-09-11
200623ZX00206,2006,23ZX00,206,0,1,1,eneheuvel,26-09-11
200623ZX00207,2006,23ZX00,207,2,2,4,eneheuvel,26-09-11
200623ZX00208,2006,23ZX00,208,3,4,7,eneheuvel,26-09-11
200623ZX00209,2006,23ZX00,209,2,1,3,eneheuvel,26-09-11
200623ZX00211,2006,23ZX00,211,2,3,5,eneheuvel,26-09-11
200623ZX00311,2006,23ZX00,311,1,0,1,eneheuvel,26-09-11
200623ZY00109,2006,23ZY00,109,0,2,2,eneheuvel,26-09-11
200623ZY00210,2006,23ZY00,210,2,2,4,eneheuvel,26-09-11
200623ZY00211,2006,23ZY00,211,2,3,5,eneheuvel,26-09-11
200623ZY00212,2006,23ZY00,212,173,236,409,eneheuvel,26-09-11
200623ZY00213,2006,23ZY00,213,0,1,1,eneheuvel,26-09-11
200623ZY00214,2006,23ZY00,214,1,1,2,eneheuvel,26-09-11
200623ZY00216,2006,23ZY00,216,0,1,1,eneheuvel,26-09-11
200623ZY00302,2006,23ZY00,302,0,1,1,eneheuvel,26-09-11
200623ZY00305,2006,23ZY00,305,0,1,1,eneheuvel,26-09-11
200623ZY009999,2006,23ZY00,9999,1,0,1,eneheuvel,26-09-11
200624EJ00102,2006,24EJ00,102,4,5,9,eneheuvel,26-09-11
200624EJ00103,2006,24EJ00,103,4,6,10,eneheuvel,26-09-11
200624EJ00106,2006,24EJ00,106,2,2,4,eneheuvel,26-09-11
200624EJ00107,2006,24EJ00,107,3,0,3,eneheuvel,26-09-11
200624EJ00202,2006,24EJ00,202,6,5,11,eneheuvel,26-09-11
200624EJ00203,2006,24EJ00,203,2,2,4,eneheuvel,26-09-11
200624EJ00204,2006,24EJ00,204,8,5,13,eneheuvel,26-09-11
200624EJ00205,2006,24EJ00,205,0,2,2,eneheuvel,26-09-11
200624EJ00206,2006,24EJ00,206,1,5,6,eneheuvel,26-09-11
200624EJ00207,2006,24EJ00,207,3,5,8,eneheuvel,26-09-11
200624EJ00208,2006,24EJ00,208,7,6,13,eneheuvel,26-09-11
200624EJ00209,2006,24EJ00,209,16,9,25,eneheuvel,26-09-11
200624EJ00210,2006,24EJ00,210,24,9,33,eneheuvel,26-09-11
200624EJ00211,2006,24EJ00,211,30,20,50,eneheuvel,26-09-11
200624EJ00212,2006,24EJ00,212,13,8,21,eneheuvel,26-09-11
200624EJ00213,2006,24EJ00,213,7,5,12,eneheuvel,26-09-11
200624EJ00214,2006,24EJ00,214,4,6,10,eneheuvel,26-09-11
200624EJ00302,2006,24EJ00,302,2,2,4,eneheuvel,26-09-11
200624EJ00303,2006,24EJ00,303,2,2,4,eneheuvel,26-09-11
200624EJ00304,2006,24EJ00,304,1,2,3,eneheuvel,26-09-11
200624EJ00305,2006,24EJ00,305,0,3,3,eneheuvel,26-09-11
200624EJ00306,2006,24EJ00,306,0,1,1,eneheuvel,26-09-11
200624EJ00307,2006,24EJ00,307,3,0,3,eneheuvel,26-09-11
200624EJ00308,2006,24EJ00,308,1,1,2,eneheuvel,26-09-11
200624EJ00309,2006,24EJ00,309,1,1,2,eneheuvel,26-09-11
200624EJ00311,2006,24EJ00,311,1,0,1,eneheuvel,26-09-11
200624EJ00312,2006,24EJ00,312,1,2,3,eneheuvel,26-09-11
200624EJ009999,2006,24EJ00,9999,6,1,7,eneheuvel,26-09-11
200624FT00102,2006,24FT00,102,1,1,2,eneheuvel,26-09-11
200624FT00103,2006,24FT00,103,0,1,1,eneheuvel,26-09-11
200624FT00105,2006,24FT00,105,0,4,4,eneheuvel,26-09-11
200624FT00106,2006,24FT00,106,1,1,2,eneheuvel,26-09-11
200624FT00110,2006,24FT00,110,0,1,1,eneheuvel,26-09-11
200624FT00202,2006,24FT00,202,1,6,7,eneheuvel,26-09-11
200624FT00203,2006,24FT00,203,0,2,2,eneheuvel,26-09-11
200624FT00204,2006,24FT00,204,1,7,8,eneheuvel,26-09-11
200624FT00205,2006,24FT00,205,1,5,6,eneheuvel,26-09-11
200624FT00206,2006,24FT00,206,0,8,8,eneheuvel,26-09-11
200624FT00207,2006,24FT00,207,0,2,2,eneheuvel,26-09-11
200624FT00208,2006,24FT00,208,2,9,11,eneheuvel,26-09-11
200624FT00209,2006,24FT00,209,2,1,3,eneheuvel,26-09-11
200624FT00210,2006,24FT00,210,0,4,4,eneheuvel,26-09-11
200624FT00211,2006,24FT00,211,5,10,15,eneheuvel,26-09-11
200624FT00212,2006,24FT00,212,4,11,15,eneheuvel,26-09-11
200624FT00213,2006,24FT00,213,2,8,10,eneheuvel,26-09-11
200624FT00214,2006,24FT00,214,6,12,18,eneheuvel,26-09-11
200624FT00216,2006,24FT00,216,0,1,1,eneheuvel,26-09-11
200624FT00302,2006,24FT00,302,1,10,11,eneheuvel,26-09-11
200624FT00303,2006,24FT00,303,1,11,12,eneheuvel,26-09-11
200624FT00304,2006,24FT00,304,0,3,3,eneheuvel,26-09-11
200624FT00305,2006,24FT00,305,1,1,2,eneheuvel,26-09-11
200624FT00306,2006,24FT00,306,0,1,1,eneheuvel,26-09-11
200624FT00307,2006,24FT00,307,0,3,3,eneheuvel,26-09-11
200624FT00308,2006,24FT00,308,1,15,16,eneheuvel,26-09-11
200624FT00309,2006,24FT00,309,1,7,8,eneheuvel,26-09-11
200624FT00311,2006,24FT00,311,0,12,12,eneheuvel,26-09-11
200624FT00312,2006,24FT00,312,1,8,9,eneheuvel,26-09-11
200624FT00502,2006,24FT00,502,0,2,2,eneheuvel,26-09-11
200624FT009999,2006,24FT00,9999,5,0,5,eneheuvel,26-09-11
200624MR00201,2006,24MR00,201,2,1,3,eneheuvel,26-09-11
200624MR00207,2006,24MR00,207,1,1,2,eneheuvel,26-09-11
200624MR00208,2006,24MR00,208,1,4,5,eneheuvel,26-09-11
200624MR00209,2006,24MR00,209,0,1,1,eneheuvel,26-09-11
200624MR00210,2006,24MR00,210,1,0,1,eneheuvel,26-09-11
200624MR00213,2006,24MR00,213,2,0,2,eneheuvel,26-09-11
200624MR00301,2006,24MR00,301,1,0,1,eneheuvel,26-09-11
200624MR00302,2006,24MR00,302,0,1,1,eneheuvel,26-09-11
200624MR00303,2006,24MR00,303,0,1,1,eneheuvel,26-09-11
200624MR00304,2006,24MR00,304,1,1,2,eneheuvel,26-09-11
200624MR00305,2006,24MR00,305,1,2,3,eneheuvel,26-09-11
200624MR00306,2006,24MR00,306,16,20,36,eneheuvel,26-09-11
200624MR00307,2006,24MR00,307,141,180,321,eneheuvel,26-09-11
200624MR00308,2006,24MR00,308,5,15,20,eneheuvel,26-09-11
200624MR00310,2006,24MR00,310,0,1,1,eneheuvel,26-09-11
200624MR00311,2006,24MR00,311,0,2,2,eneheuvel,26-09-11
200624MR00312,2006,24MR00,312,0,1,1,eneheuvel,26-09-11
200624MR00502,2006,24MR00,502,1,1,2,eneheuvel,26-09-11
200624MR009999,2006,24MR00,9999,1,0,1,eneheuvel,26-09-11
200624RK00108,2006,24RK00,108,0,1,1,eneheuvel,26-09-11
200624RK00202,2006,24RK00,202,23,16,39,eneheuvel,26-09-11
200624RK00203,2006,24RK00,203,12,15,27,eneheuvel,26-09-11
200624RK00204,2006,24RK00,204,16,13,29,eneheuvel,26-09-11
200624RK00205,2006,24RK00,205,6,8,14,eneheuvel,26-09-11
200624RK00206,2006,24RK00,206,2,2,4,eneheuvel,26-09-11
200624RK00207,2006,24RK00,207,9,3,12,eneheuvel,26-09-11
200624RK00208,2006,24RK00,208,4,5,9,eneheuvel,26-09-11
200624RK00210,2006,24RK00,210,0,3,3,eneheuvel,26-09-11
200624RK00212,2006,24RK00,212,1,3,4,eneheuvel,26-09-11
200624RK00213,2006,24RK00,213,2,1,3,eneheuvel,26-09-11
200624RK00214,2006,24RK00,214,3,1,4,eneheuvel,26-09-11
200624RK00216,2006,24RK00,216,1,1,2,eneheuvel,26-09-11
200624RK00301,2006,24RK00,301,1,1,2,eneheuvel,26-09-11
200624RK00302,2006,24RK00,302,7,1,8,eneheuvel,26-09-11
200624RK00303,2006,24RK00,303,7,3,10,eneheuvel,26-09-11
200624RK00304,2006,24RK00,304,3,4,7,eneheuvel,26-09-11
200624RK00305,2006,24RK00,305,0,5,5,eneheuvel,26-09-11
200624RK00306,2006,24RK00,306,5,4,9,eneheuvel,26-09-11
200624RK00307,2006,24RK00,307,4,3,7,eneheuvel,26-09-11
200624RK00308,2006,24RK00,308,3,4,7,eneheuvel,26-09-11
200624RK00309,2006,24RK00,309,3,1,4,eneheuvel,26-09-11
200624UN00201,2006,24UN00,201,1,0,1,eneheuvel,26-09-11
200624UN00202,2006,24UN00,202,1,0,1,eneheuvel,26-09-11
200624UN00208,2006,24UN00,208,0,2,2,eneheuvel,26-09-11
200624UN00214,2006,24UN00,214,1,0,1,eneheuvel,26-09-11
200624UN00216,2006,24UN00,216,0,1,1,eneheuvel,26-09-11
200624UN00302,2006,24UN00,302,0,1,1,eneheuvel,26-09-11
200624UN00303,2006,24UN00,303,3,2,5,eneheuvel,26-09-11
200624UN00306,2006,24UN00,306,30,27,57,eneheuvel,26-09-11
200624UN00307,2006,24UN00,307,64,29,93,eneheuvel,26-09-11
200624UN00308,2006,24UN00,308,56,68,124,eneheuvel,26-09-11
200624UN00309,2006,24UN00,309,23,19,42,eneheuvel,26-09-11
200624UN00310,2006,24UN00,310,0,2,2,eneheuvel,26-09-11
200624UN00311,2006,24UN00,311,5,2,7,eneheuvel,26-09-11
200624UN00502,2006,24UN00,502,0,1,1,eneheuvel,26-09-11
200624UN009999,2006,24UN00,9999,3,0,3,eneheuvel,26-09-11
200625CF00202,2006,25CF00,202,7,5,12,eneheuvel,26-09-11
200625CF00203,2006,25CF00,203,6,10,16,eneheuvel,26-09-11
200625CF00204,2006,25CF00,204,71,100,171,eneheuvel,26-09-11
200625CF00205,2006,25CF00,205,39,54,93,eneheuvel,26-09-11
200625CF00206,2006,25CF00,206,1,0,1,eneheuvel,26-09-11
200625CF00207,2006,25CF00,207,4,5,9,eneheuvel,26-09-11
200625CF00208,2006,25CF00,208,4,7,11,eneheuvel,26-09-11
200625CF00209,2006,25CF00,209,0,3,3,eneheuvel,26-09-11
200625CF00210,2006,25CF00,210,2,0,2,eneheuvel,26-09-11
200625CF00302,2006,25CF00,302,0,1,1,eneheuvel,26-09-11
200625CF00303,2006,25CF00,303,0,2,2,eneheuvel,26-09-11
200625CF00307,2006,25CF00,307,0,1,1,eneheuvel,26-09-11
200625CF00308,2006,25CF00,308,0,2,2,eneheuvel,26-09-11
200625CF009999,2006,25CF00,9999,4,2,6,eneheuvel,26-09-11
200625KT00107,2006,25KT00,107,0,1,1,eneheuvel,26-09-11
200625KT00202,2006,25KT00,202,52,55,107,eneheuvel,26-09-11
200625KT00203,2006,25KT00,203,101,56,157,eneheuvel,26-09-11
200625KT00204,2006,25KT00,204,85,88,173,eneheuvel,26-09-11
200625KT00205,2006,25KT00,205,9,7,16,eneheuvel,26-09-11
200625KT00207,2006,25KT00,207,16,2,18,eneheuvel,26-09-11
200625KT00208,2006,25KT00,208,44,22,66,eneheuvel,26-09-11
200625KT00211,2006,25KT00,211,1,0,1,eneheuvel,26-09-11
200625KT00212,2006,25KT00,212,0,1,1,eneheuvel,26-09-11
200625KT00306,2006,25KT00,306,1,0,1,eneheuvel,26-09-11
200625KT00312,2006,25KT00,312,0,1,1,eneheuvel,26-09-11
200625KT00502,2006,25KT00,502,14,9,23,eneheuvel,26-09-11
200625KT009999,2006,25KT00,9999,2,0,2,eneheuvel,26-09-11
200625KU00110,2006,25KU00,110,2,0,2,eneheuvel,26-09-11
200625KU00201,2006,25KU00,201,0,1,1,eneheuvel,26-09-11
200625KU00202,2006,25KU00,202,31,30,61,eneheuvel,26-09-11
200625KU00203,2006,25KU00,203,65,38,103,eneheuvel,26-09-11
200625KU00204,2006,25KU00,204,84,77,161,eneheuvel,26-09-11
200625KU00205,2006,25KU00,205,3,0,3,eneheuvel,26-09-11
200625KU00206,2006,25KU00,206,1,0,1,eneheuvel,26-09-11
200625KU00207,2006,25KU00,207,13,5,18,eneheuvel,26-09-11
200625KU00208,2006,25KU00,208,32,28,60,eneheuvel,26-09-11
200625KU00210,2006,25KU00,210,1,0,1,eneheuvel,26-09-11
200625KU00216,2006,25KU00,216,1,0,1,eneheuvel,26-09-11
200625KU00309,2006,25KU00,309,1,0,1,eneheuvel,26-09-11
200625KU00502,2006,25KU00,502,7,13,20,eneheuvel,26-09-11
200625KU009999,2006,25KU00,9999,1,0,1,eneheuvel,26-09-11
200625KV00201,2006,25KV00,201,0,1,1,eneheuvel,26-09-11
200625KV00202,2006,25KV00,202,1,6,7,eneheuvel,26-09-11
200625KV00203,2006,25KV00,203,205,179,384,eneheuvel,26-09-11
200625KV00204,2006,25KV00,204,9,11,20,eneheuvel,26-09-11
200625KV00205,2006,25KV00,205,1,2,3,eneheuvel,26-09-11
200625KV00208,2006,25KV00,208,7,10,17,eneheuvel,26-09-11
200625KV00211,2006,25KV00,211,2,2,4,eneheuvel,26-09-11
200625KV00212,2006,25KV00,212,0,1,1,eneheuvel,26-09-11
200625KV00302,2006,25KV00,302,0,1,1,eneheuvel,26-09-11
200625KV00309,2006,25KV00,309,0,1,1,eneheuvel,26-09-11
200625KV00312,2006,25KV00,312,0,1,1,eneheuvel,26-09-11
200625KV009999,2006,25KV00,9999,4,0,4,eneheuvel,26-09-11
200626AB00103,2006,26AB00,103,1,0,1,eneheuvel,26-09-11
200626AB00206,2006,26AB00,206,0,1,1,eneheuvel,26-09-11
200626AB00207,2006,26AB00,207,1,0,1,eneheuvel,26-09-11
200626AB00208,2006,26AB00,208,0,1,1,eneheuvel,26-09-11
200626AB00209,2006,26AB00,209,1,0,1,eneheuvel,26-09-11
200626AB00301,2006,26AB00,301,0,1,1,eneheuvel,26-09-11
200626AB00302,2006,26AB00,302,16,16,32,eneheuvel,26-09-11
200626AB00303,2006,26AB00,303,201,194,395,eneheuvel,26-09-11
200626AB00304,2006,26AB00,304,5,2,7,eneheuvel,26-09-11
200626AB00305,2006,26AB00,305,1,1,2,eneheuvel,26-09-11
200626AB00306,2006,26AB00,306,3,1,4,eneheuvel,26-09-11
200626AB00308,2006,26AB00,308,1,1,2,eneheuvel,26-09-11
200626AB00309,2006,26AB00,309,3,1,4,eneheuvel,26-09-11
200626AB00310,2006,26AB00,310,1,0,1,eneheuvel,26-09-11
200626AB00311,2006,26AB00,311,5,4,9,eneheuvel,26-09-11
200626AB00312,2006,26AB00,312,0,1,1,eneheuvel,26-09-11
200626AB00313,2006,26AB00,313,3,3,6,eneheuvel,26-09-11
200626AB009999,2006,26AB00,9999,2,2,4,eneheuvel,26-09-11
200626AC00101,2006,26AC00,101,0,1,1,eneheuvel,26-09-11
200626AC00102,2006,26AC00,102,1,0,1,eneheuvel,26-09-11
200626AC00107,2006,26AC00,107,1,2,3,eneheuvel,26-09-11
200626AC00109,2006,26AC00,109,20,6,26,eneheuvel,26-09-11
200626AC00201,2006,26AC00,201,0,1,1,eneheuvel,26-09-11
200626AC00202,2006,26AC00,202,1,0,1,eneheuvel,26-09-11
200626AC00203,2006,26AC00,203,0,1,1,eneheuvel,26-09-11
200626AC00204,2006,26AC00,204,1,0,1,eneheuvel,26-09-11
200626AC00206,2006,26AC00,206,2,0,2,eneheuvel,26-09-11
200626AC00208,2006,26AC00,208,0,1,1,eneheuvel,26-09-11
200626AC00209,2006,26AC00,209,1,0,1,eneheuvel,26-09-11
200626AC00211,2006,26AC00,211,6,5,11,eneheuvel,26-09-11
200626AC00212,2006,26AC00,212,15,19,34,eneheuvel,26-09-11
200626AC00213,2006,26AC00,213,16,24,40,eneheuvel,26-09-11
200626AC00214,2006,26AC00,214,490,329,819,eneheuvel,26-09-11
200626AC00215,2006,26AC00,215,1,0,1,eneheuvel,26-09-11
200626AC00301,2006,26AC00,301,1,0,1,eneheuvel,26-09-11
200626AC00302,2006,26AC00,302,2,0,2,eneheuvel,26-09-11
200626AC00305,2006,26AC00,305,1,0,1,eneheuvel,26-09-11
200626AC00306,2006,26AC00,306,3,0,3,eneheuvel,26-09-11
200626AC00307,2006,26AC00,307,4,0,4,eneheuvel,26-09-11
200626AC00308,2006,26AC00,308,0,1,1,eneheuvel,26-09-11
200626AC00311,2006,26AC00,311,2,2,4,eneheuvel,26-09-11
200626AC00312,2006,26AC00,312,2,2,4,eneheuvel,26-09-11
200626AC009999,2006,26AC00,9999,2,0,2,eneheuvel,26-09-11
200626AD00108,2006,26AD00,108,1,0,1,eneheuvel,26-09-11
200626AD00203,2006,26AD00,203,0,1,1,eneheuvel,26-09-11
200626AD00205,2006,26AD00,205,0,1,1,eneheuvel,26-09-11
200626AD00207,2006,26AD00,207,0,1,1,eneheuvel,26-09-11
200626AD00208,2006,26AD00,208,1,0,1,eneheuvel,26-09-11
200626AD00214,2006,26AD00,214,1,0,1,eneheuvel,26-09-11
200626AD00301,2006,26AD00,301,0,1,1,eneheuvel,26-09-11
200626AD00302,2006,26AD00,302,97,73,170,eneheuvel,26-09-11
200626AD00303,2006,26AD00,303,37,21,58,eneheuvel,26-09-11
200626AD00305,2006,26AD00,305,3,1,4,eneheuvel,26-09-11
200626AD00306,2006,26AD00,306,3,1,4,eneheuvel,26-09-11
200626AD00307,2006,26AD00,307,0,2,2,eneheuvel,26-09-11
200626AD00308,2006,26AD00,308,1,0,1,eneheuvel,26-09-11
200626AD00309,2006,26AD00,309,65,38,103,eneheuvel,26-09-11
200626AD00310,2006,26AD00,310,14,5,19,eneheuvel,26-09-11
200626AD00311,2006,26AD00,311,52,40,92,eneheuvel,26-09-11
200626AD00312,2006,26AD00,312,8,2,10,eneheuvel,26-09-11
200626AD00313,2006,26AD00,313,6,6,12,eneheuvel,26-09-11
200626AD00502,2006,26AD00,502,1,2,3,eneheuvel,26-09-11
200626AD009999,2006,26AD00,9999,1,1,2,eneheuvel,26-09-11
200626PD00104,2006,26PD00,104,1,0,1,eneheuvel,26-09-11
200626PD00203,2006,26PD00,203,1,1,2,eneheuvel,26-09-11
200626PD00204,2006,26PD00,204,1,1,2,eneheuvel,26-09-11
200626PD00205,2006,26PD00,205,5,6,11,eneheuvel,26-09-11
200626PD00207,2006,26PD00,207,178,221,399,eneheuvel,26-09-11
200626PD00208,2006,26PD00,208,43,77,120,eneheuvel,26-09-11
200626PD00210,2006,26PD00,210,1,0,1,eneheuvel,26-09-11
200626PD00211,2006,26PD00,211,1,0,1,eneheuvel,26-09-11
200626PD00212,2006,26PD00,212,0,3,3,eneheuvel,26-09-11
200626PD00302,2006,26PD00,302,1,0,1,eneheuvel,26-09-11
200626PD00306,2006,26PD00,306,0,2,2,eneheuvel,26-09-11
200626PD00502,2006,26PD00,502,2,1,3,eneheuvel,26-09-11
200626PD009999,2006,26PD00,9999,4,0,4,eneheuvel,26-09-11
200626PE00201,2006,26PE00,201,1,0,1,eneheuvel,26-09-11
200626PE00205,2006,26PE00,205,0,1,1,eneheuvel,26-09-11
200626PE00210,2006,26PE00,210,1,0,1,eneheuvel,26-09-11
200626PE00211,2006,26PE00,211,1,1,2,eneheuvel,26-09-11
200626PE00213,2006,26PE00,213,1,0,1,eneheuvel,26-09-11
200626PE00301,2006,26PE00,301,1,0,1,eneheuvel,26-09-11
200626PE00302,2006,26PE00,302,263,240,503,eneheuvel,26-09-11
200626PE00303,2006,26PE00,303,17,12,29,eneheuvel,26-09-11
200626PE00304,2006,26PE00,304,0,1,1,eneheuvel,26-09-11
200626PE00306,2006,26PE00,306,2,1,3,eneheuvel,26-09-11
200626PE00307,2006,26PE00,307,0,1,1,eneheuvel,26-09-11
200626PE00308,2006,26PE00,308,0,1,1,eneheuvel,26-09-11
200626PE00309,2006,26PE00,309,2,1,3,eneheuvel,26-09-11
200626PE00310,2006,26PE00,310,0,1,1,eneheuvel,26-09-11
200626PE00311,2006,26PE00,311,2,7,9,eneheuvel,26-09-11
200626PE00312,2006,26PE00,312,1,2,3,eneheuvel,26-09-11
200626PE009999,2006,26PE00,9999,4,0,4,eneheuvel,26-09-11
200626PF00102,2006,26PF00,102,0,1,1,eneheuvel,26-09-11
200626PF00201,2006,26PF00,201,1,0,1,eneheuvel,26-09-11
200626PF00202,2006,26PF00,202,1,2,3,eneheuvel,26-09-11
200626PF00206,2006,26PF00,206,2,0,2,eneheuvel,26-09-11
200626PF00207,2006,26PF00,207,0,1,1,eneheuvel,26-09-11
200626PF00208,2006,26PF00,208,3,1,4,eneheuvel,26-09-11
200626PF00209,2006,26PF00,209,1,1,2,eneheuvel,26-09-11
200626PF00211,2006,26PF00,211,5,2,7,eneheuvel,26-09-11
200626PF00212,2006,26PF00,212,5,5,10,eneheuvel,26-09-11
200626PF00213,2006,26PF00,213,0,5,5,eneheuvel,26-09-11
200626PF00214,2006,26PF00,214,203,183,386,eneheuvel,26-09-11
200626PF00216,2006,26PF00,216,0,1,1,eneheuvel,26-09-11
200626PF00302,2006,26PF00,302,0,1,1,eneheuvel,26-09-11
200626PF00303,2006,26PF00,303,1,2,3,eneheuvel,26-09-11
200626PF00308,2006,26PF00,308,1,0,1,eneheuvel,26-09-11
200626PF00309,2006,26PF00,309,1,0,1,eneheuvel,26-09-11
200626PF00311,2006,26PF00,311,1,0,1,eneheuvel,26-09-11
200626PF00312,2006,26PF00,312,0,1,1,eneheuvel,26-09-11
200626PF009999,2006,26PF00,9999,4,0,4,eneheuvel,26-09-11
200626PG00108,2006,26PG00,108,1,0,1,eneheuvel,26-09-11
200626PG00207,2006,26PG00,207,1,0,1,eneheuvel,26-09-11
200626PG00209,2006,26PG00,209,0,1,1,eneheuvel,26-09-11
200626PG00210,2006,26PG00,210,1,0,1,eneheuvel,26-09-11
200626PG00211,2006,26PG00,211,0,1,1,eneheuvel,26-09-11
200626PG00212,2006,26PG00,212,0,4,4,eneheuvel,26-09-11
200626PG00213,2006,26PG00,213,1,0,1,eneheuvel,26-09-11
200626PG00214,2006,26PG00,214,76,108,184,eneheuvel,26-09-11
200626PG00304,2006,26PG00,304,0,1,1,eneheuvel,26-09-11
200626PG009999,2006,26PG00,9999,4,0,4,eneheuvel,26-09-11
200626PH00206,2006,26PH00,206,1,0,1,eneheuvel,26-09-11
200626PH00208,2006,26PH00,208,1,0,1,eneheuvel,26-09-11
200626PH00209,2006,26PH00,209,1,0,1,eneheuvel,26-09-11
200626PH00211,2006,26PH00,211,1,0,1,eneheuvel,26-09-11
200626PH00216,2006,26PH00,216,0,1,1,eneheuvel,26-09-11
200626PH00302,2006,26PH00,302,28,9,37,eneheuvel,26-09-11
200626PH00303,2006,26PH00,303,12,6,18,eneheuvel,26-09-11
200626PH00305,2006,26PH00,305,2,1,3,eneheuvel,26-09-11
200626PH00306,2006,26PH00,306,1,0,1,eneheuvel,26-09-11
200626PH00307,2006,26PH00,307,2,1,3,eneheuvel,26-09-11
200626PH00308,2006,26PH00,308,3,0,3,eneheuvel,26-09-11
200626PH00309,2006,26PH00,309,46,19,65,eneheuvel,26-09-11
200626PH00311,2006,26PH00,311,271,178,449,eneheuvel,26-09-11
200626PH00312,2006,26PH00,312,13,6,19,eneheuvel,26-09-11
200626PH00313,2006,26PH00,313,6,3,9,eneheuvel,26-09-11
200626PH009999,2006,26PH00,9999,2,0,2,eneheuvel,26-09-11
200626PW00208,2006,26PW00,208,3,0,3,eneheuvel,26-09-11
200626PW00302,2006,26PW00,302,52,33,85,eneheuvel,26-09-11
200626PW00303,2006,26PW00,303,40,16,56,eneheuvel,26-09-11
200626PW00305,2006,26PW00,305,0,1,1,eneheuvel,26-09-11
200626PW00307,2006,26PW00,307,1,1,2,eneheuvel,26-09-11
200626PW00308,2006,26PW00,308,4,1,5,eneheuvel,26-09-11
200626PW00309,2006,26PW00,309,41,21,62,eneheuvel,26-09-11
200626PW00310,2006,26PW00,310,8,3,11,eneheuvel,26-09-11
200626PW00311,2006,26PW00,311,28,26,54,eneheuvel,26-09-11
200626PW00312,2006,26PW00,312,4,2,6,eneheuvel,26-09-11
200626PW00313,2006,26PW00,313,6,1,7,eneheuvel,26-09-11
200626PW009999,2006,26PW00,9999,2,0,2,eneheuvel,26-09-11
200626ZZ00103,2006,26ZZ00,103,0,1,1,eneheuvel,26-09-11
200626ZZ00105,2006,26ZZ00,105,1,0,1,eneheuvel,26-09-11
200626ZZ00202,2006,26ZZ00,202,239,212,451,eneheuvel,26-09-11
200626ZZ00203,2006,26ZZ00,203,15,6,21,eneheuvel,26-09-11
200626ZZ00204,2006,26ZZ00,204,3,2,5,eneheuvel,26-09-11
200626ZZ00205,2006,26ZZ00,205,1,0,1,eneheuvel,26-09-11
200626ZZ00206,2006,26ZZ00,206,2,0,2,eneheuvel,26-09-11
200626ZZ00208,2006,26ZZ00,208,3,5,8,eneheuvel,26-09-11
200626ZZ00209,2006,26ZZ00,209,1,1,2,eneheuvel,26-09-11
200626ZZ00210,2006,26ZZ00,210,3,1,4,eneheuvel,26-09-11
200626ZZ00211,2006,26ZZ00,211,0,1,1,eneheuvel,26-09-11
200626ZZ00214,2006,26ZZ00,214,1,2,3,eneheuvel,26-09-11
200626ZZ00308,2006,26ZZ00,308,0,1,1,eneheuvel,26-09-11
200626ZZ00309,2006,26ZZ00,309,0,1,1,eneheuvel,26-09-11
200626ZZ00311,2006,26ZZ00,311,0,1,1,eneheuvel,26-09-11
200626ZZ00312,2006,26ZZ00,312,1,0,1,eneheuvel,26-09-11
200626ZZ00502,2006,26ZZ00,502,1,1,2,eneheuvel,26-09-11
200626ZZ009999,2006,26ZZ00,9999,3,0,3,eneheuvel,26-09-11
200627AA00106,2006,27AA00,106,0,1,1,eneheuvel,26-09-11
200627AA00201,2006,27AA00,201,1,0,1,eneheuvel,26-09-11
200627AA00202,2006,27AA00,202,1,1,2,eneheuvel,26-09-11
200627AA00203,2006,27AA00,203,6,1,7,eneheuvel,26-09-11
200627AA00204,2006,27AA00,204,15,6,21,eneheuvel,26-09-11
200627AA00205,2006,27AA00,205,7,3,10,eneheuvel,26-09-11
200627AA00206,2006,27AA00,206,1,0,1,eneheuvel,26-09-11
200627AA00207,2006,27AA00,207,73,50,123,eneheuvel,26-09-11
200627AA00208,2006,27AA00,208,173,149,322,eneheuvel,26-09-11
200627AA00209,2006,27AA00,209,0,1,1,eneheuvel,26-09-11
200627AA00210,2006,27AA00,210,2,0,2,eneheuvel,26-09-11
200627AA00211,2006,27AA00,211,0,1,1,eneheuvel,26-09-11
200627AA00212,2006,27AA00,212,0,2,2,eneheuvel,26-09-11
200627AA00214,2006,27AA00,214,3,1,4,eneheuvel,26-09-11
200627AA00303,2006,27AA00,303,1,0,1,eneheuvel,26-09-11
200627AA00305,2006,27AA00,305,0,2,2,eneheuvel,26-09-11
200627AA00306,2006,27AA00,306,0,1,1,eneheuvel,26-09-11
200627AA00307,2006,27AA00,307,3,0,3,eneheuvel,26-09-11
200627AA00308,2006,27AA00,308,2,1,3,eneheuvel,26-09-11
200627AA00312,2006,27AA00,312,1,1,2,eneheuvel,26-09-11
200627AA009999,2006,27AA00,9999,2,0,2,eneheuvel,26-09-11
200627NU00108,2006,27NU00,108,1,0,1,eneheuvel,26-09-11
200627NU00203,2006,27NU00,203,8,3,11,eneheuvel,26-09-11
200627NU00204,2006,27NU00,204,1,3,4,eneheuvel,26-09-11
200627NU00205,2006,27NU00,205,1,0,1,eneheuvel,26-09-11
200627NU00206,2006,27NU00,206,1,0,1,eneheuvel,26-09-11
200627NU00207,2006,27NU00,207,18,6,24,eneheuvel,26-09-11
200627NU00208,2006,27NU00,208,170,89,259,eneheuvel,26-09-11
200627NU00210,2006,27NU00,210,1,0,1,eneheuvel,26-09-11
200627NU00211,2006,27NU00,211,1,0,1,eneheuvel,26-09-11
200627NU00303,2006,27NU00,303,0,1,1,eneheuvel,26-09-11
200627NU00309,2006,27NU00,309,1,0,1,eneheuvel,26-09-11
200627NU00502,2006,27NU00,502,1,0,1,eneheuvel,26-09-11
200627UB00201,2006,27UB00,201,0,1,1,eneheuvel,26-09-11
200627UB00202,2006,27UB00,202,2,0,2,eneheuvel,26-09-11
200627UB00203,2006,27UB00,203,3,1,4,eneheuvel,26-09-11
200627UB00204,2006,27UB00,204,0,1,1,eneheuvel,26-09-11
200627UB00207,2006,27UB00,207,4,0,4,eneheuvel,26-09-11
200627UB00208,2006,27UB00,208,141,69,210,eneheuvel,26-09-11
200627UB00211,2006,27UB00,211,2,0,2,eneheuvel,26-09-11
200627UB00301,2006,27UB00,301,0,1,1,eneheuvel,26-09-11
200627UB00303,2006,27UB00,303,1,0,1,eneheuvel,26-09-11
200627UB00305,2006,27UB00,305,1,0,1,eneheuvel,26-09-11
200627UB00306,2006,27UB00,306,3,1,4,eneheuvel,26-09-11
200627UB00307,2006,27UB00,307,1,0,1,eneheuvel,26-09-11
200627UB00309,2006,27UB00,309,1,1,2,eneheuvel,26-09-11
200627UB00310,2006,27UB00,310,1,0,1,eneheuvel,26-09-11
200627UB00311,2006,27UB00,311,1,0,1,eneheuvel,26-09-11
200627UB00502,2006,27UB00,502,2,2,4,eneheuvel,26-09-11
200627UB009999,2006,27UB00,9999,4,0,4,eneheuvel,26-09-11
200627XH00206,2006,27XH00,206,1,2,3,eneheuvel,26-09-11
200627XH00208,2006,27XH00,208,1,0,1,eneheuvel,26-09-11
200627XH00209,2006,27XH00,209,1,1,2,eneheuvel,26-09-11
200627XH00210,2006,27XH00,210,6,1,7,eneheuvel,26-09-11
200627XH00211,2006,27XH00,211,1,0,1,eneheuvel,26-09-11
200627XH00212,2006,27XH00,212,2,4,6,eneheuvel,26-09-11
200627XH00214,2006,27XH00,214,4,0,4,eneheuvel,26-09-11
200627XH00215,2006,27XH00,215,10,16,26,eneheuvel,26-09-11
200627XH00216,2006,27XH00,216,41,38,79,eneheuvel,26-09-11
200627XJ00201,2006,27XJ00,201,1,0,1,eneheuvel,26-09-11
200627XJ00206,2006,27XJ00,206,1,0,1,eneheuvel,26-09-11
200627XJ00216,2006,27XJ00,216,1,0,1,eneheuvel,26-09-11
200627XJ00302,2006,27XJ00,302,10,1,11,eneheuvel,26-09-11
200627XJ00303,2006,27XJ00,303,5,0,5,eneheuvel,26-09-11
200627XJ00305,2006,27XJ00,305,0,1,1,eneheuvel,26-09-11
200627XJ00306,2006,27XJ00,306,2,0,2,eneheuvel,26-09-11
200627XJ00307,2006,27XJ00,307,1,0,1,eneheuvel,26-09-11
200627XJ00308,2006,27XJ00,308,0,1,1,eneheuvel,26-09-11
200627XJ00309,2006,27XJ00,309,1,1,2,eneheuvel,26-09-11
200627XJ00310,2006,27XJ00,310,1,0,1,eneheuvel,26-09-11
200627XJ00311,2006,27XJ00,311,17,0,17,eneheuvel,26-09-11
200627XJ00312,2006,27XJ00,312,57,24,81,eneheuvel,26-09-11
200627XJ00313,2006,27XJ00,313,4,5,9,eneheuvel,26-09-11
200627XJ00502,2006,27XJ00,502,1,3,4,eneheuvel,26-09-11
200627XJ009999,2006,27XJ00,9999,2,0,2,eneheuvel,26-09-11
200627YN00109,2006,27YN00,109,1,0,1,eneheuvel,26-09-11
200627YN00202,2006,27YN00,202,1,1,2,eneheuvel,26-09-11
200627YN00203,2006,27YN00,203,0,1,1,eneheuvel,26-09-11
200627YN00206,2006,27YN00,206,0,3,3,eneheuvel,26-09-11
200627YN00210,2006,27YN00,210,0,2,2,eneheuvel,26-09-11
200627YN00212,2006,27YN00,212,0,2,2,eneheuvel,26-09-11
200627YN00215,2006,27YN00,215,2,0,2,eneheuvel,26-09-11
200627YN00216,2006,27YN00,216,37,38,75,eneheuvel,26-09-11
200627YN00302,2006,27YN00,302,1,0,1,eneheuvel,26-09-11
200627YN00308,2006,27YN00,308,0,1,1,eneheuvel,26-09-11
200627YN00309,2006,27YN00,309,0,3,3,eneheuvel,26-09-11
200628AM00105,2006,28AM00,105,1,2,3,eneheuvel,26-09-11
200628AM00106,2006,28AM00,106,1,0,1,eneheuvel,26-09-11
200628AM00203,2006,28AM00,203,2,0,2,eneheuvel,26-09-11
200628AM00204,2006,28AM00,204,0,1,1,eneheuvel,26-09-11
200628AM00208,2006,28AM00,208,1,0,1,eneheuvel,26-09-11
200628AM00211,2006,28AM00,211,0,2,2,eneheuvel,26-09-11
200628AM00214,2006,28AM00,214,1,1,2,eneheuvel,26-09-11
200628AM00302,2006,28AM00,302,2,1,3,eneheuvel,26-09-11
200628AM00303,2006,28AM00,303,1,0,1,eneheuvel,26-09-11
200628AM00309,2006,28AM00,309,2,0,2,eneheuvel,26-09-11
200628AM00311,2006,28AM00,311,5,4,9,eneheuvel,26-09-11
200628AM00312,2006,28AM00,312,56,53,109,eneheuvel,26-09-11
200628AM00313,2006,28AM00,313,4,1,5,eneheuvel,26-09-11
200628BR00201,2006,28BR00,201,1,0,1,eneheuvel,26-09-11
200628BR00203,2006,28BR00,203,2,0,2,eneheuvel,26-09-11
200628BR00207,2006,28BR00,207,0,1,1,eneheuvel,26-09-11
200628BR00208,2006,28BR00,208,1,2,3,eneheuvel,26-09-11
200628BR00211,2006,28BR00,211,2,3,5,eneheuvel,26-09-11
200628BR00212,2006,28BR00,212,3,3,6,eneheuvel,26-09-11
200628BR00213,2006,28BR00,213,1,0,1,eneheuvel,26-09-11
200628BR00214,2006,28BR00,214,0,2,2,eneheuvel,26-09-11
200628BR00301,2006,28BR00,301,1,1,2,eneheuvel,26-09-11
200628BR00302,2006,28BR00,302,3,3,6,eneheuvel,26-09-11
200628BR00303,2006,28BR00,303,4,1,5,eneheuvel,26-09-11
200628BR00305,2006,28BR00,305,1,0,1,eneheuvel,26-09-11
200628BR00306,2006,28BR00,306,2,0,2,eneheuvel,26-09-11
200628BR00307,2006,28BR00,307,1,0,1,eneheuvel,26-09-11
200628BR00308,2006,28BR00,308,1,1,2,eneheuvel,26-09-11
200628BR00309,2006,28BR00,309,4,1,5,eneheuvel,26-09-11
200628BR00311,2006,28BR00,311,11,5,16,eneheuvel,26-09-11
200628BR00312,2006,28BR00,312,1,2,3,eneheuvel,26-09-11
200628BR009999,2006,28BR00,9999,2,0,2,eneheuvel,26-09-11
200628DJ00105,2006,28DJ00,105,1,2,3,eneheuvel,26-09-11
200628DJ00107,2006,28DJ00,107,1,0,1,eneheuvel,26-09-11
200628DJ00108,2006,28DJ00,108,2,0,2,eneheuvel,26-09-11
200628DJ00203,2006,28DJ00,203,6,3,9,eneheuvel,26-09-11
200628DJ00204,2006,28DJ00,204,2,3,5,eneheuvel,26-09-11
200628DJ00205,2006,28DJ00,205,1,1,2,eneheuvel,26-09-11
200628DJ00206,2006,28DJ00,206,1,1,2,eneheuvel,26-09-11
200628DJ00207,2006,28DJ00,207,5,6,11,eneheuvel,26-09-11
200628DJ00208,2006,28DJ00,208,6,3,9,eneheuvel,26-09-11
200628DJ00210,2006,28DJ00,210,1,1,2,eneheuvel,26-09-11
200628DJ00211,2006,28DJ00,211,3,1,4,eneheuvel,26-09-11
200628DJ00212,2006,28DJ00,212,2,4,6,eneheuvel,26-09-11
200628DJ00213,2006,28DJ00,213,1,1,2,eneheuvel,26-09-11
200628DJ00214,2006,28DJ00,214,1,0,1,eneheuvel,26-09-11
200628DJ00301,2006,28DJ00,301,1,1,2,eneheuvel,26-09-11
200628DJ00302,2006,28DJ00,302,0,3,3,eneheuvel,26-09-11
200628DJ00303,2006,28DJ00,303,1,1,2,eneheuvel,26-09-11
200628DJ00304,2006,28DJ00,304,0,3,3,eneheuvel,26-09-11
200628DJ00305,2006,28DJ00,305,6,7,13,eneheuvel,26-09-11
200628DJ00306,2006,28DJ00,306,3,1,4,eneheuvel,26-09-11
200628DJ00307,2006,28DJ00,307,6,5,11,eneheuvel,26-09-11
200628DJ00308,2006,28DJ00,308,2,2,4,eneheuvel,26-09-11
200628DJ009999,2006,28DJ00,9999,1,0,1,eneheuvel,26-09-11
200706RM00102,2007,06RM00,102,1,4,5,eneheuvel,26-09-11
200706RM00103,2007,06RM00,103,4,0,4,eneheuvel,26-09-11
200706RM00105,2007,06RM00,105,1,1,2,eneheuvel,26-09-11
200706RM00106,2007,06RM00,106,2,0,2,eneheuvel,26-09-11
200706RM00109,2007,06RM00,109,0,2,2,eneheuvel,26-09-11
200706RM00202,2007,06RM00,202,4,9,13,eneheuvel,26-09-11
200706RM00204,2007,06RM00,204,2,2,4,eneheuvel,26-09-11
200706RM00206,2007,06RM00,206,1,7,8,eneheuvel,26-09-11
200706RM00207,2007,06RM00,207,2,2,4,eneheuvel,26-09-11
200706RM00208,2007,06RM00,208,1,1,2,eneheuvel,26-09-11
200706RM00210,2007,06RM00,210,9,7,16,eneheuvel,26-09-11
200706RM00211,2007,06RM00,211,10,6,16,eneheuvel,26-09-11
200706RM00212,2007,06RM00,212,23,32,55,eneheuvel,26-09-11
200706RM00213,2007,06RM00,213,9,7,16,eneheuvel,26-09-11
200706RM00214,2007,06RM00,214,18,15,33,eneheuvel,26-09-11
200706RM00215,2007,06RM00,215,2,2,4,eneheuvel,26-09-11
200706RM00216,2007,06RM00,216,5,7,12,eneheuvel,26-09-11
200706RM00302,2007,06RM00,302,4,4,8,eneheuvel,26-09-11
200706RM00303,2007,06RM00,303,6,4,10,eneheuvel,26-09-11
200706RM00304,2007,06RM00,304,3,1,4,eneheuvel,26-09-11
200706RM00305,2007,06RM00,305,1,0,1,eneheuvel,26-09-11
200706RM00306,2007,06RM00,306,2,1,3,eneheuvel,26-09-11
200706RM00307,2007,06RM00,307,1,0,1,eneheuvel,26-09-11
200706RM00309,2007,06RM00,309,1,3,4,eneheuvel,26-09-11
200706RM00311,2007,06RM00,311,4,3,7,eneheuvel,26-09-11
200706RM00312,2007,06RM00,312,3,2,5,eneheuvel,26-09-11
200706RM00502,2007,06RM00,502,2,4,6,eneheuvel,26-09-11
200706RM009999,2007,06RM00,9999,11,13,24,eneheuvel,26-09-11
200712HU00103,2007,12HU00,103,1,1,2,eneheuvel,26-09-11
200712HU00201,2007,12HU00,201,4,8,12,eneheuvel,26-09-11
200712HU00202,2007,12HU00,202,3,1,4,eneheuvel,26-09-11
200712HU00206,2007,12HU00,206,0,1,1,eneheuvel,26-09-11
200712HU00209,2007,12HU00,209,3,1,4,eneheuvel,26-09-11
200712HU00210,2007,12HU00,210,2,1,3,eneheuvel,26-09-11
200712HU00211,2007,12HU00,211,53,54,107,eneheuvel,26-09-11
200712HU00212,2007,12HU00,212,0,2,2,eneheuvel,26-09-11
200712HU00213,2007,12HU00,213,0,2,2,eneheuvel,26-09-11
200712HU00305,2007,12HU00,305,1,0,1,eneheuvel,26-09-11
200712HU009999,2007,12HU00,9999,0,2,2,eneheuvel,26-09-11
200712PM00101,2007,12PM00,101,15,2,17,eneheuvel,26-09-11
200712PM00102,2007,12PM00,102,11,6,17,eneheuvel,26-09-11
200712PM00103,2007,12PM00,103,37,33,70,eneheuvel,26-09-11
200712PM00104,2007,12PM00,104,5,5,10,eneheuvel,26-09-11
200712PM00106,2007,12PM00,106,2,4,6,eneheuvel,26-09-11
200712PM00107,2007,12PM00,107,25,18,43,eneheuvel,26-09-11
200712PM00108,2007,12PM00,108,17,15,32,eneheuvel,26-09-11
200712PM00109,2007,12PM00,109,12,14,26,eneheuvel,26-09-11
200712PM00110,2007,12PM00,110,0,1,1,eneheuvel,26-09-11
200712PM00202,2007,12PM00,202,1,3,4,eneheuvel,26-09-11
200712PM00211,2007,12PM00,211,0,1,1,eneheuvel,26-09-11
200712PM00212,2007,12PM00,212,0,2,2,eneheuvel,26-09-11
200712PM00214,2007,12PM00,214,1,0,1,eneheuvel,26-09-11
200712PM00216,2007,12PM00,216,1,1,2,eneheuvel,26-09-11
200712PM00303,2007,12PM00,303,1,0,1,eneheuvel,26-09-11
200712PM00306,2007,12PM00,306,1,1,2,eneheuvel,26-09-11
200712PM00309,2007,12PM00,309,1,0,1,eneheuvel,26-09-11
200712PM00311,2007,12PM00,311,3,0,3,eneheuvel,26-09-11
200712QK00104,2007,12QK00,104,0,1,1,eneheuvel,26-09-11
200712QK00201,2007,12QK00,201,1,0,1,eneheuvel,26-09-11
200712QK00202,2007,12QK00,202,2,0,2,eneheuvel,26-09-11
200712QK00205,2007,12QK00,205,0,2,2,eneheuvel,26-09-11
200712QK00206,2007,12QK00,206,105,105,210,eneheuvel,26-09-11
200712QK00207,2007,12QK00,207,2,1,3,eneheuvel,26-09-11
200712QK00208,2007,12QK00,208,2,5,7,eneheuvel,26-09-11
200712QK00209,2007,12QK00,209,7,3,10,eneheuvel,26-09-11
200712QK00210,2007,12QK00,210,9,7,16,eneheuvel,26-09-11
200712QK00211,2007,12QK00,211,0,1,1,eneheuvel,26-09-11
200712QK00212,2007,12QK00,212,1,0,1,eneheuvel,26-09-11
200712QK00213,2007,12QK00,213,0,2,2,eneheuvel,26-09-11
200712QK00214,2007,12QK00,214,2,2,4,eneheuvel,26-09-11
200712QK00215,2007,12QK00,215,6,11,17,eneheuvel,26-09-11
200712QK00303,2007,12QK00,303,0,1,1,eneheuvel,26-09-11
200712QK00307,2007,12QK00,307,0,1,1,eneheuvel,26-09-11
200712QK00309,2007,12QK00,309,0,1,1,eneheuvel,26-09-11
200712QK00311,2007,12QK00,311,1,1,2,eneheuvel,26-09-11
200712QK00312,2007,12QK00,312,0,3,3,eneheuvel,26-09-11
200712QK009999,2007,12QK00,9999,0,2,2,eneheuvel,26-09-11
200712XA00201,2007,12XA00,201,0,1,1,eneheuvel,26-09-11
200712XA00204,2007,12XA00,204,0,1,1,eneheuvel,26-09-11
200712XA00207,2007,12XA00,207,1,0,1,eneheuvel,26-09-11
200712XA00208,2007,12XA00,208,0,1,1,eneheuvel,26-09-11
200712XA00211,2007,12XA00,211,64,48,112,eneheuvel,26-09-11
200712XA00213,2007,12XA00,213,1,1,2,eneheuvel,26-09-11
200712XA00214,2007,12XA00,214,1,1,2,eneheuvel,26-09-11
200712XA00303,2007,12XA00,303,1,0,1,eneheuvel,26-09-11
200712XA00309,2007,12XA00,309,0,1,1,eneheuvel,26-09-11
200712XA009999,2007,12XA00,9999,1,0,1,eneheuvel,26-09-11
200713CW00102,2007,13CW00,102,0,1,1,eneheuvel,26-09-11
200713CW00106,2007,13CW00,106,0,1,1,eneheuvel,26-09-11
200713CW00201,2007,13CW00,201,3,1,4,eneheuvel,26-09-11
200713CW00202,2007,13CW00,202,1,1,2,eneheuvel,26-09-11
200713CW00203,2007,13CW00,203,1,0,1,eneheuvel,26-09-11
200713CW00205,2007,13CW00,205,3,4,7,eneheuvel,26-09-11
200713CW00206,2007,13CW00,206,65,61,126,eneheuvel,26-09-11
200713CW00207,2007,13CW00,207,2,2,4,eneheuvel,26-09-11
200713CW00208,2007,13CW00,208,1,1,2,eneheuvel,26-09-11
200713CW00209,2007,13CW00,209,18,2,20,eneheuvel,26-09-11
200713CW00210,2007,13CW00,210,8,7,15,eneheuvel,26-09-11
200713CW00211,2007,13CW00,211,1,2,3,eneheuvel,26-09-11
200713CW00212,2007,13CW00,212,1,0,1,eneheuvel,26-09-11
200713CW00215,2007,13CW00,215,0,3,3,eneheuvel,26-09-11
200713CW00216,2007,13CW00,216,1,0,1,eneheuvel,26-09-11
200713CW00308,2007,13CW00,308,2,0,2,eneheuvel,26-09-11
200713IF00105,2007,13IF00,105,0,1,1,eneheuvel,26-09-11
200713IF00207,2007,13IF00,207,1,0,1,eneheuvel,26-09-11
200713IF00208,2007,13IF00,208,1,1,2,eneheuvel,26-09-11
200713IF00211,2007,13IF00,211,0,1,1,eneheuvel,26-09-11
200713IF00301,2007,13IF00,301,12,9,21,eneheuvel,26-09-11
200713IF00302,2007,13IF00,302,0,2,2,eneheuvel,26-09-11
200713IF00303,2007,13IF00,303,10,14,24,eneheuvel,26-09-11
200713IF00304,2007,13IF00,304,42,34,76,eneheuvel,26-09-11
200713IF00305,2007,13IF00,305,9,11,20,eneheuvel,26-09-11
200713IF00306,2007,13IF00,306,7,21,28,eneheuvel,26-09-11
200713IF00307,2007,13IF00,307,1,3,4,eneheuvel,26-09-11
200713IF00308,2007,13IF00,308,2,2,4,eneheuvel,26-09-11
200713IF00309,2007,13IF00,309,1,2,3,eneheuvel,26-09-11
200713IF00310,2007,13IF00,310,1,0,1,eneheuvel,26-09-11
200713IF00311,2007,13IF00,311,0,1,1,eneheuvel,26-09-11
200713IU00102,2007,13IU00,102,12,8,20,eneheuvel,26-09-11
200713IU00103,2007,13IU00,103,9,3,12,eneheuvel,26-09-11
200713IU00104,2007,13IU00,104,4,0,4,eneheuvel,26-09-11
200713IU00105,2007,13IU00,105,1,5,6,eneheuvel,26-09-11
200713IU00106,2007,13IU00,106,56,30,86,eneheuvel,26-09-11
200713IU00107,2007,13IU00,107,5,3,8,eneheuvel,26-09-11
200713IU00108,2007,13IU00,108,2,3,5,eneheuvel,26-09-11
200713IU00109,2007,13IU00,109,2,2,4,eneheuvel,26-09-11
200713IU00211,2007,13IU00,211,1,1,2,eneheuvel,26-09-11
200713IU00212,2007,13IU00,212,1,1,2,eneheuvel,26-09-11
200713IU00311,2007,13IU00,311,1,0,1,eneheuvel,26-09-11
200713IU009999,2007,13IU00,9999,0,1,1,eneheuvel,26-09-11
200713NH00101,2007,13NH00,101,5,2,7,eneheuvel,26-09-11
200713NH00102,2007,13NH00,102,9,8,17,eneheuvel,26-09-11
200713NH00103,2007,13NH00,103,2,2,4,eneheuvel,26-09-11
200713NH00104,2007,13NH00,104,21,26,47,eneheuvel,26-09-11
200713NH00105,2007,13NH00,105,64,62,126,eneheuvel,26-09-11
200713NH00106,2007,13NH00,106,4,10,14,eneheuvel,26-09-11
200713NH00107,2007,13NH00,107,3,3,6,eneheuvel,26-09-11
200713NH00109,2007,13NH00,109,0,2,2,eneheuvel,26-09-11
200713NH00110,2007,13NH00,110,2,3,5,eneheuvel,26-09-11
200713NH00202,2007,13NH00,202,0,1,1,eneheuvel,26-09-11
200713NH00212,2007,13NH00,212,1,1,2,eneheuvel,26-09-11
200713NH00213,2007,13NH00,213,1,0,1,eneheuvel,26-09-11
200713NH00502,2007,13NH00,502,1,0,1,eneheuvel,26-09-11
200713NH009999,2007,13NH00,9999,1,0,1,eneheuvel,26-09-11
200713NU00201,2007,13NU00,201,1,0,1,eneheuvel,26-09-11
200713NU00202,2007,13NU00,202,1,0,1,eneheuvel,26-09-11
200713NU00207,2007,13NU00,207,0,1,1,eneheuvel,26-09-11
200713NU00212,2007,13NU00,212,1,1,2,eneheuvel,26-09-11
200713NU00214,2007,13NU00,214,1,0,1,eneheuvel,26-09-11
200713NU00301,2007,13NU00,301,11,6,17,eneheuvel,26-09-11
200713NU00302,2007,13NU00,302,1,0,1,eneheuvel,26-09-11
200713NU00303,2007,13NU00,303,34,44,78,eneheuvel,26-09-11
200713NU00304,2007,13NU00,304,70,61,131,eneheuvel,26-09-11
200713NU00305,2007,13NU00,305,15,18,33,eneheuvel,26-09-11
200713NU00306,2007,13NU00,306,14,14,28,eneheuvel,26-09-11
200713NU00307,2007,13NU00,307,2,3,5,eneheuvel,26-09-11
200713NU00308,2007,13NU00,308,4,7,11,eneheuvel,26-09-11
200713NU00309,2007,13NU00,309,2,3,5,eneheuvel,26-09-11
200713NU00310,2007,13NU00,310,1,1,2,eneheuvel,26-09-11
200713NU00311,2007,13NU00,311,0,1,1,eneheuvel,26-09-11
200713NU00312,2007,13NU00,312,0,1,1,eneheuvel,26-09-11
200713NU00502,2007,13NU00,502,0,1,1,eneheuvel,26-09-11
200713NU009999,2007,13NU00,9999,0,1,1,eneheuvel,26-09-11
200714QC00104,2007,14QC00,104,0,2,2,eneheuvel,26-09-11
200714QC00109,2007,14QC00,109,2,1,3,eneheuvel,26-09-11
200714QC00201,2007,14QC00,201,1,0,1,eneheuvel,26-09-11
200714QC00202,2007,14QC00,202,53,65,118,eneheuvel,26-09-11
200714QC00203,2007,14QC00,203,44,41,85,eneheuvel,26-09-11
200714QC00204,2007,14QC00,204,22,29,51,eneheuvel,26-09-11
200714QC00205,2007,14QC00,205,18,12,30,eneheuvel,26-09-11
200714QC00206,2007,14QC00,206,19,6,25,eneheuvel,26-09-11
200714QC00207,2007,14QC00,207,14,7,21,eneheuvel,26-09-11
200714QC00208,2007,14QC00,208,20,19,39,eneheuvel,26-09-11
200714QC00210,2007,14QC00,210,7,2,9,eneheuvel,26-09-11
200714QC00211,2007,14QC00,211,6,1,7,eneheuvel,26-09-11
200714QC00212,2007,14QC00,212,2,7,9,eneheuvel,26-09-11
200714QC00213,2007,14QC00,213,4,1,5,eneheuvel,26-09-11
200714QC00214,2007,14QC00,214,2,5,7,eneheuvel,26-09-11
200714QC00215,2007,14QC00,215,1,0,1,eneheuvel,26-09-11
200714QC00216,2007,14QC00,216,1,1,2,eneheuvel,26-09-11
200714QC00302,2007,14QC00,302,6,3,9,eneheuvel,26-09-11
200714QC00303,2007,14QC00,303,9,1,10,eneheuvel,26-09-11
200714QC00304,2007,14QC00,304,2,2,4,eneheuvel,26-09-11
200714QC00306,2007,14QC00,306,1,0,1,eneheuvel,26-09-11
200714QC00307,2007,14QC00,307,2,1,3,eneheuvel,26-09-11
200714QC00309,2007,14QC00,309,3,2,5,eneheuvel,26-09-11
200714QC00311,2007,14QC00,311,6,2,8,eneheuvel,26-09-11
200714QC00312,2007,14QC00,312,3,1,4,eneheuvel,26-09-11
200714QC00313,2007,14QC00,313,2,0,2,eneheuvel,26-09-11
200714QC00502,2007,14QC00,502,15,11,26,eneheuvel,26-09-11
200714QC009999,2007,14QC00,9999,1,3,4,eneheuvel,26-09-11
200715SJ00101,2007,15SJ00,101,1,3,4,eneheuvel,26-09-11
200715SJ00102,2007,15SJ00,102,1,3,4,eneheuvel,26-09-11
200715SJ00103,2007,15SJ00,103,2,8,10,eneheuvel,26-09-11
200715SJ00104,2007,15SJ00,104,0,3,3,eneheuvel,26-09-11
200715SJ00106,2007,15SJ00,106,0,4,4,eneheuvel,26-09-11
200715SJ00108,2007,15SJ00,108,0,4,4,eneheuvel,26-09-11
200715SJ00201,2007,15SJ00,201,0,3,3,eneheuvel,26-09-11
200715SJ00202,2007,15SJ00,202,2,7,9,eneheuvel,26-09-11
200715SJ00203,2007,15SJ00,203,3,7,10,eneheuvel,26-09-11
200715SJ00204,2007,15SJ00,204,0,12,12,eneheuvel,26-09-11
200715SJ00205,2007,15SJ00,205,0,6,6,eneheuvel,26-09-11
200715SJ00206,2007,15SJ00,206,2,20,22,eneheuvel,26-09-11
200715SJ00207,2007,15SJ00,207,6,10,16,eneheuvel,26-09-11
200715SJ00208,2007,15SJ00,208,1,12,13,eneheuvel,26-09-11
200715SJ00209,2007,15SJ00,209,3,6,9,eneheuvel,26-09-11
200715SJ00210,2007,15SJ00,210,3,18,21,eneheuvel,26-09-11
200715SJ00211,2007,15SJ00,211,3,18,21,eneheuvel,26-09-11
200715SJ00212,2007,15SJ00,212,3,15,18,eneheuvel,26-09-11
200715SJ00213,2007,15SJ00,213,1,6,7,eneheuvel,26-09-11
200715SJ00214,2007,15SJ00,214,5,9,14,eneheuvel,26-09-11
200715SJ00216,2007,15SJ00,216,0,1,1,eneheuvel,26-09-11
200715SJ00301,2007,15SJ00,301,0,4,4,eneheuvel,26-09-11
200715SJ00302,2007,15SJ00,302,2,10,12,eneheuvel,26-09-11
200715SJ00303,2007,15SJ00,303,1,9,10,eneheuvel,26-09-11
200715SJ00304,2007,15SJ00,304,3,8,11,eneheuvel,26-09-11
200715SJ00305,2007,15SJ00,305,1,4,5,eneheuvel,26-09-11
200715SJ00306,2007,15SJ00,306,2,8,10,eneheuvel,26-09-11
200715SJ00307,2007,15SJ00,307,1,10,11,eneheuvel,26-09-11
200715SJ00308,2007,15SJ00,308,2,2,4,eneheuvel,26-09-11
200715SJ00309,2007,15SJ00,309,3,5,8,eneheuvel,26-09-11
200715SJ00311,2007,15SJ00,311,1,4,5,eneheuvel,26-09-11
200715SJ00312,2007,15SJ00,312,0,2,2,eneheuvel,26-09-11
200715SJ00313,2007,15SJ00,313,0,1,1,eneheuvel,26-09-11
200715SJ009999,2007,15SJ00,9999,1,3,4,eneheuvel,26-09-11
200715ZL00103,2007,15ZL00,103,0,1,1,eneheuvel,26-09-11
200715ZL00107,2007,15ZL00,107,0,1,1,eneheuvel,26-09-11
200715ZL00108,2007,15ZL00,108,0,1,1,eneheuvel,26-09-11
200715ZL00203,2007,15ZL00,203,1,0,1,eneheuvel,26-09-11
200715ZL00204,2007,15ZL00,204,1,2,3,eneheuvel,26-09-11
200715ZL00205,2007,15ZL00,205,1,1,2,eneheuvel,26-09-11
200715ZL00206,2007,15ZL00,206,2,0,2,eneheuvel,26-09-11
200715ZL00207,2007,15ZL00,207,0,1,1,eneheuvel,26-09-11
200715ZL00208,2007,15ZL00,208,1,1,2,eneheuvel,26-09-11
200715ZL00210,2007,15ZL00,210,0,3,3,eneheuvel,26-09-11
200715ZL00214,2007,15ZL00,214,1,1,2,eneheuvel,26-09-11
200715ZL00302,2007,15ZL00,302,1,6,7,eneheuvel,26-09-11
200715ZL00303,2007,15ZL00,303,3,4,7,eneheuvel,26-09-11
200715ZL00304,2007,15ZL00,304,1,3,4,eneheuvel,26-09-11
200715ZL00305,2007,15ZL00,305,61,53,114,eneheuvel,26-09-11
200715ZL00306,2007,15ZL00,306,6,9,15,eneheuvel,26-09-11
200715ZL00307,2007,15ZL00,307,1,7,8,eneheuvel,26-09-11
200715ZL00308,2007,15ZL00,308,6,3,9,eneheuvel,26-09-11
200715ZL00309,2007,15ZL00,309,5,6,11,eneheuvel,26-09-11
200715ZL00311,2007,15ZL00,311,3,0,3,eneheuvel,26-09-11
200715ZL00313,2007,15ZL00,313,0,1,1,eneheuvel,26-09-11
200715ZL009999,2007,15ZL00,9999,1,1,2,eneheuvel,26-09-11
200715ZL01206,2007,15ZL01,206,1,2,3,eneheuvel,26-09-11
200715ZL01209,2007,15ZL01,209,6,5,11,eneheuvel,26-09-11
200715ZL01210,2007,15ZL01,210,75,66,141,eneheuvel,26-09-11
200715ZL01212,2007,15ZL01,212,0,3,3,eneheuvel,26-09-11
200715ZL01214,2007,15ZL01,214,0,1,1,eneheuvel,26-09-11
200715ZL01215,2007,15ZL01,215,1,3,4,eneheuvel,26-09-11
200715ZL01216,2007,15ZL01,216,0,1,1,eneheuvel,26-09-11
200715ZL019999,2007,15ZL01,9999,1,0,1,eneheuvel,26-09-11
200716KK00101,2007,16KK00,101,16,11,27,eneheuvel,26-09-11
200716KK00102,2007,16KK00,102,46,42,88,eneheuvel,26-09-11
200716KK00103,2007,16KK00,103,63,53,116,eneheuvel,26-09-11
200716KK00104,2007,16KK00,104,2,1,3,eneheuvel,26-09-11
200716KK00105,2007,16KK00,105,2,1,3,eneheuvel,26-09-11
200716KK00106,2007,16KK00,106,5,5,10,eneheuvel,26-09-11
200716KK00107,2007,16KK00,107,17,11,28,eneheuvel,26-09-11
200716KK00108,2007,16KK00,108,28,28,56,eneheuvel,26-09-11
200716KK00109,2007,16KK00,109,20,15,35,eneheuvel,26-09-11
200716KK00201,2007,16KK00,201,0,1,1,eneheuvel,26-09-11
200716KK00202,2007,16KK00,202,2,0,2,eneheuvel,26-09-11
200716KK00203,2007,16KK00,203,0,1,1,eneheuvel,26-09-11
200716KK00204,2007,16KK00,204,1,1,2,eneheuvel,26-09-11
200716KK00206,2007,16KK00,206,0,1,1,eneheuvel,26-09-11
200716KK00207,2007,16KK00,207,2,1,3,eneheuvel,26-09-11
200716KK00208,2007,16KK00,208,0,1,1,eneheuvel,26-09-11
200716KK00209,2007,16KK00,209,0,1,1,eneheuvel,26-09-11
200716KK00210,2007,16KK00,210,3,1,4,eneheuvel,26-09-11
200716KK00211,2007,16KK00,211,3,1,4,eneheuvel,26-09-11
200716KK00212,2007,16KK00,212,1,1,2,eneheuvel,26-09-11
200716KK00213,2007,16KK00,213,3,1,4,eneheuvel,26-09-11
200716KK00214,2007,16KK00,214,1,4,5,eneheuvel,26-09-11
200716KK00307,2007,16KK00,307,1,0,1,eneheuvel,26-09-11
200716KK00311,2007,16KK00,311,0,2,2,eneheuvel,26-09-11
200716KK00502,2007,16KK00,502,2,1,3,eneheuvel,26-09-11
200716KK009999,2007,16KK00,9999,4,0,4,eneheuvel,26-09-11
200716LJ00101,2007,16LJ00,101,1,0,1,eneheuvel,26-09-11
200716LJ00102,2007,16LJ00,102,4,3,7,eneheuvel,26-09-11
200716LJ00104,2007,16LJ00,104,2,4,6,eneheuvel,26-09-11
200716LJ00105,2007,16LJ00,105,1,2,3,eneheuvel,26-09-11
200716LJ00106,2007,16LJ00,106,55,45,100,eneheuvel,26-09-11
200716LJ00107,2007,16LJ00,107,5,6,11,eneheuvel,26-09-11
200716LJ00108,2007,16LJ00,108,1,5,6,eneheuvel,26-09-11
200716LJ00109,2007,16LJ00,109,1,1,2,eneheuvel,26-09-11
200716LJ00202,2007,16LJ00,202,0,1,1,eneheuvel,26-09-11
200716LJ00203,2007,16LJ00,203,2,0,2,eneheuvel,26-09-11
200716LJ00208,2007,16LJ00,208,1,1,2,eneheuvel,26-09-11
200716LJ00209,2007,16LJ00,209,0,1,1,eneheuvel,26-09-11
200716LJ00210,2007,16LJ00,210,0,1,1,eneheuvel,26-09-11
200716LJ00214,2007,16LJ00,214,0,1,1,eneheuvel,26-09-11
200716LJ00216,2007,16LJ00,216,1,0,1,eneheuvel,26-09-11
200716LJ00302,2007,16LJ00,302,0,1,1,eneheuvel,26-09-11
200716LJ00306,2007,16LJ00,306,1,0,1,eneheuvel,26-09-11
200716LJ00307,2007,16LJ00,307,1,0,1,eneheuvel,26-09-11
200716LJ00308,2007,16LJ00,308,0,3,3,eneheuvel,26-09-11
200716LJ00309,2007,16LJ00,309,0,1,1,eneheuvel,26-09-11
200716LJ00311,2007,16LJ00,311,0,2,2,eneheuvel,26-09-11
200716LJ00312,2007,16LJ00,312,1,0,1,eneheuvel,26-09-11
200716LJ009999,2007,16LJ00,9999,2,1,3,eneheuvel,26-09-11
200716ML00101,2007,16ML00,101,7,10,17,eneheuvel,26-09-11
200716ML00102,2007,16ML00,102,33,18,51,eneheuvel,26-09-11
200716ML00103,2007,16ML00,103,2,0,2,eneheuvel,26-09-11
200716ML00104,2007,16ML00,104,56,65,121,eneheuvel,26-09-11
200716ML00105,2007,16ML00,105,27,25,52,eneheuvel,26-09-11
200716ML00106,2007,16ML00,106,3,4,7,eneheuvel,26-09-11
200716ML00107,2007,16ML00,107,2,2,4,eneheuvel,26-09-11
200716ML00108,2007,16ML00,108,1,5,6,eneheuvel,26-09-11
200716ML00109,2007,16ML00,109,3,5,8,eneheuvel,26-09-11
200716ML00110,2007,16ML00,110,0,2,2,eneheuvel,26-09-11
200716ML00203,2007,16ML00,203,1,3,4,eneheuvel,26-09-11
200716ML00205,2007,16ML00,205,0,3,3,eneheuvel,26-09-11
200716ML00209,2007,16ML00,209,0,1,1,eneheuvel,26-09-11
200716ML00210,2007,16ML00,210,1,2,3,eneheuvel,26-09-11
200716ML00212,2007,16ML00,212,2,1,3,eneheuvel,26-09-11
200716ML00213,2007,16ML00,213,1,0,1,eneheuvel,26-09-11
200716ML00214,2007,16ML00,214,2,0,2,eneheuvel,26-09-11
200716ML00303,2007,16ML00,303,1,1,2,eneheuvel,26-09-11
200716ML00306,2007,16ML00,306,0,1,1,eneheuvel,26-09-11
200716ML00502,2007,16ML00,502,2,2,4,eneheuvel,26-09-11
200716ML009999,2007,16ML00,9999,1,0,1,eneheuvel,26-09-11
200716OC00101,2007,16OC00,101,1,1,2,eneheuvel,26-09-11
200716OC00102,2007,16OC00,102,1,2,3,eneheuvel,26-09-11
200716OC00103,2007,16OC00,103,4,7,11,eneheuvel,26-09-11
200716OC00104,2007,16OC00,104,2,1,3,eneheuvel,26-09-11
200716OC00105,2007,16OC00,105,1,1,2,eneheuvel,26-09-11
200716OC00106,2007,16OC00,106,0,1,1,eneheuvel,26-09-11
200716OC00107,2007,16OC00,107,63,76,139,eneheuvel,26-09-11
200716OC00108,2007,16OC00,108,11,21,32,eneheuvel,26-09-11
200716OC00109,2007,16OC00,109,37,47,84,eneheuvel,26-09-11
200716OC00201,2007,16OC00,201,1,0,1,eneheuvel,26-09-11
200716OC00203,2007,16OC00,203,1,1,2,eneheuvel,26-09-11
200716OC00204,2007,16OC00,204,1,0,1,eneheuvel,26-09-11
200716OC00205,2007,16OC00,205,1,0,1,eneheuvel,26-09-11
200716OC00208,2007,16OC00,208,0,2,2,eneheuvel,26-09-11
200716OC00210,2007,16OC00,210,0,2,2,eneheuvel,26-09-11
200716OC00211,2007,16OC00,211,0,1,1,eneheuvel,26-09-11
200716OC00212,2007,16OC00,212,0,2,2,eneheuvel,26-09-11
200716OC00214,2007,16OC00,214,2,3,5,eneheuvel,26-09-11
200716OC00303,2007,16OC00,303,0,1,1,eneheuvel,26-09-11
200716OC00308,2007,16OC00,308,0,1,1,eneheuvel,26-09-11
200716OC00309,2007,16OC00,309,1,1,2,eneheuvel,26-09-11
200716UK00102,2007,16UK00,102,0,1,1,eneheuvel,26-09-11
200716UK00103,2007,16UK00,103,7,14,21,eneheuvel,26-09-11
200716UK00108,2007,16UK00,108,73,75,148,eneheuvel,26-09-11
200716UK00109,2007,16UK00,109,1,1,2,eneheuvel,26-09-11
200716UK00210,2007,16UK00,210,0,1,1,eneheuvel,26-09-11
200716UK00212,2007,16UK00,212,0,1,1,eneheuvel,26-09-11
200716UK00305,2007,16UK00,305,1,1,2,eneheuvel,26-09-11
200716UK00306,2007,16UK00,306,0,1,1,eneheuvel,26-09-11
200716UK009999,2007,16UK00,9999,1,0,1,eneheuvel,26-09-11
200716WV00201,2007,16WV00,201,6,2,8,eneheuvel,26-09-11
200716WV00202,2007,16WV00,202,1,0,1,eneheuvel,26-09-11
200716WV00207,2007,16WV00,207,0,2,2,eneheuvel,26-09-11
200716WV00209,2007,16WV00,209,15,19,34,eneheuvel,26-09-11
200716WV00210,2007,16WV00,210,1,1,2,eneheuvel,26-09-11
200716WV00211,2007,16WV00,211,66,54,120,eneheuvel,26-09-11
200716WV00214,2007,16WV00,214,0,1,1,eneheuvel,26-09-11
200716WV00216,2007,16WV00,216,0,1,1,eneheuvel,26-09-11
200716WV00301,2007,16WV00,301,2,0,2,eneheuvel,26-09-11
200716WV00306,2007,16WV00,306,0,2,2,eneheuvel,26-09-11
200716WV009999,2007,16WV00,9999,1,1,2,eneheuvel,26-09-11
200716YS00108,2007,16YS00,108,0,1,1,eneheuvel,26-09-11
200716YS00201,2007,16YS00,201,12,7,19,eneheuvel,26-09-11
200716YS00203,2007,16YS00,203,1,0,1,eneheuvel,26-09-11
200716YS00208,2007,16YS00,208,0,1,1,eneheuvel,26-09-11
200716YS00209,2007,16YS00,209,1,0,1,eneheuvel,26-09-11
200716YS00210,2007,16YS00,210,1,0,1,eneheuvel,26-09-11
200716YS00211,2007,16YS00,211,94,72,166,eneheuvel,26-09-11
200716YS00212,2007,16YS00,212,0,2,2,eneheuvel,26-09-11
200716YS00213,2007,16YS00,213,2,0,2,eneheuvel,26-09-11
200716YS00214,2007,16YS00,214,1,2,3,eneheuvel,26-09-11
200716YS00309,2007,16YS00,309,0,1,1,eneheuvel,26-09-11
200716YS009999,2007,16YS00,9999,2,2,4,eneheuvel,26-09-11
200716ZG00102,2007,16ZG00,102,0,1,1,eneheuvel,26-09-11
200716ZG00202,2007,16ZG00,202,1,0,1,eneheuvel,26-09-11
200716ZG00206,2007,16ZG00,206,0,1,1,eneheuvel,26-09-11
200716ZG00211,2007,16ZG00,211,84,70,154,eneheuvel,26-09-11
200716ZG00212,2007,16ZG00,212,1,0,1,eneheuvel,26-09-11
200716ZG00213,2007,16ZG00,213,0,2,2,eneheuvel,26-09-11
200716ZG00214,2007,16ZG00,214,2,4,6,eneheuvel,26-09-11
200716ZG00308,2007,16ZG00,308,0,1,1,eneheuvel,26-09-11
200716ZG00309,2007,16ZG00,309,0,1,1,eneheuvel,26-09-11
200716ZX00201,2007,16ZX00,201,1,1,2,eneheuvel,26-09-11
200716ZX00203,2007,16ZX00,203,0,1,1,eneheuvel,26-09-11
200716ZX00206,2007,16ZX00,206,14,32,46,eneheuvel,26-09-11
200716ZX00209,2007,16ZX00,209,36,40,76,eneheuvel,26-09-11
200716ZX00210,2007,16ZX00,210,1,1,2,eneheuvel,26-09-11
200716ZX00211,2007,16ZX00,211,0,1,1,eneheuvel,26-09-11
200716ZX00308,2007,16ZX00,308,1,0,1,eneheuvel,26-09-11
200716ZX009999,2007,16ZX00,9999,1,0,1,eneheuvel,26-09-11
200717AK00202,2007,17AK00,202,0,1,1,eneheuvel,26-09-11
200717AK00203,2007,17AK00,203,0,2,2,eneheuvel,26-09-11
200717AK00205,2007,17AK00,205,1,3,4,eneheuvel,26-09-11
200717AK00206,2007,17AK00,206,64,58,122,eneheuvel,26-09-11
200717AK00207,2007,17AK00,207,1,0,1,eneheuvel,26-09-11
200717AK00209,2007,17AK00,209,5,1,6,eneheuvel,26-09-11
200717AK00210,2007,17AK00,210,4,3,7,eneheuvel,26-09-11
200717AK00211,2007,17AK00,211,0,1,1,eneheuvel,26-09-11
200717AK00304,2007,17AK00,304,1,1,2,eneheuvel,26-09-11
200717AK00305,2007,17AK00,305,2,3,5,eneheuvel,26-09-11
200717AK00306,2007,17AK00,306,1,0,1,eneheuvel,26-09-11
200717AK00307,2007,17AK00,307,0,2,2,eneheuvel,26-09-11
200717AK00309,2007,17AK00,309,1,1,2,eneheuvel,26-09-11
200717AV00101,2007,17AV00,101,1,0,1,eneheuvel,26-09-11
200717AV00108,2007,17AV00,108,0,1,1,eneheuvel,26-09-11
200717AV00204,2007,17AV00,204,0,2,2,eneheuvel,26-09-11
200717AV00205,2007,17AV00,205,1,0,1,eneheuvel,26-09-11
200717AV00206,2007,17AV00,206,65,85,150,eneheuvel,26-09-11
200717AV00207,2007,17AV00,207,1,0,1,eneheuvel,26-09-11
200717AV00208,2007,17AV00,208,0,1,1,eneheuvel,26-09-11
200717AV00209,2007,17AV00,209,3,0,3,eneheuvel,26-09-11
200717AV00210,2007,17AV00,210,0,3,3,eneheuvel,26-09-11
200717AV00211,2007,17AV00,211,1,0,1,eneheuvel,26-09-11
200717AV00311,2007,17AV00,311,1,1,2,eneheuvel,26-09-11
200717AV009999,2007,17AV00,9999,0,2,2,eneheuvel,26-09-11
200717BP00201,2007,17BP00,201,0,4,4,eneheuvel,26-09-11
200717BP00208,2007,17BP00,208,1,2,3,eneheuvel,26-09-11
200717BP00211,2007,17BP00,211,52,60,112,eneheuvel,26-09-11
200717BP00212,2007,17BP00,212,3,3,6,eneheuvel,26-09-11
200717BP00213,2007,17BP00,213,75,81,156,eneheuvel,26-09-11
200717BP00214,2007,17BP00,214,3,4,7,eneheuvel,26-09-11
200717BP00309,2007,17BP00,309,1,1,2,eneheuvel,26-09-11
200717BP00312,2007,17BP00,312,1,0,1,eneheuvel,26-09-11
200717DA00102,2007,17DA00,102,0,1,1,eneheuvel,26-09-11
200717DA00202,2007,17DA00,202,1,0,1,eneheuvel,26-09-11
200717DA00209,2007,17DA00,209,13,9,22,eneheuvel,26-09-11
200717DA00210,2007,17DA00,210,55,50,105,eneheuvel,26-09-11
200717DA00302,2007,17DA00,302,2,1,3,eneheuvel,26-09-11
200717DA00303,2007,17DA00,303,0,1,1,eneheuvel,26-09-11
200717DA00307,2007,17DA00,307,1,1,2,eneheuvel,26-09-11
200717DK00201,2007,17DK00,201,0,1,1,eneheuvel,26-09-11
200717DK00206,2007,17DK00,206,0,1,1,eneheuvel,26-09-11
200717DK00207,2007,17DK00,207,1,0,1,eneheuvel,26-09-11
200717DK00208,2007,17DK00,208,0,1,1,eneheuvel,26-09-11
200717DK00301,2007,17DK00,301,4,6,10,eneheuvel,26-09-11
200717DK00302,2007,17DK00,302,1,2,3,eneheuvel,26-09-11
200717DK00303,2007,17DK00,303,1,1,2,eneheuvel,26-09-11
200717DK00304,2007,17DK00,304,23,47,70,eneheuvel,26-09-11
200717DK00305,2007,17DK00,305,1,1,2,eneheuvel,26-09-11
200717DK00306,2007,17DK00,306,0,1,1,eneheuvel,26-09-11
200717DK00308,2007,17DK00,308,3,0,3,eneheuvel,26-09-11
200717DK00309,2007,17DK00,309,2,1,3,eneheuvel,26-09-11
200717DV00106,2007,17DV00,106,0,1,1,eneheuvel,26-09-11
200717DV00108,2007,17DV00,108,0,1,1,eneheuvel,26-09-11
200717DV00202,2007,17DV00,202,0,1,1,eneheuvel,26-09-11
200717DV00203,2007,17DV00,203,0,1,1,eneheuvel,26-09-11
200717DV00204,2007,17DV00,204,0,2,2,eneheuvel,26-09-11
200717DV00207,2007,17DV00,207,1,0,1,eneheuvel,26-09-11
200717DV00209,2007,17DV00,209,1,1,2,eneheuvel,26-09-11
200717DV00211,2007,17DV00,211,2,1,3,eneheuvel,26-09-11
200717DV00212,2007,17DV00,212,0,1,1,eneheuvel,26-09-11
200717DV00214,2007,17DV00,214,0,1,1,eneheuvel,26-09-11
200717DV00216,2007,17DV00,216,1,2,3,eneheuvel,26-09-11
200717DV00301,2007,17DV00,301,15,7,22,eneheuvel,26-09-11
200717DV00302,2007,17DV00,302,1,7,8,eneheuvel,26-09-11
200717DV00303,2007,17DV00,303,30,27,57,eneheuvel,26-09-11
200717DV00304,2007,17DV00,304,39,46,85,eneheuvel,26-09-11
200717DV00305,2007,17DV00,305,9,6,15,eneheuvel,26-09-11
200717DV00306,2007,17DV00,306,13,10,23,eneheuvel,26-09-11
200717DV00307,2007,17DV00,307,10,12,22,eneheuvel,26-09-11
200717DV00308,2007,17DV00,308,12,12,24,eneheuvel,26-09-11
200717DV00309,2007,17DV00,309,13,17,30,eneheuvel,26-09-11
200717DV00310,2007,17DV00,310,2,1,3,eneheuvel,26-09-11
200717DV00311,2007,17DV00,311,5,4,9,eneheuvel,26-09-11
200717DV00312,2007,17DV00,312,0,1,1,eneheuvel,26-09-11
200717DV00502,2007,17DV00,502,1,1,2,eneheuvel,26-09-11
200717DV009999,2007,17DV00,9999,1,0,1,eneheuvel,26-09-11
200717FI00101,2007,17FI00,101,0,1,1,eneheuvel,26-09-11
200717FI00102,2007,17FI00,102,2,3,5,eneheuvel,26-09-11
200717FI00103,2007,17FI00,103,3,5,8,eneheuvel,26-09-11
200717FI00105,2007,17FI00,105,0,2,2,eneheuvel,26-09-11
200717FI00106,2007,17FI00,106,3,2,5,eneheuvel,26-09-11
200717FI00107,2007,17FI00,107,0,1,1,eneheuvel,26-09-11
200717FI00108,2007,17FI00,108,3,4,7,eneheuvel,26-09-11
200717FI00109,2007,17FI00,109,0,1,1,eneheuvel,26-09-11
200717FI00201,2007,17FI00,201,3,2,5,eneheuvel,26-09-11
200717FI00202,2007,17FI00,202,6,23,29,eneheuvel,26-09-11
200717FI00203,2007,17FI00,203,10,8,18,eneheuvel,26-09-11
200717FI00204,2007,17FI00,204,5,8,13,eneheuvel,26-09-11
200717FI00205,2007,17FI00,205,1,7,8,eneheuvel,26-09-11
200717FI00206,2007,17FI00,206,4,6,10,eneheuvel,26-09-11
200717FI00207,2007,17FI00,207,5,4,9,eneheuvel,26-09-11
200717FI00208,2007,17FI00,208,5,7,12,eneheuvel,26-09-11
200717FI00209,2007,17FI00,209,0,1,1,eneheuvel,26-09-11
200717FI00210,2007,17FI00,210,6,9,15,eneheuvel,26-09-11
200717FI00211,2007,17FI00,211,4,5,9,eneheuvel,26-09-11
200717FI00212,2007,17FI00,212,3,6,9,eneheuvel,26-09-11
200717FI00213,2007,17FI00,213,3,5,8,eneheuvel,26-09-11
200717FI00214,2007,17FI00,214,2,5,7,eneheuvel,26-09-11
200717FI00216,2007,17FI00,216,1,2,3,eneheuvel,26-09-11
200717FI00301,2007,17FI00,301,0,1,1,eneheuvel,26-09-11
200717FI00302,2007,17FI00,302,3,2,5,eneheuvel,26-09-11
200717FI00303,2007,17FI00,303,4,4,8,eneheuvel,26-09-11
200717FI00304,2007,17FI00,304,4,5,9,eneheuvel,26-09-11
200717FI00305,2007,17FI00,305,3,10,13,eneheuvel,26-09-11
200717FI00306,2007,17FI00,306,1,3,4,eneheuvel,26-09-11
200717FI00307,2007,17FI00,307,6,4,10,eneheuvel,26-09-11
200717FI00308,2007,17FI00,308,0,3,3,eneheuvel,26-09-11
200717FI00309,2007,17FI00,309,4,2,6,eneheuvel,26-09-11
200717FI00310,2007,17FI00,310,0,1,1,eneheuvel,26-09-11
200717FI00311,2007,17FI00,311,1,2,3,eneheuvel,26-09-11
200717FI00312,2007,17FI00,312,2,1,3,eneheuvel,26-09-11
200717FI00502,2007,17FI00,502,1,1,2,eneheuvel,26-09-11
200717FI009999,2007,17FI00,9999,0,2,2,eneheuvel,26-09-11
200717LP00203,2007,17LP00,203,0,1,1,eneheuvel,26-09-11
200717LP00301,2007,17LP00,301,1,0,1,eneheuvel,26-09-11
200717LP00304,2007,17LP00,304,3,0,3,eneheuvel,26-09-11
200717LP00305,2007,17LP00,305,48,39,87,eneheuvel,26-09-11
200717LP00306,2007,17LP00,306,7,3,10,eneheuvel,26-09-11
200717LP00307,2007,17LP00,307,0,1,1,eneheuvel,26-09-11
200717LP00308,2007,17LP00,308,0,1,1,eneheuvel,26-09-11
200717LP00309,2007,17LP00,309,0,1,1,eneheuvel,26-09-11
200717LP009999,2007,17LP00,9999,1,0,1,eneheuvel,26-09-11
200717MH00202,2007,17MH00,202,2,0,2,eneheuvel,26-09-11
200717MH00207,2007,17MH00,207,0,1,1,eneheuvel,26-09-11
200717MH00210,2007,17MH00,210,0,3,3,eneheuvel,26-09-11
200717MH00212,2007,17MH00,212,1,0,1,eneheuvel,26-09-11
200717MH00216,2007,17MH00,216,0,1,1,eneheuvel,26-09-11
200717MH00302,2007,17MH00,302,1,3,4,eneheuvel,26-09-11
200717MH00303,2007,17MH00,303,0,2,2,eneheuvel,26-09-11
200717MH00304,2007,17MH00,304,0,2,2,eneheuvel,26-09-11
200717MH00305,2007,17MH00,305,64,56,120,eneheuvel,26-09-11
200717MH00306,2007,17MH00,306,4,1,5,eneheuvel,26-09-11
200717MH00311,2007,17MH00,311,0,1,1,eneheuvel,26-09-11
200721KO00106,2007,21KO00,106,0,1,1,eneheuvel,26-09-11
200721KO00202,2007,21KO00,202,0,1,1,eneheuvel,26-09-11
200721KO00205,2007,21KO00,205,1,1,2,eneheuvel,26-09-11
200721KO00209,2007,21KO00,209,1,5,6,eneheuvel,26-09-11
200721KO00210,2007,21KO00,210,83,112,195,eneheuvel,26-09-11
200721KO00211,2007,21KO00,211,2,0,2,eneheuvel,26-09-11
200721KO00212,2007,21KO00,212,1,2,3,eneheuvel,26-09-11
200721KO00213,2007,21KO00,213,0,1,1,eneheuvel,26-09-11
200721KO00216,2007,21KO00,216,0,1,1,eneheuvel,26-09-11
200721KO00309,2007,21KO00,309,0,2,2,eneheuvel,26-09-11
200721KO009999,2007,21KO00,9999,0,1,1,eneheuvel,26-09-11
200721NC00103,2007,21NC00,103,0,1,1,eneheuvel,26-09-11
200721NC00110,2007,21NC00,110,2,0,2,eneheuvel,26-09-11
200721NC00208,2007,21NC00,208,0,1,1,eneheuvel,26-09-11
200721NC00210,2007,21NC00,210,1,0,1,eneheuvel,26-09-11
200721NC00211,2007,21NC00,211,5,0,5,eneheuvel,26-09-11
200721NC00212,2007,21NC00,212,5,3,8,eneheuvel,26-09-11
200721NC00213,2007,21NC00,213,48,50,98,eneheuvel,26-09-11
200721NC00214,2007,21NC00,214,4,3,7,eneheuvel,26-09-11
200721NC00303,2007,21NC00,303,1,0,1,eneheuvel,26-09-11
200721NC00305,2007,21NC00,305,1,0,1,eneheuvel,26-09-11
200721ND00201,2007,21ND00,201,0,1,1,eneheuvel,26-09-11
200721ND00209,2007,21ND00,209,1,0,1,eneheuvel,26-09-11
200721ND00210,2007,21ND00,210,1,1,2,eneheuvel,26-09-11
200721ND00211,2007,21ND00,211,10,9,19,eneheuvel,26-09-11
200721ND00212,2007,21ND00,212,3,5,8,eneheuvel,26-09-11
200721ND00213,2007,21ND00,213,84,105,189,eneheuvel,26-09-11
200721ND00214,2007,21ND00,214,0,5,5,eneheuvel,26-09-11
200721ND00302,2007,21ND00,302,0,1,1,eneheuvel,26-09-11
200721ND00304,2007,21ND00,304,0,1,1,eneheuvel,26-09-11
200721ND00312,2007,21ND00,312,2,1,3,eneheuvel,26-09-11
200721ND009999,2007,21ND00,9999,0,1,1,eneheuvel,26-09-11
200722KP00206,2007,22KP00,206,1,0,1,eneheuvel,26-09-11
200722KP00207,2007,22KP00,207,0,2,2,eneheuvel,26-09-11
200722KP00211,2007,22KP00,211,0,1,1,eneheuvel,26-09-11
200722KP00301,2007,22KP00,301,2,2,4,eneheuvel,26-09-11
200722KP00302,2007,22KP00,302,5,3,8,eneheuvel,26-09-11
200722KP00303,2007,22KP00,303,3,3,6,eneheuvel,26-09-11
200722KP00304,2007,22KP00,304,2,5,7,eneheuvel,26-09-11
200722KP00306,2007,22KP00,306,2,1,3,eneheuvel,26-09-11
200722KP00308,2007,22KP00,308,3,7,10,eneheuvel,26-09-11
200722KP00309,2007,22KP00,309,135,151,286,eneheuvel,26-09-11
200722KP00310,2007,22KP00,310,4,2,6,eneheuvel,26-09-11
200722KP00311,2007,22KP00,311,14,19,33,eneheuvel,26-09-11
200722KP00312,2007,22KP00,312,0,3,3,eneheuvel,26-09-11
200722KQ00205,2007,22KQ00,205,1,1,2,eneheuvel,26-09-11
200722KQ00206,2007,22KQ00,206,1,0,1,eneheuvel,26-09-11
200722KQ00208,2007,22KQ00,208,1,1,2,eneheuvel,26-09-11
200722KQ00209,2007,22KQ00,209,0,2,2,eneheuvel,26-09-11
200722KQ00210,2007,22KQ00,210,73,115,188,eneheuvel,26-09-11
200722KQ00211,2007,22KQ00,211,0,1,1,eneheuvel,26-09-11
200722KQ00212,2007,22KQ00,212,0,1,1,eneheuvel,26-09-11
200722KQ00214,2007,22KQ00,214,2,2,4,eneheuvel,26-09-11
200722KQ00215,2007,22KQ00,215,0,1,1,eneheuvel,26-09-11
200722KQ00216,2007,22KQ00,216,3,2,5,eneheuvel,26-09-11
200722KQ00307,2007,22KQ00,307,1,0,1,eneheuvel,26-09-11
200723EP00202,2007,23EP00,202,0,2,2,eneheuvel,26-09-11
200723EP00204,2007,23EP00,204,0,1,1,eneheuvel,26-09-11
200723EP00212,2007,23EP00,212,34,52,86,eneheuvel,26-09-11
200723EP00213,2007,23EP00,213,8,8,16,eneheuvel,26-09-11
200723EP00214,2007,23EP00,214,1,2,3,eneheuvel,26-09-11
200723EP009999,2007,23EP00,9999,1,1,2,eneheuvel,26-09-11
200723ER00201,2007,23ER00,201,1,0,1,eneheuvel,26-09-11
200723ER00210,2007,23ER00,210,0,2,2,eneheuvel,26-09-11
200723ER00211,2007,23ER00,211,0,1,1,eneheuvel,26-09-11
200723ER00212,2007,23ER00,212,83,99,182,eneheuvel,26-09-11
200723ER00213,2007,23ER00,213,1,2,3,eneheuvel,26-09-11
200723ER00214,2007,23ER00,214,2,5,7,eneheuvel,26-09-11
200723ER00303,2007,23ER00,303,0,1,1,eneheuvel,26-09-11
200723ER009999,2007,23ER00,9999,0,1,1,eneheuvel,26-09-11
200723ET00201,2007,23ET00,201,1,0,1,eneheuvel,26-09-11
200723ET00202,2007,23ET00,202,0,1,1,eneheuvel,26-09-11
200723ET00203,2007,23ET00,203,1,0,1,eneheuvel,26-09-11
200723ET00208,2007,23ET00,208,1,1,2,eneheuvel,26-09-11
200723ET00210,2007,23ET00,210,0,1,1,eneheuvel,26-09-11
200723ET00211,2007,23ET00,211,1,2,3,eneheuvel,26-09-11
200723ET00212,2007,23ET00,212,1,0,1,eneheuvel,26-09-11
200723ET00214,2007,23ET00,214,0,1,1,eneheuvel,26-09-11
200723ET00301,2007,23ET00,301,0,1,1,eneheuvel,26-09-11
200723ET00302,2007,23ET00,302,1,2,3,eneheuvel,26-09-11
200723ET00304,2007,23ET00,304,1,1,2,eneheuvel,26-09-11
200723ET00305,2007,23ET00,305,0,1,1,eneheuvel,26-09-11
200723ET00306,2007,23ET00,306,3,7,10,eneheuvel,26-09-11
200723ET00307,2007,23ET00,307,8,7,15,eneheuvel,26-09-11
200723ET00308,2007,23ET00,308,64,104,168,eneheuvel,26-09-11
200723ET00309,2007,23ET00,309,8,4,12,eneheuvel,26-09-11
200723ET00310,2007,23ET00,310,0,1,1,eneheuvel,26-09-11
200723ET00311,2007,23ET00,311,2,2,4,eneheuvel,26-09-11
200723ET00312,2007,23ET00,312,3,2,5,eneheuvel,26-09-11
200723EU00102,2007,23EU00,102,0,1,1,eneheuvel,26-09-11
200723EU00105,2007,23EU00,105,0,1,1,eneheuvel,26-09-11
200723EU00207,2007,23EU00,207,2,0,2,eneheuvel,26-09-11
200723EU00208,2007,23EU00,208,0,2,2,eneheuvel,26-09-11
200723EU00301,2007,23EU00,301,1,1,2,eneheuvel,26-09-11
200723EU00305,2007,23EU00,305,5,7,12,eneheuvel,26-09-11
200723EU00306,2007,23EU00,306,109,115,224,eneheuvel,26-09-11
200723EU00307,2007,23EU00,307,6,5,11,eneheuvel,26-09-11
200723EU00309,2007,23EU00,309,2,1,3,eneheuvel,26-09-11
200723EU00310,2007,23EU00,310,1,0,1,eneheuvel,26-09-11
200723EU00311,2007,23EU00,311,0,1,1,eneheuvel,26-09-11
200723EU00313,2007,23EU00,313,0,1,1,eneheuvel,26-09-11
200723EU009999,2007,23EU00,9999,1,0,1,eneheuvel,26-09-11
200723EV00102,2007,23EV00,102,0,1,1,eneheuvel,26-09-11
200723EV00201,2007,23EV00,201,1,0,1,eneheuvel,26-09-11
200723EV00203,2007,23EV00,203,1,1,2,eneheuvel,26-09-11
200723EV00206,2007,23EV00,206,1,0,1,eneheuvel,26-09-11
200723EV00207,2007,23EV00,207,1,1,2,eneheuvel,26-09-11
200723EV00208,2007,23EV00,208,1,1,2,eneheuvel,26-09-11
200723EV00209,2007,23EV00,209,1,2,3,eneheuvel,26-09-11
200723EV00210,2007,23EV00,210,12,7,19,eneheuvel,26-09-11
200723EV00211,2007,23EV00,211,15,10,25,eneheuvel,26-09-11
200723EV00212,2007,23EV00,212,117,127,244,eneheuvel,26-09-11
200723EV00213,2007,23EV00,213,29,31,60,eneheuvel,26-09-11
200723EV00214,2007,23EV00,214,4,4,8,eneheuvel,26-09-11
200723EV00216,2007,23EV00,216,1,4,5,eneheuvel,26-09-11
200723EV00302,2007,23EV00,302,2,0,2,eneheuvel,26-09-11
200723EV00304,2007,23EV00,304,0,1,1,eneheuvel,26-09-11
200723EV00307,2007,23EV00,307,2,0,2,eneheuvel,26-09-11
200723EV009999,2007,23EV00,9999,2,0,2,eneheuvel,26-09-11
200723EY00103,2007,23EY00,103,1,0,1,eneheuvel,26-09-11
200723EY00201,2007,23EY00,201,4,1,5,eneheuvel,26-09-11
200723EY00204,2007,23EY00,204,0,1,1,eneheuvel,26-09-11
200723EY00206,2007,23EY00,206,1,2,3,eneheuvel,26-09-11
200723EY00208,2007,23EY00,208,2,1,3,eneheuvel,26-09-11
200723EY00209,2007,23EY00,209,2,1,3,eneheuvel,26-09-11
200723EY00210,2007,23EY00,210,8,7,15,eneheuvel,26-09-11
200723EY00211,2007,23EY00,211,11,6,17,eneheuvel,26-09-11
200723EY00212,2007,23EY00,212,125,135,260,eneheuvel,26-09-11
200723EY00213,2007,23EY00,213,31,21,52,eneheuvel,26-09-11
200723EY00214,2007,23EY00,214,4,4,8,eneheuvel,26-09-11
200723EY00215,2007,23EY00,215,2,0,2,eneheuvel,26-09-11
200723EY00304,2007,23EY00,304,1,0,1,eneheuvel,26-09-11
200723EY00305,2007,23EY00,305,1,0,1,eneheuvel,26-09-11
200723EY00312,2007,23EY00,312,0,1,1,eneheuvel,26-09-11
200723EY00502,2007,23EY00,502,0,1,1,eneheuvel,26-09-11
200723EY009999,2007,23EY00,9999,2,3,5,eneheuvel,26-09-11
200723ZU00202,2007,23ZU00,202,81,90,171,eneheuvel,26-09-11
200723ZU00203,2007,23ZU00,203,5,6,11,eneheuvel,26-09-11
200723ZU00204,2007,23ZU00,204,45,57,102,eneheuvel,26-09-11
200723ZU00205,2007,23ZU00,205,100,97,197,eneheuvel,26-09-11
200723ZU00206,2007,23ZU00,206,2,2,4,eneheuvel,26-09-11
200723ZU00207,2007,23ZU00,207,22,12,34,eneheuvel,26-09-11
200723ZU00208,2007,23ZU00,208,17,20,37,eneheuvel,26-09-11
200723ZU00210,2007,23ZU00,210,1,0,1,eneheuvel,26-09-11
200723ZU00211,2007,23ZU00,211,1,6,7,eneheuvel,26-09-11
200723ZU00212,2007,23ZU00,212,0,2,2,eneheuvel,26-09-11
200723ZU00213,2007,23ZU00,213,1,0,1,eneheuvel,26-09-11
200723ZU00214,2007,23ZU00,214,1,2,3,eneheuvel,26-09-11
200723ZU00215,2007,23ZU00,215,1,2,3,eneheuvel,26-09-11
200723ZU00216,2007,23ZU00,216,1,0,1,eneheuvel,26-09-11
200723ZU00302,2007,23ZU00,302,1,3,4,eneheuvel,26-09-11
200723ZU00303,2007,23ZU00,303,1,4,5,eneheuvel,26-09-11
200723ZU00306,2007,23ZU00,306,2,0,2,eneheuvel,26-09-11
200723ZU00308,2007,23ZU00,308,0,1,1,eneheuvel,26-09-11
200723ZU00309,2007,23ZU00,309,1,0,1,eneheuvel,26-09-11
200723ZU00311,2007,23ZU00,311,0,1,1,eneheuvel,26-09-11
200723ZU00502,2007,23ZU00,502,1,3,4,eneheuvel,26-09-11
200723ZU009999,2007,23ZU00,9999,0,2,2,eneheuvel,26-09-11
200723ZV00107,2007,23ZV00,107,2,1,3,eneheuvel,26-09-11
200723ZV00201,2007,23ZV00,201,2,2,4,eneheuvel,26-09-11
200723ZV00202,2007,23ZV00,202,38,45,83,eneheuvel,26-09-11
200723ZV00203,2007,23ZV00,203,5,7,12,eneheuvel,26-09-11
200723ZV00204,2007,23ZV00,204,23,44,67,eneheuvel,26-09-11
200723ZV00205,2007,23ZV00,205,37,75,112,eneheuvel,26-09-11
200723ZV00207,2007,23ZV00,207,12,10,22,eneheuvel,26-09-11
200723ZV00208,2007,23ZV00,208,8,7,15,eneheuvel,26-09-11
200723ZV00209,2007,23ZV00,209,1,0,1,eneheuvel,26-09-11
200723ZV00210,2007,23ZV00,210,1,0,1,eneheuvel,26-09-11
200723ZV00211,2007,23ZV00,211,1,1,2,eneheuvel,26-09-11
200723ZV00216,2007,23ZV00,216,1,0,1,eneheuvel,26-09-11
200723ZV00308,2007,23ZV00,308,2,0,2,eneheuvel,26-09-11
200723ZV00312,2007,23ZV00,312,2,1,3,eneheuvel,26-09-11
200723ZW00202,2007,23ZW00,202,0,2,2,eneheuvel,26-09-11
200723ZW00207,2007,23ZW00,207,1,2,3,eneheuvel,26-09-11
200723ZW00208,2007,23ZW00,208,0,4,4,eneheuvel,26-09-11
200723ZW00210,2007,23ZW00,210,1,0,1,eneheuvel,26-09-11
200723ZW00211,2007,23ZW00,211,0,1,1,eneheuvel,26-09-11
200723ZW00301,2007,23ZW00,301,3,0,3,eneheuvel,26-09-11
200723ZW00302,2007,23ZW00,302,4,0,4,eneheuvel,26-09-11
200723ZW00303,2007,23ZW00,303,3,6,9,eneheuvel,26-09-11
200723ZW00304,2007,23ZW00,304,3,2,5,eneheuvel,26-09-11
200723ZW00305,2007,23ZW00,305,3,1,4,eneheuvel,26-09-11
200723ZW00306,2007,23ZW00,306,30,36,66,eneheuvel,26-09-11
200723ZW00307,2007,23ZW00,307,88,70,158,eneheuvel,26-09-11
200723ZW00308,2007,23ZW00,308,101,90,191,eneheuvel,26-09-11
200723ZW00309,2007,23ZW00,309,8,3,11,eneheuvel,26-09-11
200723ZW00310,2007,23ZW00,310,1,1,2,eneheuvel,26-09-11
200723ZW00311,2007,23ZW00,311,1,1,2,eneheuvel,26-09-11
200723ZW00312,2007,23ZW00,312,3,5,8,eneheuvel,26-09-11
200723ZW00313,2007,23ZW00,313,0,1,1,eneheuvel,26-09-11
200723ZW00502,2007,23ZW00,502,3,2,5,eneheuvel,26-09-11
200723ZW009999,2007,23ZW00,9999,1,2,3,eneheuvel,26-09-11
200723ZX00102,2007,23ZX00,102,0,1,1,eneheuvel,26-09-11
200723ZX00105,2007,23ZX00,105,0,1,1,eneheuvel,26-09-11
200723ZX00110,2007,23ZX00,110,0,2,2,eneheuvel,26-09-11
200723ZX00201,2007,23ZX00,201,8,7,15,eneheuvel,26-09-11
200723ZX00202,2007,23ZX00,202,122,128,250,eneheuvel,26-09-11
200723ZX00203,2007,23ZX00,203,2,0,2,eneheuvel,26-09-11
200723ZX00204,2007,23ZX00,204,4,6,10,eneheuvel,26-09-11
200723ZX00205,2007,23ZX00,205,4,5,9,eneheuvel,26-09-11
200723ZX00206,2007,23ZX00,206,0,1,1,eneheuvel,26-09-11
200723ZX00207,2007,23ZX00,207,2,2,4,eneheuvel,26-09-11
200723ZX00208,2007,23ZX00,208,5,6,11,eneheuvel,26-09-11
200723ZX00209,2007,23ZX00,209,2,0,2,eneheuvel,26-09-11
200723ZX00211,2007,23ZX00,211,2,4,6,eneheuvel,26-09-11
200723ZX00304,2007,23ZX00,304,0,2,2,eneheuvel,26-09-11
200723ZX00305,2007,23ZX00,305,1,0,1,eneheuvel,26-09-11
200723ZX00306,2007,23ZX00,306,0,1,1,eneheuvel,26-09-11
200723ZY00105,2007,23ZY00,105,1,0,1,eneheuvel,26-09-11
200723ZY00109,2007,23ZY00,109,0,2,2,eneheuvel,26-09-11
200723ZY00206,2007,23ZY00,206,1,2,3,eneheuvel,26-09-11
200723ZY00210,2007,23ZY00,210,2,0,2,eneheuvel,26-09-11
200723ZY00211,2007,23ZY00,211,3,3,6,eneheuvel,26-09-11
200723ZY00212,2007,23ZY00,212,170,206,376,eneheuvel,26-09-11
200723ZY00213,2007,23ZY00,213,0,1,1,eneheuvel,26-09-11
200723ZY00214,2007,23ZY00,214,1,0,1,eneheuvel,26-09-11
200723ZY00302,2007,23ZY00,302,0,1,1,eneheuvel,26-09-11
200723ZY00306,2007,23ZY00,306,1,0,1,eneheuvel,26-09-11
200723ZY009999,2007,23ZY00,9999,0,1,1,eneheuvel,26-09-11
200724EJ00101,2007,24EJ00,101,2,0,2,eneheuvel,26-09-11
200724EJ00102,2007,24EJ00,102,3,7,10,eneheuvel,26-09-11
200724EJ00106,2007,24EJ00,106,1,3,4,eneheuvel,26-09-11
200724EJ00107,2007,24EJ00,107,3,0,3,eneheuvel,26-09-11
200724EJ00108,2007,24EJ00,108,3,1,4,eneheuvel,26-09-11
200724EJ00201,2007,24EJ00,201,2,0,2,eneheuvel,26-09-11
200724EJ00202,2007,24EJ00,202,5,5,10,eneheuvel,26-09-11
200724EJ00203,2007,24EJ00,203,0,3,3,eneheuvel,26-09-11
200724EJ00204,2007,24EJ00,204,5,5,10,eneheuvel,26-09-11
200724EJ00205,2007,24EJ00,205,0,1,1,eneheuvel,26-09-11
200724EJ00206,2007,24EJ00,206,2,4,6,eneheuvel,26-09-11
200724EJ00207,2007,24EJ00,207,1,4,5,eneheuvel,26-09-11
200724EJ00208,2007,24EJ00,208,6,9,15,eneheuvel,26-09-11
200724EJ00209,2007,24EJ00,209,18,10,28,eneheuvel,26-09-11
200724EJ00210,2007,24EJ00,210,24,13,37,eneheuvel,26-09-11
200724EJ00211,2007,24EJ00,211,30,23,53,eneheuvel,26-09-11
200724EJ00212,2007,24EJ00,212,8,7,15,eneheuvel,26-09-11
200724EJ00213,2007,24EJ00,213,5,7,12,eneheuvel,26-09-11
200724EJ00214,2007,24EJ00,214,3,7,10,eneheuvel,26-09-11
200724EJ00303,2007,24EJ00,303,1,1,2,eneheuvel,26-09-11
200724EJ00308,2007,24EJ00,308,0,2,2,eneheuvel,26-09-11
200724EJ00309,2007,24EJ00,309,1,1,2,eneheuvel,26-09-11
200724EJ009999,2007,24EJ00,9999,3,1,4,eneheuvel,26-09-11
200724FT00102,2007,24FT00,102,1,1,2,eneheuvel,26-09-11
200724FT00103,2007,24FT00,103,0,1,1,eneheuvel,26-09-11
200724FT00105,2007,24FT00,105,0,5,5,eneheuvel,26-09-11
200724FT00106,2007,24FT00,106,0,2,2,eneheuvel,26-09-11
200724FT00202,2007,24FT00,202,1,1,2,eneheuvel,26-09-11
200724FT00203,2007,24FT00,203,0,2,2,eneheuvel,26-09-11
200724FT00204,2007,24FT00,204,1,4,5,eneheuvel,26-09-11
200724FT00205,2007,24FT00,205,1,3,4,eneheuvel,26-09-11
200724FT00206,2007,24FT00,206,0,7,7,eneheuvel,26-09-11
200724FT00207,2007,24FT00,207,0,2,2,eneheuvel,26-09-11
200724FT00208,2007,24FT00,208,2,11,13,eneheuvel,26-09-11
200724FT00209,2007,24FT00,209,0,1,1,eneheuvel,26-09-11
200724FT00210,2007,24FT00,210,0,3,3,eneheuvel,26-09-11
200724FT00211,2007,24FT00,211,4,9,13,eneheuvel,26-09-11
200724FT00212,2007,24FT00,212,4,16,20,eneheuvel,26-09-11
200724FT00213,2007,24FT00,213,3,6,9,eneheuvel,26-09-11
200724FT00214,2007,24FT00,214,4,16,20,eneheuvel,26-09-11
200724FT00302,2007,24FT00,302,0,12,12,eneheuvel,26-09-11
200724FT00303,2007,24FT00,303,0,11,11,eneheuvel,26-09-11
200724FT00304,2007,24FT00,304,0,6,6,eneheuvel,26-09-11
200724FT00305,2007,24FT00,305,0,2,2,eneheuvel,26-09-11
200724FT00306,2007,24FT00,306,4,2,6,eneheuvel,26-09-11
200724FT00307,2007,24FT00,307,1,4,5,eneheuvel,26-09-11
200724FT00308,2007,24FT00,308,3,9,12,eneheuvel,26-09-11
200724FT00309,2007,24FT00,309,0,7,7,eneheuvel,26-09-11
200724FT00311,2007,24FT00,311,2,11,13,eneheuvel,26-09-11
200724FT00312,2007,24FT00,312,2,11,13,eneheuvel,26-09-11
200724FT00502,2007,24FT00,502,0,2,2,eneheuvel,26-09-11
200724FT009999,2007,24FT00,9999,2,1,3,eneheuvel,26-09-11
200724MR00201,2007,24MR00,201,1,1,2,eneheuvel,26-09-11
200724MR00204,2007,24MR00,204,0,1,1,eneheuvel,26-09-11
200724MR00207,2007,24MR00,207,0,1,1,eneheuvel,26-09-11
200724MR00208,2007,24MR00,208,1,2,3,eneheuvel,26-09-11
200724MR00210,2007,24MR00,210,1,0,1,eneheuvel,26-09-11
200724MR00301,2007,24MR00,301,1,0,1,eneheuvel,26-09-11
200724MR00305,2007,24MR00,305,1,0,1,eneheuvel,26-09-11
200724MR00306,2007,24MR00,306,11,17,28,eneheuvel,26-09-11
200724MR00307,2007,24MR00,307,122,167,289,eneheuvel,26-09-11
200724MR00308,2007,24MR00,308,3,11,14,eneheuvel,26-09-11
200724MR00310,2007,24MR00,310,0,1,1,eneheuvel,26-09-11
200724MR00311,2007,24MR00,311,0,1,1,eneheuvel,26-09-11
200724MR00502,2007,24MR00,502,0,2,2,eneheuvel,26-09-11
200724MR009999,2007,24MR00,9999,3,0,3,eneheuvel,26-09-11
200724RK00108,2007,24RK00,108,0,1,1,eneheuvel,26-09-11
200724RK00202,2007,24RK00,202,16,21,37,eneheuvel,26-09-11
200724RK00203,2007,24RK00,203,12,10,22,eneheuvel,26-09-11
200724RK00204,2007,24RK00,204,13,12,25,eneheuvel,26-09-11
200724RK00205,2007,24RK00,205,4,7,11,eneheuvel,26-09-11
200724RK00206,2007,24RK00,206,3,0,3,eneheuvel,26-09-11
200724RK00207,2007,24RK00,207,7,3,10,eneheuvel,26-09-11
200724RK00208,2007,24RK00,208,3,3,6,eneheuvel,26-09-11
200724RK00210,2007,24RK00,210,0,3,3,eneheuvel,26-09-11
200724RK00212,2007,24RK00,212,2,0,2,eneheuvel,26-09-11
200724RK00213,2007,24RK00,213,2,1,3,eneheuvel,26-09-11
200724RK00214,2007,24RK00,214,3,1,4,eneheuvel,26-09-11
200724RK00216,2007,24RK00,216,0,2,2,eneheuvel,26-09-11
200724RK00301,2007,24RK00,301,0,1,1,eneheuvel,26-09-11
200724RK00302,2007,24RK00,302,4,2,6,eneheuvel,26-09-11
200724RK00303,2007,24RK00,303,8,2,10,eneheuvel,26-09-11
200724RK00304,2007,24RK00,304,3,5,8,eneheuvel,26-09-11
200724RK00305,2007,24RK00,305,0,3,3,eneheuvel,26-09-11
200724RK00306,2007,24RK00,306,3,4,7,eneheuvel,26-09-11
200724RK00307,2007,24RK00,307,5,1,6,eneheuvel,26-09-11
200724RK00308,2007,24RK00,308,6,5,11,eneheuvel,26-09-11
200724RK00309,2007,24RK00,309,2,2,4,eneheuvel,26-09-11
200724RK00312,2007,24RK00,312,1,0,1,eneheuvel,26-09-11
200724RK009999,2007,24RK00,9999,1,1,2,eneheuvel,26-09-11
200724UN00201,2007,24UN00,201,1,0,1,eneheuvel,26-09-11
200724UN00202,2007,24UN00,202,1,0,1,eneheuvel,26-09-11
200724UN00204,2007,24UN00,204,0,1,1,eneheuvel,26-09-11
200724UN00208,2007,24UN00,208,0,1,1,eneheuvel,26-09-11
200724UN00302,2007,24UN00,302,1,0,1,eneheuvel,26-09-11
200724UN00303,2007,24UN00,303,2,2,4,eneheuvel,26-09-11
200724UN00304,2007,24UN00,304,0,1,1,eneheuvel,26-09-11
200724UN00306,2007,24UN00,306,29,30,59,eneheuvel,26-09-11
200724UN00307,2007,24UN00,307,60,42,102,eneheuvel,26-09-11
200724UN00308,2007,24UN00,308,53,56,109,eneheuvel,26-09-11
200724UN00309,2007,24UN00,309,17,16,33,eneheuvel,26-09-11
200724UN00311,2007,24UN00,311,3,5,8,eneheuvel,26-09-11
200724UN00313,2007,24UN00,313,1,0,1,eneheuvel,26-09-11
200724UN009999,2007,24UN00,9999,1,0,1,eneheuvel,26-09-11
200725CF00202,2007,25CF00,202,4,5,9,eneheuvel,26-09-11
200725CF00203,2007,25CF00,203,6,8,14,eneheuvel,26-09-11
200725CF00204,2007,25CF00,204,58,91,149,eneheuvel,26-09-11
200725CF00205,2007,25CF00,205,25,49,74,eneheuvel,26-09-11
200725CF00206,2007,25CF00,206,0,1,1,eneheuvel,26-09-11
200725CF00207,2007,25CF00,207,3,7,10,eneheuvel,26-09-11
200725CF00208,2007,25CF00,208,3,7,10,eneheuvel,26-09-11
200725CF00210,2007,25CF00,210,1,1,2,eneheuvel,26-09-11
200725CF00211,2007,25CF00,211,1,0,1,eneheuvel,26-09-11
200725CF00212,2007,25CF00,212,1,0,1,eneheuvel,26-09-11
200725CF00303,2007,25CF00,303,0,1,1,eneheuvel,26-09-11
200725CF00309,2007,25CF00,309,1,0,1,eneheuvel,26-09-11
200725CF00312,2007,25CF00,312,0,1,1,eneheuvel,26-09-11
200725CF009999,2007,25CF00,9999,0,1,1,eneheuvel,26-09-11
200725KT00107,2007,25KT00,107,0,1,1,eneheuvel,26-09-11
200725KT00201,2007,25KT00,201,1,0,1,eneheuvel,26-09-11
200725KT00202,2007,25KT00,202,48,61,109,eneheuvel,26-09-11
200725KT00203,2007,25KT00,203,112,79,191,eneheuvel,26-09-11
200725KT00204,2007,25KT00,204,86,82,168,eneheuvel,26-09-11
200725KT00205,2007,25KT00,205,6,6,12,eneheuvel,26-09-11
200725KT00207,2007,25KT00,207,25,3,28,eneheuvel,26-09-11
200725KT00208,2007,25KT00,208,43,34,77,eneheuvel,26-09-11
200725KT00211,2007,25KT00,211,1,0,1,eneheuvel,26-09-11
200725KT00212,2007,25KT00,212,0,1,1,eneheuvel,26-09-11
200725KT00306,2007,25KT00,306,2,0,2,eneheuvel,26-09-11
200725KT00312,2007,25KT00,312,0,1,1,eneheuvel,26-09-11
200725KT00502,2007,25KT00,502,9,13,22,eneheuvel,26-09-11
200725KT009999,2007,25KT00,9999,3,1,4,eneheuvel,26-09-11
200725KU00109,2007,25KU00,109,1,1,2,eneheuvel,26-09-11
200725KU00110,2007,25KU00,110,2,0,2,eneheuvel,26-09-11
200725KU00201,2007,25KU00,201,0,1,1,eneheuvel,26-09-11
200725KU00202,2007,25KU00,202,25,28,53,eneheuvel,26-09-11
200725KU00203,2007,25KU00,203,78,41,119,eneheuvel,26-09-11
200725KU00204,2007,25KU00,204,75,73,148,eneheuvel,26-09-11
200725KU00205,2007,25KU00,205,2,2,4,eneheuvel,26-09-11
200725KU00206,2007,25KU00,206,1,0,1,eneheuvel,26-09-11
200725KU00207,2007,25KU00,207,13,6,19,eneheuvel,26-09-11
200725KU00208,2007,25KU00,208,23,34,57,eneheuvel,26-09-11
200725KU00211,2007,25KU00,211,1,0,1,eneheuvel,26-09-11
200725KU00216,2007,25KU00,216,2,0,2,eneheuvel,26-09-11
200725KU00303,2007,25KU00,303,1,0,1,eneheuvel,26-09-11
200725KU00304,2007,25KU00,304,1,0,1,eneheuvel,26-09-11
200725KU00308,2007,25KU00,308,1,0,1,eneheuvel,26-09-11
200725KU00309,2007,25KU00,309,1,0,1,eneheuvel,26-09-11
200725KU00313,2007,25KU00,313,1,0,1,eneheuvel,26-09-11
200725KU00502,2007,25KU00,502,5,11,16,eneheuvel,26-09-11
200725KV00101,2007,25KV00,101,2,0,2,eneheuvel,26-09-11
200725KV00108,2007,25KV00,108,2,0,2,eneheuvel,26-09-11
200725KV00201,2007,25KV00,201,1,2,3,eneheuvel,26-09-11
200725KV00202,2007,25KV00,202,2,5,7,eneheuvel,26-09-11
200725KV00203,2007,25KV00,203,189,185,374,eneheuvel,26-09-11
200725KV00204,2007,25KV00,204,5,12,17,eneheuvel,26-09-11
200725KV00205,2007,25KV00,205,1,2,3,eneheuvel,26-09-11
200725KV00206,2007,25KV00,206,1,0,1,eneheuvel,26-09-11
200725KV00207,2007,25KV00,207,1,1,2,eneheuvel,26-09-11
200725KV00208,2007,25KV00,208,3,11,14,eneheuvel,26-09-11
200725KV00209,2007,25KV00,209,1,0,1,eneheuvel,26-09-11
200725KV00211,2007,25KV00,211,1,1,2,eneheuvel,26-09-11
200725KV00214,2007,25KV00,214,0,1,1,eneheuvel,26-09-11
200725KV00302,2007,25KV00,302,0,1,1,eneheuvel,26-09-11
200725KV00309,2007,25KV00,309,0,1,1,eneheuvel,26-09-11
200725KV00310,2007,25KV00,310,1,0,1,eneheuvel,26-09-11
200725KV00311,2007,25KV00,311,1,1,2,eneheuvel,26-09-11
200726AB00103,2007,26AB00,103,1,0,1,eneheuvel,26-09-11
200726AB00202,2007,26AB00,202,1,1,2,eneheuvel,26-09-11
200726AB00205,2007,26AB00,205,1,0,1,eneheuvel,26-09-11
200726AB00208,2007,26AB00,208,1,0,1,eneheuvel,26-09-11
200726AB00211,2007,26AB00,211,0,2,2,eneheuvel,26-09-11
200726AB00214,2007,26AB00,214,1,0,1,eneheuvel,26-09-11
200726AB00302,2007,26AB00,302,17,19,36,eneheuvel,26-09-11
200726AB00303,2007,26AB00,303,181,184,365,eneheuvel,26-09-11
200726AB00304,2007,26AB00,304,2,3,5,eneheuvel,26-09-11
200726AB00305,2007,26AB00,305,1,0,1,eneheuvel,26-09-11
200726AB00306,2007,26AB00,306,1,3,4,eneheuvel,26-09-11
200726AB00308,2007,26AB00,308,0,2,2,eneheuvel,26-09-11
200726AB00309,2007,26AB00,309,2,3,5,eneheuvel,26-09-11
200726AB00310,2007,26AB00,310,1,0,1,eneheuvel,26-09-11
200726AB00311,2007,26AB00,311,5,6,11,eneheuvel,26-09-11
200726AB00312,2007,26AB00,312,0,1,1,eneheuvel,26-09-11
200726AB00313,2007,26AB00,313,5,4,9,eneheuvel,26-09-11
200726AB009999,2007,26AB00,9999,2,1,3,eneheuvel,26-09-11
200726AC00102,2007,26AC00,102,1,0,1,eneheuvel,26-09-11
200726AC00107,2007,26AC00,107,1,1,2,eneheuvel,26-09-11
200726AC00109,2007,26AC00,109,22,9,31,eneheuvel,26-09-11
200726AC00201,2007,26AC00,201,1,1,2,eneheuvel,26-09-11
200726AC00203,2007,26AC00,203,2,1,3,eneheuvel,26-09-11
200726AC00204,2007,26AC00,204,0,1,1,eneheuvel,26-09-11
200726AC00206,2007,26AC00,206,1,0,1,eneheuvel,26-09-11
200726AC00208,2007,26AC00,208,0,1,1,eneheuvel,26-09-11
200726AC00210,2007,26AC00,210,1,0,1,eneheuvel,26-09-11
200726AC00211,2007,26AC00,211,6,6,12,eneheuvel,26-09-11
200726AC00212,2007,26AC00,212,14,16,30,eneheuvel,26-09-11
200726AC00213,2007,26AC00,213,17,18,35,eneheuvel,26-09-11
200726AC00214,2007,26AC00,214,485,377,862,eneheuvel,26-09-11
200726AC00215,2007,26AC00,215,0,1,1,eneheuvel,26-09-11
200726AC00216,2007,26AC00,216,1,0,1,eneheuvel,26-09-11
200726AC00301,2007,26AC00,301,1,0,1,eneheuvel,26-09-11
200726AC00302,2007,26AC00,302,0,1,1,eneheuvel,26-09-11
200726AC00303,2007,26AC00,303,0,1,1,eneheuvel,26-09-11
200726AC00311,2007,26AC00,311,3,0,3,eneheuvel,26-09-11
200726AC00312,2007,26AC00,312,1,1,2,eneheuvel,26-09-11
200726AC009999,2007,26AC00,9999,1,3,4,eneheuvel,26-09-11
200726AD00201,2007,26AD00,201,1,1,2,eneheuvel,26-09-11
200726AD00202,2007,26AD00,202,1,0,1,eneheuvel,26-09-11
200726AD00203,2007,26AD00,203,0,1,1,eneheuvel,26-09-11
200726AD00207,2007,26AD00,207,0,1,1,eneheuvel,26-09-11
200726AD00208,2007,26AD00,208,1,0,1,eneheuvel,26-09-11
200726AD00214,2007,26AD00,214,1,1,2,eneheuvel,26-09-11
200726AD00301,2007,26AD00,301,0,1,1,eneheuvel,26-09-11
200726AD00302,2007,26AD00,302,104,71,175,eneheuvel,26-09-11
200726AD00303,2007,26AD00,303,43,22,65,eneheuvel,26-09-11
200726AD00305,2007,26AD00,305,3,2,5,eneheuvel,26-09-11
200726AD00306,2007,26AD00,306,1,2,3,eneheuvel,26-09-11
200726AD00307,2007,26AD00,307,0,2,2,eneheuvel,26-09-11
200726AD00308,2007,26AD00,308,3,2,5,eneheuvel,26-09-11
200726AD00309,2007,26AD00,309,74,36,110,eneheuvel,26-09-11
200726AD00310,2007,26AD00,310,16,7,23,eneheuvel,26-09-11
200726AD00311,2007,26AD00,311,43,42,85,eneheuvel,26-09-11
200726AD00312,2007,26AD00,312,5,1,6,eneheuvel,26-09-11
200726AD00313,2007,26AD00,313,7,7,14,eneheuvel,26-09-11
200726AD00502,2007,26AD00,502,1,1,2,eneheuvel,26-09-11
200726AD009999,2007,26AD00,9999,1,1,2,eneheuvel,26-09-11
200726PD00104,2007,26PD00,104,1,0,1,eneheuvel,26-09-11
200726PD00201,2007,26PD00,201,1,1,2,eneheuvel,26-09-11
200726PD00204,2007,26PD00,204,2,2,4,eneheuvel,26-09-11
200726PD00205,2007,26PD00,205,4,4,8,eneheuvel,26-09-11
200726PD00207,2007,26PD00,207,159,207,366,eneheuvel,26-09-11
200726PD00208,2007,26PD00,208,41,69,110,eneheuvel,26-09-11
200726PD00210,2007,26PD00,210,1,1,2,eneheuvel,26-09-11
200726PD00211,2007,26PD00,211,0,1,1,eneheuvel,26-09-11
200726PD00212,2007,26PD00,212,0,3,3,eneheuvel,26-09-11
200726PD00312,2007,26PD00,312,0,1,1,eneheuvel,26-09-11
200726PD00502,2007,26PD00,502,2,2,4,eneheuvel,26-09-11
200726PD009999,2007,26PD00,9999,1,2,3,eneheuvel,26-09-11
200726PE00201,2007,26PE00,201,1,1,2,eneheuvel,26-09-11
200726PE00203,2007,26PE00,203,1,0,1,eneheuvel,26-09-11
200726PE00209,2007,26PE00,209,1,0,1,eneheuvel,26-09-11
200726PE00302,2007,26PE00,302,268,260,528,eneheuvel,26-09-11
200726PE00303,2007,26PE00,303,20,16,36,eneheuvel,26-09-11
200726PE00304,2007,26PE00,304,0,1,1,eneheuvel,26-09-11
200726PE00306,2007,26PE00,306,1,1,2,eneheuvel,26-09-11
200726PE00309,2007,26PE00,309,4,1,5,eneheuvel,26-09-11
200726PE00310,2007,26PE00,310,0,1,1,eneheuvel,26-09-11
200726PE00311,2007,26PE00,311,3,9,12,eneheuvel,26-09-11
200726PE00312,2007,26PE00,312,3,0,3,eneheuvel,26-09-11
200726PE00313,2007,26PE00,313,6,3,9,eneheuvel,26-09-11
200726PE009999,2007,26PE00,9999,2,2,4,eneheuvel,26-09-11
200726PF00103,2007,26PF00,103,1,0,1,eneheuvel,26-09-11
200726PF00201,2007,26PF00,201,4,0,4,eneheuvel,26-09-11
200726PF00202,2007,26PF00,202,1,1,2,eneheuvel,26-09-11
200726PF00203,2007,26PF00,203,1,0,1,eneheuvel,26-09-11
200726PF00206,2007,26PF00,206,3,0,3,eneheuvel,26-09-11
200726PF00208,2007,26PF00,208,0,1,1,eneheuvel,26-09-11
200726PF00209,2007,26PF00,209,0,1,1,eneheuvel,26-09-11
200726PF00210,2007,26PF00,210,1,0,1,eneheuvel,26-09-11
200726PF00211,2007,26PF00,211,5,6,11,eneheuvel,26-09-11
200726PF00212,2007,26PF00,212,8,4,12,eneheuvel,26-09-11
200726PF00213,2007,26PF00,213,3,3,6,eneheuvel,26-09-11
200726PF00214,2007,26PF00,214,189,202,391,eneheuvel,26-09-11
200726PF00216,2007,26PF00,216,1,0,1,eneheuvel,26-09-11
200726PF00302,2007,26PF00,302,1,3,4,eneheuvel,26-09-11
200726PF00308,2007,26PF00,308,1,0,1,eneheuvel,26-09-11
200726PF00309,2007,26PF00,309,2,1,3,eneheuvel,26-09-11
200726PF00311,2007,26PF00,311,1,0,1,eneheuvel,26-09-11
200726PF00312,2007,26PF00,312,0,2,2,eneheuvel,26-09-11
200726PF009999,2007,26PF00,9999,3,1,4,eneheuvel,26-09-11
200726PG00103,2007,26PG00,103,0,1,1,eneheuvel,26-09-11
200726PG00108,2007,26PG00,108,1,0,1,eneheuvel,26-09-11
200726PG00207,2007,26PG00,207,2,0,2,eneheuvel,26-09-11
200726PG00209,2007,26PG00,209,0,1,1,eneheuvel,26-09-11
200726PG00210,2007,26PG00,210,1,0,1,eneheuvel,26-09-11
200726PG00211,2007,26PG00,211,2,0,2,eneheuvel,26-09-11
200726PG00212,2007,26PG00,212,0,2,2,eneheuvel,26-09-11
200726PG00213,2007,26PG00,213,2,0,2,eneheuvel,26-09-11
200726PG00214,2007,26PG00,214,71,103,174,eneheuvel,26-09-11
200726PG009999,2007,26PG00,9999,2,1,3,eneheuvel,26-09-11
200726PH00201,2007,26PH00,201,0,1,1,eneheuvel,26-09-11
200726PH00211,2007,26PH00,211,1,0,1,eneheuvel,26-09-11
200726PH00212,2007,26PH00,212,1,0,1,eneheuvel,26-09-11
200726PH00216,2007,26PH00,216,0,1,1,eneheuvel,26-09-11
200726PH00302,2007,26PH00,302,30,13,43,eneheuvel,26-09-11
200726PH00303,2007,26PH00,303,9,6,15,eneheuvel,26-09-11
200726PH00304,2007,26PH00,304,3,0,3,eneheuvel,26-09-11
200726PH00305,2007,26PH00,305,2,0,2,eneheuvel,26-09-11
200726PH00306,2007,26PH00,306,2,1,3,eneheuvel,26-09-11
200726PH00307,2007,26PH00,307,1,2,3,eneheuvel,26-09-11
200726PH00308,2007,26PH00,308,2,1,3,eneheuvel,26-09-11
200726PH00309,2007,26PH00,309,53,24,77,eneheuvel,26-09-11
200726PH00311,2007,26PH00,311,257,184,441,eneheuvel,26-09-11
200726PH00312,2007,26PH00,312,11,10,21,eneheuvel,26-09-11
200726PH00313,2007,26PH00,313,5,5,10,eneheuvel,26-09-11
200726PH009999,2007,26PH00,9999,6,2,8,eneheuvel,26-09-11
200726PW00302,2007,26PW00,302,41,37,78,eneheuvel,26-09-11
200726PW00303,2007,26PW00,303,41,22,63,eneheuvel,26-09-11
200726PW00306,2007,26PW00,306,1,0,1,eneheuvel,26-09-11
200726PW00307,2007,26PW00,307,0,2,2,eneheuvel,26-09-11
200726PW00308,2007,26PW00,308,3,2,5,eneheuvel,26-09-11
200726PW00309,2007,26PW00,309,45,31,76,eneheuvel,26-09-11
200726PW00310,2007,26PW00,310,9,4,13,eneheuvel,26-09-11
200726PW00311,2007,26PW00,311,27,16,43,eneheuvel,26-09-11
200726PW00312,2007,26PW00,312,3,2,5,eneheuvel,26-09-11
200726PW00313,2007,26PW00,313,3,3,6,eneheuvel,26-09-11
200726ZZ00202,2007,26ZZ00,202,250,216,466,eneheuvel,26-09-11
200726ZZ00203,2007,26ZZ00,203,11,11,22,eneheuvel,26-09-11
200726ZZ00204,2007,26ZZ00,204,4,4,8,eneheuvel,26-09-11
200726ZZ00205,2007,26ZZ00,205,0,1,1,eneheuvel,26-09-11
200726ZZ00206,2007,26ZZ00,206,1,0,1,eneheuvel,26-09-11
200726ZZ00207,2007,26ZZ00,207,0,1,1,eneheuvel,26-09-11
200726ZZ00208,2007,26ZZ00,208,4,4,8,eneheuvel,26-09-11
200726ZZ00209,2007,26ZZ00,209,0,1,1,eneheuvel,26-09-11
200726ZZ00210,2007,26ZZ00,210,1,1,2,eneheuvel,26-09-11
200726ZZ00211,2007,26ZZ00,211,1,0,1,eneheuvel,26-09-11
200726ZZ00214,2007,26ZZ00,214,0,1,1,eneheuvel,26-09-11
200726ZZ00309,2007,26ZZ00,309,0,2,2,eneheuvel,26-09-11
200726ZZ00312,2007,26ZZ00,312,1,0,1,eneheuvel,26-09-11
200726ZZ00313,2007,26ZZ00,313,1,0,1,eneheuvel,26-09-11
200726ZZ00502,2007,26ZZ00,502,1,1,2,eneheuvel,26-09-11
200726ZZ009999,2007,26ZZ00,9999,1,0,1,eneheuvel,26-09-11
200727AA00106,2007,27AA00,106,0,1,1,eneheuvel,26-09-11
200727AA00201,2007,27AA00,201,1,0,1,eneheuvel,26-09-11
200727AA00202,2007,27AA00,202,1,0,1,eneheuvel,26-09-11
200727AA00203,2007,27AA00,203,6,1,7,eneheuvel,26-09-11
200727AA00204,2007,27AA00,204,14,10,24,eneheuvel,26-09-11
200727AA00205,2007,27AA00,205,5,4,9,eneheuvel,26-09-11
200727AA00206,2007,27AA00,206,0,1,1,eneheuvel,26-09-11
200727AA00207,2007,27AA00,207,75,61,136,eneheuvel,26-09-11
200727AA00208,2007,27AA00,208,195,155,350,eneheuvel,26-09-11
200727AA00209,2007,27AA00,209,0,1,1,eneheuvel,26-09-11
200727AA00210,2007,27AA00,210,3,0,3,eneheuvel,26-09-11
200727AA00211,2007,27AA00,211,0,1,1,eneheuvel,26-09-11
200727AA00212,2007,27AA00,212,0,1,1,eneheuvel,26-09-11
200727AA00214,2007,27AA00,214,1,2,3,eneheuvel,26-09-11
200727AA00216,2007,27AA00,216,0,1,1,eneheuvel,26-09-11
200727AA00301,2007,27AA00,301,0,1,1,eneheuvel,26-09-11
200727AA00302,2007,27AA00,302,0,1,1,eneheuvel,26-09-11
200727AA00303,2007,27AA00,303,2,1,3,eneheuvel,26-09-11
200727AA00305,2007,27AA00,305,0,1,1,eneheuvel,26-09-11
200727AA00307,2007,27AA00,307,2,3,5,eneheuvel,26-09-11
200727AA00308,2007,27AA00,308,1,0,1,eneheuvel,26-09-11
200727AA00309,2007,27AA00,309,0,3,3,eneheuvel,26-09-11
200727AA00311,2007,27AA00,311,1,0,1,eneheuvel,26-09-11
200727AA00312,2007,27AA00,312,1,1,2,eneheuvel,26-09-11
200727AA009999,2007,27AA00,9999,2,1,3,eneheuvel,26-09-11
200727NU00103,2007,27NU00,103,1,0,1,eneheuvel,26-09-11
200727NU00108,2007,27NU00,108,1,0,1,eneheuvel,26-09-11
200727NU00201,2007,27NU00,201,2,0,2,eneheuvel,26-09-11
200727NU00203,2007,27NU00,203,7,3,10,eneheuvel,26-09-11
200727NU00204,2007,27NU00,204,4,1,5,eneheuvel,26-09-11
200727NU00205,2007,27NU00,205,2,0,2,eneheuvel,26-09-11
200727NU00206,2007,27NU00,206,1,0,1,eneheuvel,26-09-11
200727NU00207,2007,27NU00,207,18,12,30,eneheuvel,26-09-11
200727NU00208,2007,27NU00,208,168,97,265,eneheuvel,26-09-11
200727NU00209,2007,27NU00,209,1,0,1,eneheuvel,26-09-11
200727NU00210,2007,27NU00,210,2,1,3,eneheuvel,26-09-11
200727NU00302,2007,27NU00,302,2,1,3,eneheuvel,26-09-11
200727NU00305,2007,27NU00,305,1,1,2,eneheuvel,26-09-11
200727NU00311,2007,27NU00,311,0,1,1,eneheuvel,26-09-11
200727NU00502,2007,27NU00,502,0,2,2,eneheuvel,26-09-11
200727NU009999,2007,27NU00,9999,2,2,4,eneheuvel,26-09-11
200727UB00202,2007,27UB00,202,0,1,1,eneheuvel,26-09-11
200727UB00203,2007,27UB00,203,6,3,9,eneheuvel,26-09-11
200727UB00204,2007,27UB00,204,2,1,3,eneheuvel,26-09-11
200727UB00205,2007,27UB00,205,1,0,1,eneheuvel,26-09-11
200727UB00207,2007,27UB00,207,8,2,10,eneheuvel,26-09-11
200727UB00208,2007,27UB00,208,164,82,246,eneheuvel,26-09-11
200727UB00211,2007,27UB00,211,2,0,2,eneheuvel,26-09-11
200727UB00213,2007,27UB00,213,0,1,1,eneheuvel,26-09-11
200727UB00301,2007,27UB00,301,0,1,1,eneheuvel,26-09-11
200727UB00302,2007,27UB00,302,1,0,1,eneheuvel,26-09-11
200727UB00305,2007,27UB00,305,1,0,1,eneheuvel,26-09-11
200727UB00306,2007,27UB00,306,1,2,3,eneheuvel,26-09-11
200727UB00307,2007,27UB00,307,2,0,2,eneheuvel,26-09-11
200727UB00309,2007,27UB00,309,1,1,2,eneheuvel,26-09-11
200727UB00310,2007,27UB00,310,1,0,1,eneheuvel,26-09-11
200727UB00311,2007,27UB00,311,4,1,5,eneheuvel,26-09-11
200727UB00502,2007,27UB00,502,3,2,5,eneheuvel,26-09-11
200727XH00202,2007,27XH00,202,2,1,3,eneheuvel,26-09-11
200727XH00206,2007,27XH00,206,1,4,5,eneheuvel,26-09-11
200727XH00209,2007,27XH00,209,2,1,3,eneheuvel,26-09-11
200727XH00210,2007,27XH00,210,9,5,14,eneheuvel,26-09-11
200727XH00211,2007,27XH00,211,1,0,1,eneheuvel,26-09-11
200727XH00212,2007,27XH00,212,3,4,7,eneheuvel,26-09-11
200727XH00214,2007,27XH00,214,11,3,14,eneheuvel,26-09-11
200727XH00215,2007,27XH00,215,18,24,42,eneheuvel,26-09-11
200727XH00216,2007,27XH00,216,72,51,123,eneheuvel,26-09-11
200727XH00302,2007,27XH00,302,1,0,1,eneheuvel,26-09-11
200727XH00303,2007,27XH00,303,1,0,1,eneheuvel,26-09-11
200727XH00307,2007,27XH00,307,0,1,1,eneheuvel,26-09-11
200727XH00311,2007,27XH00,311,2,1,3,eneheuvel,26-09-11
200727XJ00201,2007,27XJ00,201,1,0,1,eneheuvel,26-09-11
200727XJ00202,2007,27XJ00,202,0,1,1,eneheuvel,26-09-11
200727XJ00203,2007,27XJ00,203,2,0,2,eneheuvel,26-09-11
200727XJ00205,2007,27XJ00,205,1,1,2,eneheuvel,26-09-11
200727XJ00207,2007,27XJ00,207,1,0,1,eneheuvel,26-09-11
200727XJ00208,2007,27XJ00,208,3,0,3,eneheuvel,26-09-11
200727XJ00212,2007,27XJ00,212,1,1,2,eneheuvel,26-09-11
200727XJ00302,2007,27XJ00,302,16,0,16,eneheuvel,26-09-11
200727XJ00303,2007,27XJ00,303,5,0,5,eneheuvel,26-09-11
200727XJ00304,2007,27XJ00,304,1,0,1,eneheuvel,26-09-11
200727XJ00305,2007,27XJ00,305,0,1,1,eneheuvel,26-09-11
200727XJ00306,2007,27XJ00,306,2,0,2,eneheuvel,26-09-11
200727XJ00307,2007,27XJ00,307,1,0,1,eneheuvel,26-09-11
200727XJ00308,2007,27XJ00,308,0,1,1,eneheuvel,26-09-11
200727XJ00309,2007,27XJ00,309,2,1,3,eneheuvel,26-09-11
200727XJ00311,2007,27XJ00,311,18,2,20,eneheuvel,26-09-11
200727XJ00312,2007,27XJ00,312,104,34,138,eneheuvel,26-09-11
200727XJ00313,2007,27XJ00,313,25,8,33,eneheuvel,26-09-11
200727XJ00502,2007,27XJ00,502,1,2,3,eneheuvel,26-09-11
200727XJ009999,2007,27XJ00,9999,3,2,5,eneheuvel,26-09-11
200727YN00109,2007,27YN00,109,1,0,1,eneheuvel,26-09-11
200727YN00202,2007,27YN00,202,0,1,1,eneheuvel,26-09-11
200727YN00206,2007,27YN00,206,0,2,2,eneheuvel,26-09-11
200727YN00207,2007,27YN00,207,1,0,1,eneheuvel,26-09-11
200727YN00210,2007,27YN00,210,2,2,4,eneheuvel,26-09-11
200727YN00211,2007,27YN00,211,0,2,2,eneheuvel,26-09-11
200727YN00212,2007,27YN00,212,2,5,7,eneheuvel,26-09-11
200727YN00214,2007,27YN00,214,1,0,1,eneheuvel,26-09-11
200727YN00215,2007,27YN00,215,3,3,6,eneheuvel,26-09-11
200727YN00216,2007,27YN00,216,67,52,119,eneheuvel,26-09-11
200727YN00302,2007,27YN00,302,1,1,2,eneheuvel,26-09-11
200727YN00308,2007,27YN00,308,0,1,1,eneheuvel,26-09-11
200727YN00309,2007,27YN00,309,3,0,3,eneheuvel,26-09-11
200727YN00311,2007,27YN00,311,2,0,2,eneheuvel,26-09-11
200727YN009999,2007,27YN00,9999,2,1,3,eneheuvel,26-09-11
200728AM00105,2007,28AM00,105,1,1,2,eneheuvel,26-09-11
200728AM00201,2007,28AM00,201,0,1,1,eneheuvel,26-09-11
200728AM00203,2007,28AM00,203,1,0,1,eneheuvel,26-09-11
200728AM00211,2007,28AM00,211,0,1,1,eneheuvel,26-09-11
200728AM00214,2007,28AM00,214,1,0,1,eneheuvel,26-09-11
200728AM00301,2007,28AM00,301,1,0,1,eneheuvel,26-09-11
200728AM00302,2007,28AM00,302,3,0,3,eneheuvel,26-09-11
200728AM00307,2007,28AM00,307,2,0,2,eneheuvel,26-09-11
200728AM00308,2007,28AM00,308,1,1,2,eneheuvel,26-09-11
200728AM00309,2007,28AM00,309,2,1,3,eneheuvel,26-09-11
200728AM00311,2007,28AM00,311,10,3,13,eneheuvel,26-09-11
200728AM00312,2007,28AM00,312,124,100,224,eneheuvel,26-09-11
200728AM00313,2007,28AM00,313,4,3,7,eneheuvel,26-09-11
200728AM009999,2007,28AM00,9999,1,0,1,eneheuvel,26-09-11
200728BR00108,2007,28BR00,108,0,1,1,eneheuvel,26-09-11
200728BR00203,2007,28BR00,203,2,0,2,eneheuvel,26-09-11
200728BR00207,2007,28BR00,207,0,1,1,eneheuvel,26-09-11
200728BR00208,2007,28BR00,208,1,1,2,eneheuvel,26-09-11
200728BR00211,2007,28BR00,211,1,3,4,eneheuvel,26-09-11
200728BR00212,2007,28BR00,212,4,4,8,eneheuvel,26-09-11
200728BR00213,2007,28BR00,213,1,0,1,eneheuvel,26-09-11
200728BR00301,2007,28BR00,301,1,3,4,eneheuvel,26-09-11
200728BR00302,2007,28BR00,302,5,4,9,eneheuvel,26-09-11
200728BR00303,2007,28BR00,303,1,3,4,eneheuvel,26-09-11
200728BR00304,2007,28BR00,304,1,1,2,eneheuvel,26-09-11
200728BR00305,2007,28BR00,305,1,1,2,eneheuvel,26-09-11
200728BR00306,2007,28BR00,306,1,0,1,eneheuvel,26-09-11
200728BR00307,2007,28BR00,307,1,0,1,eneheuvel,26-09-11
200728BR00308,2007,28BR00,308,1,1,2,eneheuvel,26-09-11
200728BR00309,2007,28BR00,309,3,2,5,eneheuvel,26-09-11
200728BR00311,2007,28BR00,311,13,8,21,eneheuvel,26-09-11
200728BR00312,2007,28BR00,312,0,1,1,eneheuvel,26-09-11
200728BR009999,2007,28BR00,9999,0,1,1,eneheuvel,26-09-11
200728DJ00103,2007,28DJ00,103,0,2,2,eneheuvel,26-09-11
200728DJ00105,2007,28DJ00,105,1,2,3,eneheuvel,26-09-11
200728DJ00107,2007,28DJ00,107,2,0,2,eneheuvel,26-09-11
200728DJ00108,2007,28DJ00,108,2,1,3,eneheuvel,26-09-11
200728DJ00202,2007,28DJ00,202,2,0,2,eneheuvel,26-09-11
200728DJ00203,2007,28DJ00,203,8,2,10,eneheuvel,26-09-11
200728DJ00204,2007,28DJ00,204,2,3,5,eneheuvel,26-09-11
200728DJ00205,2007,28DJ00,205,3,1,4,eneheuvel,26-09-11
200728DJ00206,2007,28DJ00,206,1,1,2,eneheuvel,26-09-11
200728DJ00207,2007,28DJ00,207,6,7,13,eneheuvel,26-09-11
200728DJ00208,2007,28DJ00,208,9,9,18,eneheuvel,26-09-11
200728DJ00210,2007,28DJ00,210,4,3,7,eneheuvel,26-09-11
200728DJ00211,2007,28DJ00,211,5,1,6,eneheuvel,26-09-11
200728DJ00212,2007,28DJ00,212,2,5,7,eneheuvel,26-09-11
200728DJ00213,2007,28DJ00,213,1,2,3,eneheuvel,26-09-11
200728DJ00214,2007,28DJ00,214,2,1,3,eneheuvel,26-09-11
200728DJ00216,2007,28DJ00,216,1,0,1,eneheuvel,26-09-11
200728DJ00301,2007,28DJ00,301,1,2,3,eneheuvel,26-09-11
200728DJ00302,2007,28DJ00,302,1,2,3,eneheuvel,26-09-11
200728DJ00303,2007,28DJ00,303,2,1,3,eneheuvel,26-09-11
200728DJ00304,2007,28DJ00,304,1,3,4,eneheuvel,26-09-11
200728DJ00305,2007,28DJ00,305,7,8,15,eneheuvel,26-09-11
200728DJ00306,2007,28DJ00,306,4,2,6,eneheuvel,26-09-11
200728DJ00307,2007,28DJ00,307,5,4,9,eneheuvel,26-09-11
200728DJ00308,2007,28DJ00,308,2,1,3,eneheuvel,26-09-11
200728DJ009999,2007,28DJ00,9999,0,1,1,eneheuvel,26-09-11
200729UB00202,2007,29UB00,202,0,1,1,eneheuvel,26-09-11
200729UB00311,2007,29UB00,311,0,1,1,eneheuvel,26-09-11
200729UN00211,2007,29UN00,211,1,0,1,eneheuvel,26-09-11
200729UN00213,2007,29UN00,213,2,0,2,eneheuvel,26-09-11
200729UN00304,2007,29UN00,304,2,0,2,eneheuvel,26-09-11
200729UN00308,2007,29UN00,308,1,0,1,eneheuvel,26-09-11
200729UN00309,2007,29UN00,309,0,1,1,eneheuvel,26-09-11
200729UN00311,2007,29UN00,311,1,1,2,eneheuvel,26-09-11
200729UN00312,2007,29UN00,312,1,0,1,eneheuvel,26-09-11
200806RM00102,2008,06RM00,102,1,4,5,eneheuvel,26-09-11
200806RM00103,2008,06RM00,103,4,1,5,eneheuvel,26-09-11
200806RM00104,2008,06RM00,104,0,2,2,eneheuvel,26-09-11
200806RM00105,2008,06RM00,105,1,1,2,eneheuvel,26-09-11
200806RM00106,2008,06RM00,106,2,0,2,eneheuvel,26-09-11
200806RM00109,2008,06RM00,109,0,2,2,eneheuvel,26-09-11
200806RM00202,2008,06RM00,202,7,7,14,eneheuvel,26-09-11
200806RM00204,2008,06RM00,204,3,3,6,eneheuvel,26-09-11
200806RM00206,2008,06RM00,206,2,5,7,eneheuvel,26-09-11
200806RM00207,2008,06RM00,207,2,0,2,eneheuvel,26-09-11
200806RM00208,2008,06RM00,208,1,1,2,eneheuvel,26-09-11
200806RM00210,2008,06RM00,210,6,10,16,eneheuvel,26-09-11
200806RM00211,2008,06RM00,211,6,9,15,eneheuvel,26-09-11
200806RM00212,2008,06RM00,212,20,34,54,eneheuvel,26-09-11
200806RM00213,2008,06RM00,213,7,6,13,eneheuvel,26-09-11
200806RM00214,2008,06RM00,214,17,10,27,eneheuvel,26-09-11
200806RM00215,2008,06RM00,215,2,1,3,eneheuvel,26-09-11
200806RM00216,2008,06RM00,216,3,6,9,eneheuvel,26-09-11
200806RM00302,2008,06RM00,302,5,4,9,eneheuvel,26-09-11
200806RM00303,2008,06RM00,303,3,2,5,eneheuvel,26-09-11
200806RM00304,2008,06RM00,304,1,1,2,eneheuvel,26-09-11
200806RM00305,2008,06RM00,305,1,0,1,eneheuvel,26-09-11
200806RM00306,2008,06RM00,306,1,1,2,eneheuvel,26-09-11
200806RM00307,2008,06RM00,307,1,0,1,eneheuvel,26-09-11
200806RM00308,2008,06RM00,308,1,0,1,eneheuvel,26-09-11
200806RM00309,2008,06RM00,309,0,4,4,eneheuvel,26-09-11
200806RM00311,2008,06RM00,311,6,1,7,eneheuvel,26-09-11
200806RM00312,2008,06RM00,312,4,2,6,eneheuvel,26-09-11
200806RM00402,2008,06RM00,402,0,1,1,eneheuvel,26-09-11
200806RM00502,2008,06RM00,502,0,6,6,eneheuvel,26-09-11
200806RM009999,2008,06RM00,9999,11,10,21,eneheuvel,26-09-11
200812HU00103,2008,12HU00,103,1,2,3,eneheuvel,26-09-11
200812HU00201,2008,12HU00,201,5,3,8,eneheuvel,26-09-11
200812HU00202,2008,12HU00,202,2,0,2,eneheuvel,26-09-11
200812HU00207,2008,12HU00,207,1,0,1,eneheuvel,26-09-11
200812HU00208,2008,12HU00,208,0,1,1,eneheuvel,26-09-11
200812HU00209,2008,12HU00,209,4,0,4,eneheuvel,26-09-11
200812HU00210,2008,12HU00,210,2,2,4,eneheuvel,26-09-11
200812HU00211,2008,12HU00,211,53,47,100,eneheuvel,26-09-11
200812HU00212,2008,12HU00,212,0,1,1,eneheuvel,26-09-11
200812PM00101,2008,12PM00,101,9,5,14,eneheuvel,26-09-11
200812PM00102,2008,12PM00,102,11,3,14,eneheuvel,26-09-11
200812PM00103,2008,12PM00,103,38,37,75,eneheuvel,26-09-11
200812PM00104,2008,12PM00,104,4,5,9,eneheuvel,26-09-11
200812PM00106,2008,12PM00,106,4,3,7,eneheuvel,26-09-11
200812PM00107,2008,12PM00,107,25,17,42,eneheuvel,26-09-11
200812PM00108,2008,12PM00,108,16,16,32,eneheuvel,26-09-11
200812PM00109,2008,12PM00,109,9,10,19,eneheuvel,26-09-11
200812PM00202,2008,12PM00,202,2,2,4,eneheuvel,26-09-11
200812PM00211,2008,12PM00,211,1,1,2,eneheuvel,26-09-11
200812PM00212,2008,12PM00,212,0,2,2,eneheuvel,26-09-11
200812PM00216,2008,12PM00,216,0,2,2,eneheuvel,26-09-11
200812PM00303,2008,12PM00,303,1,1,2,eneheuvel,26-09-11
200812PM00306,2008,12PM00,306,1,1,2,eneheuvel,26-09-11
200812PM00311,2008,12PM00,311,2,0,2,eneheuvel,26-09-11
200812PM009999,2008,12PM00,9999,2,0,2,eneheuvel,26-09-11
200812QK00201,2008,12QK00,201,1,0,1,eneheuvel,26-09-11
200812QK00202,2008,12QK00,202,1,1,2,eneheuvel,26-09-11
200812QK00203,2008,12QK00,203,1,0,1,eneheuvel,26-09-11
200812QK00205,2008,12QK00,205,0,1,1,eneheuvel,26-09-11
200812QK00206,2008,12QK00,206,111,99,210,eneheuvel,26-09-11
200812QK00207,2008,12QK00,207,0,2,2,eneheuvel,26-09-11
200812QK00208,2008,12QK00,208,2,3,5,eneheuvel,26-09-11
200812QK00209,2008,12QK00,209,5,4,9,eneheuvel,26-09-11
200812QK00210,2008,12QK00,210,8,10,18,eneheuvel,26-09-11
200812QK00211,2008,12QK00,211,0,2,2,eneheuvel,26-09-11
200812QK00212,2008,12QK00,212,1,1,2,eneheuvel,26-09-11
200812QK00213,2008,12QK00,213,0,1,1,eneheuvel,26-09-11
200812QK00215,2008,12QK00,215,1,5,6,eneheuvel,26-09-11
200812QK00302,2008,12QK00,302,1,1,2,eneheuvel,26-09-11
200812QK00307,2008,12QK00,307,0,1,1,eneheuvel,26-09-11
200812QK00312,2008,12QK00,312,0,2,2,eneheuvel,26-09-11
200812QK009999,2008,12QK00,9999,1,0,1,eneheuvel,26-09-11
200812XA00201,2008,12XA00,201,0,1,1,eneheuvel,26-09-11
200812XA00208,2008,12XA00,208,0,1,1,eneheuvel,26-09-11
200812XA00211,2008,12XA00,211,61,52,113,eneheuvel,26-09-11
200812XA00213,2008,12XA00,213,0,2,2,eneheuvel,26-09-11
200812XA00303,2008,12XA00,303,2,0,2,eneheuvel,26-09-11
200813CW00102,2008,13CW00,102,0,1,1,eneheuvel,26-09-11
200813CW00201,2008,13CW00,201,2,2,4,eneheuvel,26-09-11
200813CW00203,2008,13CW00,203,0,2,2,eneheuvel,26-09-11
200813CW00205,2008,13CW00,205,1,2,3,eneheuvel,26-09-11
200813CW00206,2008,13CW00,206,67,62,129,eneheuvel,26-09-11
200813CW00207,2008,13CW00,207,2,2,4,eneheuvel,26-09-11
200813CW00208,2008,13CW00,208,1,1,2,eneheuvel,26-09-11
200813CW00209,2008,13CW00,209,19,4,23,eneheuvel,26-09-11
200813CW00210,2008,13CW00,210,7,7,14,eneheuvel,26-09-11
200813CW00212,2008,13CW00,212,2,0,2,eneheuvel,26-09-11
200813CW00214,2008,13CW00,214,1,0,1,eneheuvel,26-09-11
200813CW00215,2008,13CW00,215,0,2,2,eneheuvel,26-09-11
200813CW00216,2008,13CW00,216,1,0,1,eneheuvel,26-09-11
200813CW00305,2008,13CW00,305,1,0,1,eneheuvel,26-09-11
200813CW00308,2008,13CW00,308,2,0,2,eneheuvel,26-09-11
200813CW009999,2008,13CW00,9999,1,0,1,eneheuvel,26-09-11
200813IF00105,2008,13IF00,105,0,1,1,eneheuvel,26-09-11
200813IF00207,2008,13IF00,207,1,0,1,eneheuvel,26-09-11
200813IF00208,2008,13IF00,208,1,1,2,eneheuvel,26-09-11
200813IF00214,2008,13IF00,214,0,2,2,eneheuvel,26-09-11
200813IF00301,2008,13IF00,301,9,7,16,eneheuvel,26-09-11
200813IF00302,2008,13IF00,302,1,3,4,eneheuvel,26-09-11
200813IF00303,2008,13IF00,303,5,19,24,eneheuvel,26-09-11
200813IF00304,2008,13IF00,304,32,32,64,eneheuvel,26-09-11
200813IF00305,2008,13IF00,305,5,9,14,eneheuvel,26-09-11
200813IF00306,2008,13IF00,306,7,22,29,eneheuvel,26-09-11
200813IF00307,2008,13IF00,307,3,5,8,eneheuvel,26-09-11
200813IF00308,2008,13IF00,308,3,3,6,eneheuvel,26-09-11
200813IF00309,2008,13IF00,309,1,2,3,eneheuvel,26-09-11
200813IF00310,2008,13IF00,310,1,0,1,eneheuvel,26-09-11
200813IF00311,2008,13IF00,311,0,1,1,eneheuvel,26-09-11
200813IF009999,2008,13IF00,9999,1,0,1,eneheuvel,26-09-11
200813IU00101,2008,13IU00,101,1,1,2,eneheuvel,26-09-11
200813IU00102,2008,13IU00,102,12,5,17,eneheuvel,26-09-11
200813IU00103,2008,13IU00,103,8,5,13,eneheuvel,26-09-11
200813IU00104,2008,13IU00,104,4,1,5,eneheuvel,26-09-11
200813IU00105,2008,13IU00,105,3,6,9,eneheuvel,26-09-11
200813IU00106,2008,13IU00,106,52,40,92,eneheuvel,26-09-11
200813IU00107,2008,13IU00,107,5,2,7,eneheuvel,26-09-11
200813IU00108,2008,13IU00,108,2,2,4,eneheuvel,26-09-11
200813IU00109,2008,13IU00,109,2,3,5,eneheuvel,26-09-11
200813IU00211,2008,13IU00,211,0,1,1,eneheuvel,26-09-11
200813IU00212,2008,13IU00,212,1,1,2,eneheuvel,26-09-11
200813IU00311,2008,13IU00,311,1,0,1,eneheuvel,26-09-11
200813IU009999,2008,13IU00,9999,1,0,1,eneheuvel,26-09-11
200813NH00101,2008,13NH00,101,3,3,6,eneheuvel,26-09-11
200813NH00102,2008,13NH00,102,10,7,17,eneheuvel,26-09-11
200813NH00103,2008,13NH00,103,2,1,3,eneheuvel,26-09-11
200813NH00104,2008,13NH00,104,18,26,44,eneheuvel,26-09-11
200813NH00105,2008,13NH00,105,64,62,126,eneheuvel,26-09-11
200813NH00106,2008,13NH00,106,7,10,17,eneheuvel,26-09-11
200813NH00107,2008,13NH00,107,1,2,3,eneheuvel,26-09-11
200813NH00109,2008,13NH00,109,2,1,3,eneheuvel,26-09-11
200813NH00110,2008,13NH00,110,6,5,11,eneheuvel,26-09-11
200813NH00203,2008,13NH00,203,1,0,1,eneheuvel,26-09-11
200813NH00208,2008,13NH00,208,0,1,1,eneheuvel,26-09-11
200813NH00213,2008,13NH00,213,1,0,1,eneheuvel,26-09-11
200813NH00214,2008,13NH00,214,1,0,1,eneheuvel,26-09-11
200813NH00308,2008,13NH00,308,1,0,1,eneheuvel,26-09-11
200813NH00502,2008,13NH00,502,0,1,1,eneheuvel,26-09-11
200813NH009999,2008,13NH00,9999,0,1,1,eneheuvel,26-09-11
200813NU00206,2008,13NU00,206,1,0,1,eneheuvel,26-09-11
200813NU00207,2008,13NU00,207,0,1,1,eneheuvel,26-09-11
200813NU00208,2008,13NU00,208,0,3,3,eneheuvel,26-09-11
200813NU00211,2008,13NU00,211,0,1,1,eneheuvel,26-09-11
200813NU00301,2008,13NU00,301,9,7,16,eneheuvel,26-09-11
200813NU00302,2008,13NU00,302,1,0,1,eneheuvel,26-09-11
200813NU00303,2008,13NU00,303,40,42,82,eneheuvel,26-09-11
200813NU00304,2008,13NU00,304,69,53,122,eneheuvel,26-09-11
200813NU00305,2008,13NU00,305,18,18,36,eneheuvel,26-09-11
200813NU00306,2008,13NU00,306,12,22,34,eneheuvel,26-09-11
200813NU00307,2008,13NU00,307,2,2,4,eneheuvel,26-09-11
200813NU00308,2008,13NU00,308,3,6,9,eneheuvel,26-09-11
200813NU00309,2008,13NU00,309,1,1,2,eneheuvel,26-09-11
200813NU00310,2008,13NU00,310,1,0,1,eneheuvel,26-09-11
200813NU00311,2008,13NU00,311,0,1,1,eneheuvel,26-09-11
200813NU00312,2008,13NU00,312,1,1,2,eneheuvel,26-09-11
200813NU009999,2008,13NU00,9999,2,1,3,eneheuvel,26-09-11
200814QC00109,2008,14QC00,109,1,3,4,eneheuvel,26-09-11
200814QC00110,2008,14QC00,110,1,0,1,eneheuvel,26-09-11
200814QC00201,2008,14QC00,201,4,0,4,eneheuvel,26-09-11
200814QC00202,2008,14QC00,202,52,54,106,eneheuvel,26-09-11
200814QC00203,2008,14QC00,203,42,41,83,eneheuvel,26-09-11
200814QC00204,2008,14QC00,204,32,24,56,eneheuvel,26-09-11
200814QC00205,2008,14QC00,205,23,17,40,eneheuvel,26-09-11
200814QC00206,2008,14QC00,206,21,9,30,eneheuvel,26-09-11
200814QC00207,2008,14QC00,207,13,5,18,eneheuvel,26-09-11
200814QC00208,2008,14QC00,208,23,21,44,eneheuvel,26-09-11
200814QC00209,2008,14QC00,209,3,0,3,eneheuvel,26-09-11
200814QC00210,2008,14QC00,210,7,7,14,eneheuvel,26-09-11
200814QC00211,2008,14QC00,211,7,4,11,eneheuvel,26-09-11
200814QC00212,2008,14QC00,212,3,5,8,eneheuvel,26-09-11
200814QC00213,2008,14QC00,213,4,3,7,eneheuvel,26-09-11
200814QC00214,2008,14QC00,214,2,4,6,eneheuvel,26-09-11
200814QC00215,2008,14QC00,215,2,2,4,eneheuvel,26-09-11
200814QC00216,2008,14QC00,216,4,1,5,eneheuvel,26-09-11
200814QC00302,2008,14QC00,302,4,3,7,eneheuvel,26-09-11
200814QC00303,2008,14QC00,303,12,1,13,eneheuvel,26-09-11
200814QC00304,2008,14QC00,304,2,3,5,eneheuvel,26-09-11
200814QC00306,2008,14QC00,306,4,1,5,eneheuvel,26-09-11
200814QC00307,2008,14QC00,307,2,1,3,eneheuvel,26-09-11
200814QC00309,2008,14QC00,309,0,1,1,eneheuvel,26-09-11
200814QC00311,2008,14QC00,311,9,3,12,eneheuvel,26-09-11
200814QC00312,2008,14QC00,312,5,2,7,eneheuvel,26-09-11
200814QC00313,2008,14QC00,313,0,1,1,eneheuvel,26-09-11
200814QC00502,2008,14QC00,502,15,12,27,eneheuvel,26-09-11
200814QC009999,2008,14QC00,9999,3,0,3,eneheuvel,26-09-11
200815SJ00101,2008,15SJ00,101,1,1,2,eneheuvel,26-09-11
200815SJ00102,2008,15SJ00,102,1,3,4,eneheuvel,26-09-11
200815SJ00103,2008,15SJ00,103,1,6,7,eneheuvel,26-09-11
200815SJ00104,2008,15SJ00,104,0,3,3,eneheuvel,26-09-11
200815SJ00106,2008,15SJ00,106,0,5,5,eneheuvel,26-09-11
200815SJ00108,2008,15SJ00,108,0,4,4,eneheuvel,26-09-11
200815SJ00201,2008,15SJ00,201,2,5,7,eneheuvel,26-09-11
200815SJ00202,2008,15SJ00,202,2,7,9,eneheuvel,26-09-11
200815SJ00203,2008,15SJ00,203,3,7,10,eneheuvel,26-09-11
200815SJ00204,2008,15SJ00,204,0,8,8,eneheuvel,26-09-11
200815SJ00205,2008,15SJ00,205,1,5,6,eneheuvel,26-09-11
200815SJ00206,2008,15SJ00,206,2,18,20,eneheuvel,26-09-11
200815SJ00207,2008,15SJ00,207,3,13,16,eneheuvel,26-09-11
200815SJ00208,2008,15SJ00,208,2,9,11,eneheuvel,26-09-11
200815SJ00209,2008,15SJ00,209,4,7,11,eneheuvel,26-09-11
200815SJ00210,2008,15SJ00,210,7,20,27,eneheuvel,26-09-11
200815SJ00211,2008,15SJ00,211,6,20,26,eneheuvel,26-09-11
200815SJ00212,2008,15SJ00,212,1,17,18,eneheuvel,26-09-11
200815SJ00213,2008,15SJ00,213,2,7,9,eneheuvel,26-09-11
200815SJ00214,2008,15SJ00,214,3,7,10,eneheuvel,26-09-11
200815SJ00216,2008,15SJ00,216,0,1,1,eneheuvel,26-09-11
200815SJ00301,2008,15SJ00,301,2,5,7,eneheuvel,26-09-11
200815SJ00302,2008,15SJ00,302,3,6,9,eneheuvel,26-09-11
200815SJ00303,2008,15SJ00,303,2,6,8,eneheuvel,26-09-11
200815SJ00304,2008,15SJ00,304,1,6,7,eneheuvel,26-09-11
200815SJ00305,2008,15SJ00,305,1,6,7,eneheuvel,26-09-11
200815SJ00306,2008,15SJ00,306,3,7,10,eneheuvel,26-09-11
200815SJ00307,2008,15SJ00,307,3,4,7,eneheuvel,26-09-11
200815SJ00308,2008,15SJ00,308,2,7,9,eneheuvel,26-09-11
200815SJ00309,2008,15SJ00,309,4,6,10,eneheuvel,26-09-11
200815SJ00311,2008,15SJ00,311,4,2,6,eneheuvel,26-09-11
200815SJ00312,2008,15SJ00,312,1,3,4,eneheuvel,26-09-11
200815SJ00313,2008,15SJ00,313,0,1,1,eneheuvel,26-09-11
200815SJ009999,2008,15SJ00,9999,0,2,2,eneheuvel,26-09-11
200815ZL00203,2008,15ZL00,203,1,0,1,eneheuvel,26-09-11
200815ZL00204,2008,15ZL00,204,1,2,3,eneheuvel,26-09-11
200815ZL00205,2008,15ZL00,205,1,1,2,eneheuvel,26-09-11
200815ZL00206,2008,15ZL00,206,3,1,4,eneheuvel,26-09-11
200815ZL00208,2008,15ZL00,208,1,0,1,eneheuvel,26-09-11
200815ZL00210,2008,15ZL00,210,0,1,1,eneheuvel,26-09-11
200815ZL00214,2008,15ZL00,214,1,1,2,eneheuvel,26-09-11
200815ZL00216,2008,15ZL00,216,1,1,2,eneheuvel,26-09-11
200815ZL00302,2008,15ZL00,302,4,4,8,eneheuvel,26-09-11
200815ZL00303,2008,15ZL00,303,3,4,7,eneheuvel,26-09-11
200815ZL00304,2008,15ZL00,304,0,4,4,eneheuvel,26-09-11
200815ZL00305,2008,15ZL00,305,53,60,113,eneheuvel,26-09-11
200815ZL00306,2008,15ZL00,306,4,10,14,eneheuvel,26-09-11
200815ZL00307,2008,15ZL00,307,3,5,8,eneheuvel,26-09-11
200815ZL00308,2008,15ZL00,308,4,4,8,eneheuvel,26-09-11
200815ZL00309,2008,15ZL00,309,8,4,12,eneheuvel,26-09-11
200815ZL00311,2008,15ZL00,311,6,0,6,eneheuvel,26-09-11
200815ZL00312,2008,15ZL00,312,2,3,5,eneheuvel,26-09-11
200815ZL00313,2008,15ZL00,313,0,1,1,eneheuvel,26-09-11
200815ZL00502,2008,15ZL00,502,1,0,1,eneheuvel,26-09-11
200815ZL01109,2008,15ZL01,109,1,0,1,eneheuvel,26-09-11
200815ZL01206,2008,15ZL01,206,1,2,3,eneheuvel,26-09-11
200815ZL01207,2008,15ZL01,207,1,0,1,eneheuvel,26-09-11
200815ZL01209,2008,15ZL01,209,8,7,15,eneheuvel,26-09-11
200815ZL01210,2008,15ZL01,210,75,61,136,eneheuvel,26-09-11
200815ZL01211,2008,15ZL01,211,1,0,1,eneheuvel,26-09-11
200815ZL01212,2008,15ZL01,212,2,1,3,eneheuvel,26-09-11
200815ZL01214,2008,15ZL01,214,0,1,1,eneheuvel,26-09-11
200815ZL01215,2008,15ZL01,215,2,3,5,eneheuvel,26-09-11
200815ZL01216,2008,15ZL01,216,1,3,4,eneheuvel,26-09-11
200815ZL01306,2008,15ZL01,306,0,1,1,eneheuvel,26-09-11
200815ZL01307,2008,15ZL01,307,0,1,1,eneheuvel,26-09-11
200815ZL01308,2008,15ZL01,308,0,1,1,eneheuvel,26-09-11
200815ZL019999,2008,15ZL01,9999,2,2,4,eneheuvel,26-09-11
200816KK00101,2008,16KK00,101,17,11,28,eneheuvel,26-09-11
200816KK00102,2008,16KK00,102,40,39,79,eneheuvel,26-09-11
200816KK00103,2008,16KK00,103,62,59,121,eneheuvel,26-09-11
200816KK00104,2008,16KK00,104,3,0,3,eneheuvel,26-09-11
200816KK00105,2008,16KK00,105,1,2,3,eneheuvel,26-09-11
200816KK00106,2008,16KK00,106,5,6,11,eneheuvel,26-09-11
200816KK00107,2008,16KK00,107,18,8,26,eneheuvel,26-09-11
200816KK00108,2008,16KK00,108,21,28,49,eneheuvel,26-09-11
200816KK00109,2008,16KK00,109,14,10,24,eneheuvel,26-09-11
200816KK00110,2008,16KK00,110,1,0,1,eneheuvel,26-09-11
200816KK00202,2008,16KK00,202,3,0,3,eneheuvel,26-09-11
200816KK00203,2008,16KK00,203,0,1,1,eneheuvel,26-09-11
200816KK00204,2008,16KK00,204,0,1,1,eneheuvel,26-09-11
200816KK00206,2008,16KK00,206,0,1,1,eneheuvel,26-09-11
200816KK00207,2008,16KK00,207,1,3,4,eneheuvel,26-09-11
200816KK00208,2008,16KK00,208,1,0,1,eneheuvel,26-09-11
200816KK00209,2008,16KK00,209,0,1,1,eneheuvel,26-09-11
200816KK00210,2008,16KK00,210,0,1,1,eneheuvel,26-09-11
200816KK00211,2008,16KK00,211,3,2,5,eneheuvel,26-09-11
200816KK00212,2008,16KK00,212,0,1,1,eneheuvel,26-09-11
200816KK00213,2008,16KK00,213,1,1,2,eneheuvel,26-09-11
200816KK00214,2008,16KK00,214,0,3,3,eneheuvel,26-09-11
200816KK00216,2008,16KK00,216,0,1,1,eneheuvel,26-09-11
200816KK00302,2008,16KK00,302,1,0,1,eneheuvel,26-09-11
200816KK00303,2008,16KK00,303,1,0,1,eneheuvel,26-09-11
200816KK00309,2008,16KK00,309,3,1,4,eneheuvel,26-09-11
200816KK00311,2008,16KK00,311,1,2,3,eneheuvel,26-09-11
200816KK00502,2008,16KK00,502,3,1,4,eneheuvel,26-09-11
200816KK009999,2008,16KK00,9999,2,1,3,eneheuvel,26-09-11
200816LJ00101,2008,16LJ00,101,3,2,5,eneheuvel,26-09-11
200816LJ00102,2008,16LJ00,102,5,4,9,eneheuvel,26-09-11
200816LJ00103,2008,16LJ00,103,1,0,1,eneheuvel,26-09-11
200816LJ00104,2008,16LJ00,104,2,0,2,eneheuvel,26-09-11
200816LJ00105,2008,16LJ00,105,0,2,2,eneheuvel,26-09-11
200816LJ00106,2008,16LJ00,106,47,46,93,eneheuvel,26-09-11
200816LJ00107,2008,16LJ00,107,1,8,9,eneheuvel,26-09-11
200816LJ00108,2008,16LJ00,108,1,5,6,eneheuvel,26-09-11
200816LJ00109,2008,16LJ00,109,0,2,2,eneheuvel,26-09-11
200816LJ00201,2008,16LJ00,201,0,1,1,eneheuvel,26-09-11
200816LJ00203,2008,16LJ00,203,3,2,5,eneheuvel,26-09-11
200816LJ00204,2008,16LJ00,204,0,1,1,eneheuvel,26-09-11
200816LJ00208,2008,16LJ00,208,1,0,1,eneheuvel,26-09-11
200816LJ00210,2008,16LJ00,210,0,1,1,eneheuvel,26-09-11
200816LJ00212,2008,16LJ00,212,0,2,2,eneheuvel,26-09-11
200816LJ00213,2008,16LJ00,213,0,1,1,eneheuvel,26-09-11
200816LJ00214,2008,16LJ00,214,0,1,1,eneheuvel,26-09-11
200816LJ00303,2008,16LJ00,303,0,1,1,eneheuvel,26-09-11
200816LJ00304,2008,16LJ00,304,0,1,1,eneheuvel,26-09-11
200816LJ00306,2008,16LJ00,306,1,0,1,eneheuvel,26-09-11
200816LJ00308,2008,16LJ00,308,0,1,1,eneheuvel,26-09-11
200816LJ00311,2008,16LJ00,311,0,1,1,eneheuvel,26-09-11
200816LJ009999,2008,16LJ00,9999,0,2,2,eneheuvel,26-09-11
200816ML00101,2008,16ML00,101,4,9,13,eneheuvel,26-09-11
200816ML00102,2008,16ML00,102,33,27,60,eneheuvel,26-09-11
200816ML00103,2008,16ML00,103,4,2,6,eneheuvel,26-09-11
200816ML00104,2008,16ML00,104,55,59,114,eneheuvel,26-09-11
200816ML00105,2008,16ML00,105,26,30,56,eneheuvel,26-09-11
200816ML00106,2008,16ML00,106,3,4,7,eneheuvel,26-09-11
200816ML00107,2008,16ML00,107,2,4,6,eneheuvel,26-09-11
200816ML00108,2008,16ML00,108,0,6,6,eneheuvel,26-09-11
200816ML00109,2008,16ML00,109,4,5,9,eneheuvel,26-09-11
200816ML00110,2008,16ML00,110,2,5,7,eneheuvel,26-09-11
200816ML00201,2008,16ML00,201,0,1,1,eneheuvel,26-09-11
200816ML00202,2008,16ML00,202,1,0,1,eneheuvel,26-09-11
200816ML00203,2008,16ML00,203,1,2,3,eneheuvel,26-09-11
200816ML00205,2008,16ML00,205,1,3,4,eneheuvel,26-09-11
200816ML00209,2008,16ML00,209,0,1,1,eneheuvel,26-09-11
200816ML00210,2008,16ML00,210,0,2,2,eneheuvel,26-09-11
200816ML00211,2008,16ML00,211,1,0,1,eneheuvel,26-09-11
200816ML00212,2008,16ML00,212,1,2,3,eneheuvel,26-09-11
200816ML00213,2008,16ML00,213,0,1,1,eneheuvel,26-09-11
200816ML00214,2008,16ML00,214,0,2,2,eneheuvel,26-09-11
200816ML00303,2008,16ML00,303,1,2,3,eneheuvel,26-09-11
200816ML00306,2008,16ML00,306,1,2,3,eneheuvel,26-09-11
200816ML00308,2008,16ML00,308,1,0,1,eneheuvel,26-09-11
200816ML00311,2008,16ML00,311,1,0,1,eneheuvel,26-09-11
200816ML00312,2008,16ML00,312,0,2,2,eneheuvel,26-09-11
200816ML00502,2008,16ML00,502,3,1,4,eneheuvel,26-09-11
200816ML009999,2008,16ML00,9999,1,0,1,eneheuvel,26-09-11
200816OC00101,2008,16OC00,101,1,2,3,eneheuvel,26-09-11
200816OC00102,2008,16OC00,102,0,4,4,eneheuvel,26-09-11
200816OC00103,2008,16OC00,103,4,10,14,eneheuvel,26-09-11
200816OC00104,2008,16OC00,104,0,1,1,eneheuvel,26-09-11
200816OC00105,2008,16OC00,105,0,1,1,eneheuvel,26-09-11
200816OC00106,2008,16OC00,106,0,1,1,eneheuvel,26-09-11
200816OC00107,2008,16OC00,107,67,81,148,eneheuvel,26-09-11
200816OC00108,2008,16OC00,108,13,22,35,eneheuvel,26-09-11
200816OC00109,2008,16OC00,109,44,51,95,eneheuvel,26-09-11
200816OC00201,2008,16OC00,201,4,2,6,eneheuvel,26-09-11
200816OC00202,2008,16OC00,202,6,1,7,eneheuvel,26-09-11
200816OC00204,2008,16OC00,204,0,1,1,eneheuvel,26-09-11
200816OC00206,2008,16OC00,206,0,4,4,eneheuvel,26-09-11
200816OC00207,2008,16OC00,207,3,0,3,eneheuvel,26-09-11
200816OC00208,2008,16OC00,208,0,5,5,eneheuvel,26-09-11
200816OC00209,2008,16OC00,209,0,1,1,eneheuvel,26-09-11
200816OC00210,2008,16OC00,210,2,3,5,eneheuvel,26-09-11
200816OC00211,2008,16OC00,211,0,2,2,eneheuvel,26-09-11
200816OC00212,2008,16OC00,212,1,0,1,eneheuvel,26-09-11
200816OC00213,2008,16OC00,213,0,3,3,eneheuvel,26-09-11
200816OC00214,2008,16OC00,214,2,6,8,eneheuvel,26-09-11
200816OC00216,2008,16OC00,216,1,1,2,eneheuvel,26-09-11
200816OC00301,2008,16OC00,301,1,0,1,eneheuvel,26-09-11
200816OC00302,2008,16OC00,302,3,1,4,eneheuvel,26-09-11
200816OC00303,2008,16OC00,303,1,4,5,eneheuvel,26-09-11
200816OC00304,2008,16OC00,304,3,0,3,eneheuvel,26-09-11
200816OC00306,2008,16OC00,306,1,0,1,eneheuvel,26-09-11
200816OC00308,2008,16OC00,308,1,0,1,eneheuvel,26-09-11
200816OC00309,2008,16OC00,309,5,0,5,eneheuvel,26-09-11
200816OC00311,2008,16OC00,311,0,1,1,eneheuvel,26-09-11
200816OC00313,2008,16OC00,313,1,1,2,eneheuvel,26-09-11
200816OC00502,2008,16OC00,502,1,0,1,eneheuvel,26-09-11
200816OC009999,2008,16OC00,9999,2,0,2,eneheuvel,26-09-11
200816UK00103,2008,16UK00,103,6,11,17,eneheuvel,26-09-11
200816UK00107,2008,16UK00,107,1,1,2,eneheuvel,26-09-11
200816UK00108,2008,16UK00,108,72,80,152,eneheuvel,26-09-11
200816UK00109,2008,16UK00,109,0,1,1,eneheuvel,26-09-11
200816UK00201,2008,16UK00,201,0,1,1,eneheuvel,26-09-11
200816UK00212,2008,16UK00,212,0,1,1,eneheuvel,26-09-11
200816WV00201,2008,16WV00,201,5,0,5,eneheuvel,26-09-11
200816WV00202,2008,16WV00,202,1,0,1,eneheuvel,26-09-11
200816WV00209,2008,16WV00,209,17,9,26,eneheuvel,26-09-11
200816WV00210,2008,16WV00,210,0,1,1,eneheuvel,26-09-11
200816WV00211,2008,16WV00,211,64,51,115,eneheuvel,26-09-11
200816WV00214,2008,16WV00,214,2,1,3,eneheuvel,26-09-11
200816WV00216,2008,16WV00,216,0,1,1,eneheuvel,26-09-11
200816WV00306,2008,16WV00,306,0,1,1,eneheuvel,26-09-11
200816WV009999,2008,16WV00,9999,1,1,2,eneheuvel,26-09-11
200816YS00201,2008,16YS00,201,11,6,17,eneheuvel,26-09-11
200816YS00203,2008,16YS00,203,1,0,1,eneheuvel,26-09-11
200816YS00206,2008,16YS00,206,0,1,1,eneheuvel,26-09-11
200816YS00208,2008,16YS00,208,0,1,1,eneheuvel,26-09-11
200816YS00209,2008,16YS00,209,2,1,3,eneheuvel,26-09-11
200816YS00210,2008,16YS00,210,1,0,1,eneheuvel,26-09-11
200816YS00211,2008,16YS00,211,89,73,162,eneheuvel,26-09-11
200816YS00212,2008,16YS00,212,1,0,1,eneheuvel,26-09-11
200816YS00213,2008,16YS00,213,2,0,2,eneheuvel,26-09-11
200816YS00309,2008,16YS00,309,0,1,1,eneheuvel,26-09-11
200816YS00312,2008,16YS00,312,1,0,1,eneheuvel,26-09-11
200816ZG00108,2008,16ZG00,108,1,0,1,eneheuvel,26-09-11
200816ZG00201,2008,16ZG00,201,0,1,1,eneheuvel,26-09-11
200816ZG00202,2008,16ZG00,202,2,0,2,eneheuvel,26-09-11
200816ZG00203,2008,16ZG00,203,0,1,1,eneheuvel,26-09-11
200816ZG00211,2008,16ZG00,211,84,60,144,eneheuvel,26-09-11
200816ZG00212,2008,16ZG00,212,1,1,2,eneheuvel,26-09-11
200816ZG00213,2008,16ZG00,213,0,2,2,eneheuvel,26-09-11
200816ZG00214,2008,16ZG00,214,0,2,2,eneheuvel,26-09-11
200816ZG00301,2008,16ZG00,301,1,0,1,eneheuvel,26-09-11
200816ZG00309,2008,16ZG00,309,0,1,1,eneheuvel,26-09-11
200816ZG00312,2008,16ZG00,312,0,1,1,eneheuvel,26-09-11
200816ZG009999,2008,16ZG00,9999,2,1,3,eneheuvel,26-09-11
200816ZX00201,2008,16ZX00,201,1,2,3,eneheuvel,26-09-11
200816ZX00206,2008,16ZX00,206,13,25,38,eneheuvel,26-09-11
200816ZX00207,2008,16ZX00,207,0,1,1,eneheuvel,26-09-11
200816ZX00209,2008,16ZX00,209,37,31,68,eneheuvel,26-09-11
200816ZX00210,2008,16ZX00,210,1,1,2,eneheuvel,26-09-11
200816ZX00211,2008,16ZX00,211,0,1,1,eneheuvel,26-09-11
200816ZX00305,2008,16ZX00,305,0,1,1,eneheuvel,26-09-11
200816ZX00308,2008,16ZX00,308,1,0,1,eneheuvel,26-09-11
200816ZX00311,2008,16ZX00,311,0,1,1,eneheuvel,26-09-11
200816ZX009999,2008,16ZX00,9999,1,1,2,eneheuvel,26-09-11
200817AK00202,2008,17AK00,202,1,0,1,eneheuvel,26-09-11
200817AK00204,2008,17AK00,204,1,1,2,eneheuvel,26-09-11
200817AK00205,2008,17AK00,205,1,0,1,eneheuvel,26-09-11
200817AK00206,2008,17AK00,206,54,58,112,eneheuvel,26-09-11
200817AK00207,2008,17AK00,207,0,2,2,eneheuvel,26-09-11
200817AK00209,2008,17AK00,209,4,1,5,eneheuvel,26-09-11
200817AK00210,2008,17AK00,210,1,5,6,eneheuvel,26-09-11
200817AK00211,2008,17AK00,211,0,1,1,eneheuvel,26-09-11
200817AK00303,2008,17AK00,303,1,0,1,eneheuvel,26-09-11
200817AK00304,2008,17AK00,304,2,0,2,eneheuvel,26-09-11
200817AK00305,2008,17AK00,305,1,4,5,eneheuvel,26-09-11
200817AK00306,2008,17AK00,306,1,0,1,eneheuvel,26-09-11
200817AK00307,2008,17AK00,307,0,1,1,eneheuvel,26-09-11
200817AK00309,2008,17AK00,309,0,1,1,eneheuvel,26-09-11
200817AK009999,2008,17AK00,9999,1,1,2,eneheuvel,26-09-11
200817AV00202,2008,17AV00,202,0,1,1,eneheuvel,26-09-11
200817AV00204,2008,17AV00,204,1,2,3,eneheuvel,26-09-11
200817AV00205,2008,17AV00,205,1,0,1,eneheuvel,26-09-11
200817AV00206,2008,17AV00,206,66,84,150,eneheuvel,26-09-11
200817AV00207,2008,17AV00,207,1,0,1,eneheuvel,26-09-11
200817AV00208,2008,17AV00,208,1,1,2,eneheuvel,26-09-11
200817AV00209,2008,17AV00,209,3,0,3,eneheuvel,26-09-11
200817AV00210,2008,17AV00,210,1,0,1,eneheuvel,26-09-11
200817AV00211,2008,17AV00,211,1,0,1,eneheuvel,26-09-11
200817AV00214,2008,17AV00,214,1,1,2,eneheuvel,26-09-11
200817AV00215,2008,17AV00,215,1,0,1,eneheuvel,26-09-11
200817AV009999,2008,17AV00,9999,0,2,2,eneheuvel,26-09-11
200817BP00108,2008,17BP00,108,0,1,1,eneheuvel,26-09-11
200817BP00201,2008,17BP00,201,0,1,1,eneheuvel,26-09-11
200817BP00208,2008,17BP00,208,1,1,2,eneheuvel,26-09-11
200817BP00209,2008,17BP00,209,1,0,1,eneheuvel,26-09-11
200817BP00210,2008,17BP00,210,2,1,3,eneheuvel,26-09-11
200817BP00211,2008,17BP00,211,53,57,110,eneheuvel,26-09-11
200817BP00212,2008,17BP00,212,4,6,10,eneheuvel,26-09-11
200817BP00213,2008,17BP00,213,66,76,142,eneheuvel,26-09-11
200817BP00214,2008,17BP00,214,3,1,4,eneheuvel,26-09-11
200817BP00309,2008,17BP00,309,0,1,1,eneheuvel,26-09-11
200817BP00312,2008,17BP00,312,0,1,1,eneheuvel,26-09-11
200817DA00102,2008,17DA00,102,0,1,1,eneheuvel,26-09-11
200817DA00209,2008,17DA00,209,9,7,16,eneheuvel,26-09-11
200817DA00210,2008,17DA00,210,47,49,96,eneheuvel,26-09-11
200817DA00211,2008,17DA00,211,1,1,2,eneheuvel,26-09-11
200817DA00302,2008,17DA00,302,0,3,3,eneheuvel,26-09-11
200817DA00303,2008,17DA00,303,0,1,1,eneheuvel,26-09-11
200817DA00307,2008,17DA00,307,0,2,2,eneheuvel,26-09-11
200817DK00202,2008,17DK00,202,1,1,2,eneheuvel,26-09-11
200817DK00203,2008,17DK00,203,0,1,1,eneheuvel,26-09-11
200817DK00206,2008,17DK00,206,0,1,1,eneheuvel,26-09-11
200817DK00207,2008,17DK00,207,2,0,2,eneheuvel,26-09-11
200817DK00301,2008,17DK00,301,3,5,8,eneheuvel,26-09-11
200817DK00302,2008,17DK00,302,1,2,3,eneheuvel,26-09-11
200817DK00303,2008,17DK00,303,0,2,2,eneheuvel,26-09-11
200817DK00304,2008,17DK00,304,31,42,73,eneheuvel,26-09-11
200817DK00305,2008,17DK00,305,1,3,4,eneheuvel,26-09-11
200817DK00306,2008,17DK00,306,0,1,1,eneheuvel,26-09-11
200817DK00308,2008,17DK00,308,3,0,3,eneheuvel,26-09-11
200817DK00309,2008,17DK00,309,3,1,4,eneheuvel,26-09-11
200817DV00106,2008,17DV00,106,0,1,1,eneheuvel,26-09-11
200817DV00108,2008,17DV00,108,0,1,1,eneheuvel,26-09-11
200817DV00202,2008,17DV00,202,0,1,1,eneheuvel,26-09-11
200817DV00203,2008,17DV00,203,0,1,1,eneheuvel,26-09-11
200817DV00204,2008,17DV00,204,1,3,4,eneheuvel,26-09-11
200817DV00206,2008,17DV00,206,0,2,2,eneheuvel,26-09-11
200817DV00207,2008,17DV00,207,2,0,2,eneheuvel,26-09-11
200817DV00211,2008,17DV00,211,1,0,1,eneheuvel,26-09-11
200817DV00212,2008,17DV00,212,0,1,1,eneheuvel,26-09-11
200817DV00214,2008,17DV00,214,0,1,1,eneheuvel,26-09-11
200817DV00216,2008,17DV00,216,1,1,2,eneheuvel,26-09-11
200817DV00301,2008,17DV00,301,20,5,25,eneheuvel,26-09-11
200817DV00302,2008,17DV00,302,2,6,8,eneheuvel,26-09-11
200817DV00303,2008,17DV00,303,33,26,59,eneheuvel,26-09-11
200817DV00304,2008,17DV00,304,39,41,80,eneheuvel,26-09-11
200817DV00305,2008,17DV00,305,9,4,13,eneheuvel,26-09-11
200817DV00306,2008,17DV00,306,12,6,18,eneheuvel,26-09-11
200817DV00307,2008,17DV00,307,6,12,18,eneheuvel,26-09-11
200817DV00308,2008,17DV00,308,10,13,23,eneheuvel,26-09-11
200817DV00309,2008,17DV00,309,13,18,31,eneheuvel,26-09-11
200817DV00310,2008,17DV00,310,0,2,2,eneheuvel,26-09-11
200817DV00311,2008,17DV00,311,6,4,10,eneheuvel,26-09-11
200817DV00312,2008,17DV00,312,0,2,2,eneheuvel,26-09-11
200817DV00502,2008,17DV00,502,1,1,2,eneheuvel,26-09-11
200817DV009999,2008,17DV00,9999,1,2,3,eneheuvel,26-09-11
200817FI00101,2008,17FI00,101,0,1,1,eneheuvel,26-09-11
200817FI00102,2008,17FI00,102,1,1,2,eneheuvel,26-09-11
200817FI00103,2008,17FI00,103,4,3,7,eneheuvel,26-09-11
200817FI00104,2008,17FI00,104,2,0,2,eneheuvel,26-09-11
200817FI00105,2008,17FI00,105,2,1,3,eneheuvel,26-09-11
200817FI00106,2008,17FI00,106,1,1,2,eneheuvel,26-09-11
200817FI00108,2008,17FI00,108,2,2,4,eneheuvel,26-09-11
200817FI00201,2008,17FI00,201,1,1,2,eneheuvel,26-09-11
200817FI00202,2008,17FI00,202,3,25,28,eneheuvel,26-09-11
200817FI00203,2008,17FI00,203,8,11,19,eneheuvel,26-09-11
200817FI00204,2008,17FI00,204,6,6,12,eneheuvel,26-09-11
200817FI00205,2008,17FI00,205,1,9,10,eneheuvel,26-09-11
200817FI00206,2008,17FI00,206,9,5,14,eneheuvel,26-09-11
200817FI00207,2008,17FI00,207,4,5,9,eneheuvel,26-09-11
200817FI00208,2008,17FI00,208,4,11,15,eneheuvel,26-09-11
200817FI00209,2008,17FI00,209,2,1,3,eneheuvel,26-09-11
200817FI00210,2008,17FI00,210,4,5,9,eneheuvel,26-09-11
200817FI00211,2008,17FI00,211,10,6,16,eneheuvel,26-09-11
200817FI00212,2008,17FI00,212,2,7,9,eneheuvel,26-09-11
200817FI00213,2008,17FI00,213,4,4,8,eneheuvel,26-09-11
200817FI00214,2008,17FI00,214,1,5,6,eneheuvel,26-09-11
200817FI00216,2008,17FI00,216,2,0,2,eneheuvel,26-09-11
200817FI00302,2008,17FI00,302,1,3,4,eneheuvel,26-09-11
200817FI00303,2008,17FI00,303,4,3,7,eneheuvel,26-09-11
200817FI00304,2008,17FI00,304,6,4,10,eneheuvel,26-09-11
200817FI00305,2008,17FI00,305,1,7,8,eneheuvel,26-09-11
200817FI00306,2008,17FI00,306,2,1,3,eneheuvel,26-09-11
200817FI00307,2008,17FI00,307,4,6,10,eneheuvel,26-09-11
200817FI00308,2008,17FI00,308,2,1,3,eneheuvel,26-09-11
200817FI00309,2008,17FI00,309,6,1,7,eneheuvel,26-09-11
200817FI00310,2008,17FI00,310,0,2,2,eneheuvel,26-09-11
200817FI00311,2008,17FI00,311,2,4,6,eneheuvel,26-09-11
200817FI00312,2008,17FI00,312,1,1,2,eneheuvel,26-09-11
200817FI00313,2008,17FI00,313,1,0,1,eneheuvel,26-09-11
200817FI00402,2008,17FI00,402,1,0,1,eneheuvel,26-09-11
200817FI00502,2008,17FI00,502,1,0,1,eneheuvel,26-09-11
200817FI009999,2008,17FI00,9999,0,1,1,eneheuvel,26-09-11
200817LP00209,2008,17LP00,209,0,2,2,eneheuvel,26-09-11
200817LP00211,2008,17LP00,211,0,1,1,eneheuvel,26-09-11
200817LP00301,2008,17LP00,301,1,0,1,eneheuvel,26-09-11
200817LP00302,2008,17LP00,302,2,0,2,eneheuvel,26-09-11
200817LP00305,2008,17LP00,305,54,46,100,eneheuvel,26-09-11
200817LP00306,2008,17LP00,306,7,3,10,eneheuvel,26-09-11
200817LP00308,2008,17LP00,308,1,1,2,eneheuvel,26-09-11
200817LP00309,2008,17LP00,309,3,1,4,eneheuvel,26-09-11
200817LP009999,2008,17LP00,9999,1,0,1,eneheuvel,26-09-11
200817MH00202,2008,17MH00,202,1,1,2,eneheuvel,26-09-11
200817MH00203,2008,17MH00,203,1,0,1,eneheuvel,26-09-11
200817MH00206,2008,17MH00,206,0,1,1,eneheuvel,26-09-11
200817MH00210,2008,17MH00,210,0,3,3,eneheuvel,26-09-11
200817MH00212,2008,17MH00,212,1,0,1,eneheuvel,26-09-11
200817MH00216,2008,17MH00,216,0,1,1,eneheuvel,26-09-11
200817MH00302,2008,17MH00,302,0,2,2,eneheuvel,26-09-11
200817MH00303,2008,17MH00,303,0,1,1,eneheuvel,26-09-11
200817MH00304,2008,17MH00,304,0,1,1,eneheuvel,26-09-11
200817MH00305,2008,17MH00,305,60,66,126,eneheuvel,26-09-11
200817MH00306,2008,17MH00,306,4,1,5,eneheuvel,26-09-11
200817MH00311,2008,17MH00,311,0,1,1,eneheuvel,26-09-11
200821KO00106,2008,21KO00,106,0,1,1,eneheuvel,26-09-11
200821KO00202,2008,21KO00,202,1,0,1,eneheuvel,26-09-11
200821KO00206,2008,21KO00,206,1,0,1,eneheuvel,26-09-11
200821KO00209,2008,21KO00,209,2,5,7,eneheuvel,26-09-11
200821KO00210,2008,21KO00,210,91,89,180,eneheuvel,26-09-11
200821KO00211,2008,21KO00,211,2,0,2,eneheuvel,26-09-11
200821KO00212,2008,21KO00,212,1,0,1,eneheuvel,26-09-11
200821KO00213,2008,21KO00,213,0,1,1,eneheuvel,26-09-11
200821KO00214,2008,21KO00,214,0,2,2,eneheuvel,26-09-11
200821KO00216,2008,21KO00,216,0,2,2,eneheuvel,26-09-11
200821KO00309,2008,21KO00,309,0,1,1,eneheuvel,26-09-11
200821KO009999,2008,21KO00,9999,0,2,2,eneheuvel,26-09-11
200821NC00103,2008,21NC00,103,0,1,1,eneheuvel,26-09-11
200821NC00104,2008,21NC00,104,1,0,1,eneheuvel,26-09-11
200821NC00110,2008,21NC00,110,2,0,2,eneheuvel,26-09-11
200821NC00208,2008,21NC00,208,0,1,1,eneheuvel,26-09-11
200821NC00211,2008,21NC00,211,7,0,7,eneheuvel,26-09-11
200821NC00212,2008,21NC00,212,5,6,11,eneheuvel,26-09-11
200821NC00213,2008,21NC00,213,54,58,112,eneheuvel,26-09-11
200821NC00214,2008,21NC00,214,5,6,11,eneheuvel,26-09-11
200821NC00303,2008,21NC00,303,1,0,1,eneheuvel,26-09-11
200821NC00309,2008,21NC00,309,0,1,1,eneheuvel,26-09-11
200821NC009999,2008,21NC00,9999,2,1,3,eneheuvel,26-09-11
200821ND00102,2008,21ND00,102,1,1,2,eneheuvel,26-09-11
200821ND00201,2008,21ND00,201,0,1,1,eneheuvel,26-09-11
200821ND00202,2008,21ND00,202,2,0,2,eneheuvel,26-09-11
200821ND00208,2008,21ND00,208,0,1,1,eneheuvel,26-09-11
200821ND00209,2008,21ND00,209,1,0,1,eneheuvel,26-09-11
200821ND00211,2008,21ND00,211,11,13,24,eneheuvel,26-09-11
200821ND00212,2008,21ND00,212,3,5,8,eneheuvel,26-09-11
200821ND00213,2008,21ND00,213,64,83,147,eneheuvel,26-09-11
200821ND00302,2008,21ND00,302,0,1,1,eneheuvel,26-09-11
200821ND00304,2008,21ND00,304,0,1,1,eneheuvel,26-09-11
200821ND00312,2008,21ND00,312,0,1,1,eneheuvel,26-09-11
200821ND00402,2008,21ND00,402,1,0,1,eneheuvel,26-09-11
200822KP00202,2008,22KP00,202,2,0,2,eneheuvel,26-09-11
200822KP00203,2008,22KP00,203,1,1,2,eneheuvel,26-09-11
200822KP00204,2008,22KP00,204,2,0,2,eneheuvel,26-09-11
200822KP00207,2008,22KP00,207,1,3,4,eneheuvel,26-09-11
200822KP00208,2008,22KP00,208,1,0,1,eneheuvel,26-09-11
200822KP00210,2008,22KP00,210,2,0,2,eneheuvel,26-09-11
200822KP00211,2008,22KP00,211,2,0,2,eneheuvel,26-09-11
200822KP00301,2008,22KP00,301,1,1,2,eneheuvel,26-09-11
200822KP00302,2008,22KP00,302,3,5,8,eneheuvel,26-09-11
200822KP00303,2008,22KP00,303,3,3,6,eneheuvel,26-09-11
200822KP00304,2008,22KP00,304,2,5,7,eneheuvel,26-09-11
200822KP00306,2008,22KP00,306,0,3,3,eneheuvel,26-09-11
200822KP00307,2008,22KP00,307,0,1,1,eneheuvel,26-09-11
200822KP00308,2008,22KP00,308,3,8,11,eneheuvel,26-09-11
200822KP00309,2008,22KP00,309,117,153,270,eneheuvel,26-09-11
200822KP00310,2008,22KP00,310,5,5,10,eneheuvel,26-09-11
200822KP00311,2008,22KP00,311,13,21,34,eneheuvel,26-09-11
200822KP00312,2008,22KP00,312,4,3,7,eneheuvel,26-09-11
200822KP009999,2008,22KP00,9999,2,2,4,eneheuvel,26-09-11
200822KQ00201,2008,22KQ00,201,2,0,2,eneheuvel,26-09-11
200822KQ00205,2008,22KQ00,205,0,2,2,eneheuvel,26-09-11
200822KQ00206,2008,22KQ00,206,1,0,1,eneheuvel,26-09-11
200822KQ00209,2008,22KQ00,209,0,2,2,eneheuvel,26-09-11
200822KQ00210,2008,22KQ00,210,63,106,169,eneheuvel,26-09-11
200822KQ00211,2008,22KQ00,211,0,2,2,eneheuvel,26-09-11
200822KQ00212,2008,22KQ00,212,1,0,1,eneheuvel,26-09-11
200822KQ00214,2008,22KQ00,214,0,2,2,eneheuvel,26-09-11
200822KQ00215,2008,22KQ00,215,0,1,1,eneheuvel,26-09-11
200822KQ00216,2008,22KQ00,216,0,2,2,eneheuvel,26-09-11
200822KQ00307,2008,22KQ00,307,0,1,1,eneheuvel,26-09-11
200822KQ00312,2008,22KQ00,312,1,0,1,eneheuvel,26-09-11
200823EP00202,2008,23EP00,202,0,2,2,eneheuvel,26-09-11
200823EP00212,2008,23EP00,212,24,41,65,eneheuvel,26-09-11
200823EP00213,2008,23EP00,213,6,8,14,eneheuvel,26-09-11
200823EP00214,2008,23EP00,214,1,2,3,eneheuvel,26-09-11
200823EP00216,2008,23EP00,216,0,1,1,eneheuvel,26-09-11
200823EP00303,2008,23EP00,303,0,1,1,eneheuvel,26-09-11
200823ER00108,2008,23ER00,108,0,1,1,eneheuvel,26-09-11
200823ER00201,2008,23ER00,201,1,0,1,eneheuvel,26-09-11
200823ER00203,2008,23ER00,203,0,1,1,eneheuvel,26-09-11
200823ER00210,2008,23ER00,210,1,0,1,eneheuvel,26-09-11
200823ER00212,2008,23ER00,212,72,92,164,eneheuvel,26-09-11
200823ER00213,2008,23ER00,213,2,0,2,eneheuvel,26-09-11
200823ER00214,2008,23ER00,214,3,3,6,eneheuvel,26-09-11
200823ER00303,2008,23ER00,303,0,1,1,eneheuvel,26-09-11
200823ET00201,2008,23ET00,201,1,0,1,eneheuvel,26-09-11
200823ET00203,2008,23ET00,203,1,0,1,eneheuvel,26-09-11
200823ET00204,2008,23ET00,204,1,0,1,eneheuvel,26-09-11
200823ET00208,2008,23ET00,208,0,2,2,eneheuvel,26-09-11
200823ET00210,2008,23ET00,210,0,1,1,eneheuvel,26-09-11
200823ET00214,2008,23ET00,214,1,1,2,eneheuvel,26-09-11
200823ET00301,2008,23ET00,301,0,1,1,eneheuvel,26-09-11
200823ET00302,2008,23ET00,302,0,2,2,eneheuvel,26-09-11
200823ET00304,2008,23ET00,304,0,1,1,eneheuvel,26-09-11
200823ET00306,2008,23ET00,306,2,7,9,eneheuvel,26-09-11
200823ET00307,2008,23ET00,307,4,8,12,eneheuvel,26-09-11
200823ET00308,2008,23ET00,308,61,90,151,eneheuvel,26-09-11
200823ET00309,2008,23ET00,309,7,7,14,eneheuvel,26-09-11
200823ET00310,2008,23ET00,310,0,1,1,eneheuvel,26-09-11
200823ET00311,2008,23ET00,311,2,2,4,eneheuvel,26-09-11
200823ET00312,2008,23ET00,312,6,3,9,eneheuvel,26-09-11
200823ET009999,2008,23ET00,9999,1,0,1,eneheuvel,26-09-11
200823EU00105,2008,23EU00,105,0,1,1,eneheuvel,26-09-11
200823EU00207,2008,23EU00,207,2,0,2,eneheuvel,26-09-11
200823EU00208,2008,23EU00,208,0,1,1,eneheuvel,26-09-11
200823EU00301,2008,23EU00,301,0,2,2,eneheuvel,26-09-11
200823EU00303,2008,23EU00,303,1,1,2,eneheuvel,26-09-11
200823EU00305,2008,23EU00,305,0,6,6,eneheuvel,26-09-11
200823EU00306,2008,23EU00,306,102,96,198,eneheuvel,26-09-11
200823EU00307,2008,23EU00,307,6,6,12,eneheuvel,26-09-11
200823EU00308,2008,23EU00,308,1,2,3,eneheuvel,26-09-11
200823EU00309,2008,23EU00,309,2,0,2,eneheuvel,26-09-11
200823EU00310,2008,23EU00,310,0,1,1,eneheuvel,26-09-11
200823EU00311,2008,23EU00,311,0,1,1,eneheuvel,26-09-11
200823EU00313,2008,23EU00,313,0,1,1,eneheuvel,26-09-11
200823EU00402,2008,23EU00,402,0,1,1,eneheuvel,26-09-11
200823EU009999,2008,23EU00,9999,1,2,3,eneheuvel,26-09-11
200823EV00102,2008,23EV00,102,0,1,1,eneheuvel,26-09-11
200823EV00201,2008,23EV00,201,0,1,1,eneheuvel,26-09-11
200823EV00203,2008,23EV00,203,0,1,1,eneheuvel,26-09-11
200823EV00207,2008,23EV00,207,1,1,2,eneheuvel,26-09-11
200823EV00208,2008,23EV00,208,0,1,1,eneheuvel,26-09-11
200823EV00209,2008,23EV00,209,1,0,1,eneheuvel,26-09-11
200823EV00210,2008,23EV00,210,12,8,20,eneheuvel,26-09-11
200823EV00211,2008,23EV00,211,9,9,18,eneheuvel,26-09-11
200823EV00212,2008,23EV00,212,109,127,236,eneheuvel,26-09-11
200823EV00213,2008,23EV00,213,28,25,53,eneheuvel,26-09-11
200823EV00214,2008,23EV00,214,2,2,4,eneheuvel,26-09-11
200823EV00216,2008,23EV00,216,0,2,2,eneheuvel,26-09-11
200823EV00302,2008,23EV00,302,1,0,1,eneheuvel,26-09-11
200823EV00304,2008,23EV00,304,0,1,1,eneheuvel,26-09-11
200823EV00307,2008,23EV00,307,1,1,2,eneheuvel,26-09-11
200823EV009999,2008,23EV00,9999,1,0,1,eneheuvel,26-09-11
200823EY00103,2008,23EY00,103,1,0,1,eneheuvel,26-09-11
200823EY00201,2008,23EY00,201,1,1,2,eneheuvel,26-09-11
200823EY00206,2008,23EY00,206,1,1,2,eneheuvel,26-09-11
200823EY00208,2008,23EY00,208,2,1,3,eneheuvel,26-09-11
200823EY00209,2008,23EY00,209,2,2,4,eneheuvel,26-09-11
200823EY00210,2008,23EY00,210,8,9,17,eneheuvel,26-09-11
200823EY00211,2008,23EY00,211,15,9,24,eneheuvel,26-09-11
200823EY00212,2008,23EY00,212,114,135,249,eneheuvel,26-09-11
200823EY00213,2008,23EY00,213,31,21,52,eneheuvel,26-09-11
200823EY00214,2008,23EY00,214,4,2,6,eneheuvel,26-09-11
200823EY00215,2008,23EY00,215,2,0,2,eneheuvel,26-09-11
200823EY00216,2008,23EY00,216,0,1,1,eneheuvel,26-09-11
200823EY00302,2008,23EY00,302,1,0,1,eneheuvel,26-09-11
200823EY00304,2008,23EY00,304,0,1,1,eneheuvel,26-09-11
200823EY00305,2008,23EY00,305,1,0,1,eneheuvel,26-09-11
200823EY00502,2008,23EY00,502,0,1,1,eneheuvel,26-09-11
200823EY009999,2008,23EY00,9999,4,1,5,eneheuvel,26-09-11
200823ZU00110,2008,23ZU00,110,1,0,1,eneheuvel,26-09-11
200823ZU00202,2008,23ZU00,202,74,79,153,eneheuvel,26-09-11
200823ZU00203,2008,23ZU00,203,5,8,13,eneheuvel,26-09-11
200823ZU00204,2008,23ZU00,204,52,53,105,eneheuvel,26-09-11
200823ZU00205,2008,23ZU00,205,93,97,190,eneheuvel,26-09-11
200823ZU00206,2008,23ZU00,206,2,1,3,eneheuvel,26-09-11
200823ZU00207,2008,23ZU00,207,30,14,44,eneheuvel,26-09-11
200823ZU00208,2008,23ZU00,208,16,22,38,eneheuvel,26-09-11
200823ZU00209,2008,23ZU00,209,1,0,1,eneheuvel,26-09-11
200823ZU00210,2008,23ZU00,210,2,2,4,eneheuvel,26-09-11
200823ZU00211,2008,23ZU00,211,1,3,4,eneheuvel,26-09-11
200823ZU00212,2008,23ZU00,212,0,2,2,eneheuvel,26-09-11
200823ZU00213,2008,23ZU00,213,1,0,1,eneheuvel,26-09-11
200823ZU00214,2008,23ZU00,214,0,2,2,eneheuvel,26-09-11
200823ZU00215,2008,23ZU00,215,0,2,2,eneheuvel,26-09-11
200823ZU00216,2008,23ZU00,216,4,1,5,eneheuvel,26-09-11
200823ZU00302,2008,23ZU00,302,0,1,1,eneheuvel,26-09-11
200823ZU00303,2008,23ZU00,303,0,5,5,eneheuvel,26-09-11
200823ZU00306,2008,23ZU00,306,2,0,2,eneheuvel,26-09-11
200823ZU00307,2008,23ZU00,307,0,1,1,eneheuvel,26-09-11
200823ZU00309,2008,23ZU00,309,1,1,2,eneheuvel,26-09-11
200823ZU00311,2008,23ZU00,311,2,1,3,eneheuvel,26-09-11
200823ZU00502,2008,23ZU00,502,1,2,3,eneheuvel,26-09-11
200823ZU009999,2008,23ZU00,9999,0,1,1,eneheuvel,26-09-11
200823ZV00107,2008,23ZV00,107,2,1,3,eneheuvel,26-09-11
200823ZV00201,2008,23ZV00,201,4,1,5,eneheuvel,26-09-11
200823ZV00202,2008,23ZV00,202,35,43,78,eneheuvel,26-09-11
200823ZV00203,2008,23ZV00,203,3,7,10,eneheuvel,26-09-11
200823ZV00204,2008,23ZV00,204,24,32,56,eneheuvel,26-09-11
200823ZV00205,2008,23ZV00,205,43,66,109,eneheuvel,26-09-11
200823ZV00206,2008,23ZV00,206,0,1,1,eneheuvel,26-09-11
200823ZV00207,2008,23ZV00,207,6,13,19,eneheuvel,26-09-11
200823ZV00208,2008,23ZV00,208,6,9,15,eneheuvel,26-09-11
200823ZV00210,2008,23ZV00,210,0,1,1,eneheuvel,26-09-11
200823ZV00211,2008,23ZV00,211,0,3,3,eneheuvel,26-09-11
200823ZV00302,2008,23ZV00,302,0,1,1,eneheuvel,26-09-11
200823ZV00308,2008,23ZV00,308,2,0,2,eneheuvel,26-09-11
200823ZV00309,2008,23ZV00,309,1,0,1,eneheuvel,26-09-11
200823ZV00402,2008,23ZV00,402,1,1,2,eneheuvel,26-09-11
200823ZW00201,2008,23ZW00,201,0,1,1,eneheuvel,26-09-11
200823ZW00206,2008,23ZW00,206,1,0,1,eneheuvel,26-09-11
200823ZW00207,2008,23ZW00,207,0,2,2,eneheuvel,26-09-11
200823ZW00208,2008,23ZW00,208,2,4,6,eneheuvel,26-09-11
200823ZW00211,2008,23ZW00,211,1,1,2,eneheuvel,26-09-11
200823ZW00301,2008,23ZW00,301,4,0,4,eneheuvel,26-09-11
200823ZW00302,2008,23ZW00,302,6,0,6,eneheuvel,26-09-11
200823ZW00303,2008,23ZW00,303,3,3,6,eneheuvel,26-09-11
200823ZW00304,2008,23ZW00,304,2,2,4,eneheuvel,26-09-11
200823ZW00305,2008,23ZW00,305,3,2,5,eneheuvel,26-09-11
200823ZW00306,2008,23ZW00,306,26,37,63,eneheuvel,26-09-11
200823ZW00307,2008,23ZW00,307,80,86,166,eneheuvel,26-09-11
200823ZW00308,2008,23ZW00,308,99,81,180,eneheuvel,26-09-11
200823ZW00309,2008,23ZW00,309,8,5,13,eneheuvel,26-09-11
200823ZW00310,2008,23ZW00,310,3,1,4,eneheuvel,26-09-11
200823ZW00311,2008,23ZW00,311,1,0,1,eneheuvel,26-09-11
200823ZW00312,2008,23ZW00,312,3,4,7,eneheuvel,26-09-11
200823ZW00313,2008,23ZW00,313,0,1,1,eneheuvel,26-09-11
200823ZW00502,2008,23ZW00,502,3,2,5,eneheuvel,26-09-11
200823ZW009999,2008,23ZW00,9999,1,3,4,eneheuvel,26-09-11
200823ZX00110,2008,23ZX00,110,0,1,1,eneheuvel,26-09-11
200823ZX00201,2008,23ZX00,201,7,3,10,eneheuvel,26-09-11
200823ZX00202,2008,23ZX00,202,124,137,261,eneheuvel,26-09-11
200823ZX00203,2008,23ZX00,203,2,1,3,eneheuvel,26-09-11
200823ZX00204,2008,23ZX00,204,4,3,7,eneheuvel,26-09-11
200823ZX00205,2008,23ZX00,205,3,8,11,eneheuvel,26-09-11
200823ZX00206,2008,23ZX00,206,0,1,1,eneheuvel,26-09-11
200823ZX00207,2008,23ZX00,207,1,7,8,eneheuvel,26-09-11
200823ZX00208,2008,23ZX00,208,8,11,19,eneheuvel,26-09-11
200823ZX00209,2008,23ZX00,209,2,0,2,eneheuvel,26-09-11
200823ZX00210,2008,23ZX00,210,1,1,2,eneheuvel,26-09-11
200823ZX00211,2008,23ZX00,211,3,3,6,eneheuvel,26-09-11
200823ZX00306,2008,23ZX00,306,1,2,3,eneheuvel,26-09-11
200823ZX00307,2008,23ZX00,307,0,1,1,eneheuvel,26-09-11
200823ZX009999,2008,23ZX00,9999,0,1,1,eneheuvel,26-09-11
200823ZY00107,2008,23ZY00,107,0,1,1,eneheuvel,26-09-11
200823ZY00109,2008,23ZY00,109,0,1,1,eneheuvel,26-09-11
200823ZY00203,2008,23ZY00,203,1,0,1,eneheuvel,26-09-11
200823ZY00206,2008,23ZY00,206,1,1,2,eneheuvel,26-09-11
200823ZY00210,2008,23ZY00,210,2,0,2,eneheuvel,26-09-11
200823ZY00211,2008,23ZY00,211,2,1,3,eneheuvel,26-09-11
200823ZY00212,2008,23ZY00,212,167,188,355,eneheuvel,26-09-11
200823ZY00213,2008,23ZY00,213,4,0,4,eneheuvel,26-09-11
200823ZY00214,2008,23ZY00,214,1,1,2,eneheuvel,26-09-11
200823ZY00215,2008,23ZY00,215,0,1,1,eneheuvel,26-09-11
200823ZY00216,2008,23ZY00,216,0,1,1,eneheuvel,26-09-11
200823ZY00302,2008,23ZY00,302,0,1,1,eneheuvel,26-09-11
200823ZY009999,2008,23ZY00,9999,1,1,2,eneheuvel,26-09-11
200824EJ00101,2008,24EJ00,101,1,0,1,eneheuvel,26-09-11
200824EJ00102,2008,24EJ00,102,3,3,6,eneheuvel,26-09-11
200824EJ00103,2008,24EJ00,103,1,0,1,eneheuvel,26-09-11
200824EJ00106,2008,24EJ00,106,1,2,3,eneheuvel,26-09-11
200824EJ00107,2008,24EJ00,107,3,0,3,eneheuvel,26-09-11
200824EJ00108,2008,24EJ00,108,3,1,4,eneheuvel,26-09-11
200824EJ00201,2008,24EJ00,201,3,0,3,eneheuvel,26-09-11
200824EJ00202,2008,24EJ00,202,4,4,8,eneheuvel,26-09-11
200824EJ00203,2008,24EJ00,203,0,2,2,eneheuvel,26-09-11
200824EJ00204,2008,24EJ00,204,7,5,12,eneheuvel,26-09-11
200824EJ00205,2008,24EJ00,205,1,4,5,eneheuvel,26-09-11
200824EJ00206,2008,24EJ00,206,1,2,3,eneheuvel,26-09-11
200824EJ00207,2008,24EJ00,207,3,2,5,eneheuvel,26-09-11
200824EJ00208,2008,24EJ00,208,2,9,11,eneheuvel,26-09-11
200824EJ00209,2008,24EJ00,209,17,10,27,eneheuvel,26-09-11
200824EJ00210,2008,24EJ00,210,21,19,40,eneheuvel,26-09-11
200824EJ00211,2008,24EJ00,211,36,27,63,eneheuvel,26-09-11
200824EJ00212,2008,24EJ00,212,10,9,19,eneheuvel,26-09-11
200824EJ00213,2008,24EJ00,213,5,4,9,eneheuvel,26-09-11
200824EJ00214,2008,24EJ00,214,4,5,9,eneheuvel,26-09-11
200824EJ00303,2008,24EJ00,303,1,1,2,eneheuvel,26-09-11
200824EJ00308,2008,24EJ00,308,1,0,1,eneheuvel,26-09-11
200824EJ00309,2008,24EJ00,309,0,1,1,eneheuvel,26-09-11
200824EJ009999,2008,24EJ00,9999,1,1,2,eneheuvel,26-09-11
200824FT00102,2008,24FT00,102,1,0,1,eneheuvel,26-09-11
200824FT00103,2008,24FT00,103,0,2,2,eneheuvel,26-09-11
200824FT00105,2008,24FT00,105,0,2,2,eneheuvel,26-09-11
200824FT00106,2008,24FT00,106,0,2,2,eneheuvel,26-09-11
200824FT00108,2008,24FT00,108,0,1,1,eneheuvel,26-09-11
200824FT00109,2008,24FT00,109,1,0,1,eneheuvel,26-09-11
200824FT00203,2008,24FT00,203,1,4,5,eneheuvel,26-09-11
200824FT00204,2008,24FT00,204,0,3,3,eneheuvel,26-09-11
200824FT00205,2008,24FT00,205,0,2,2,eneheuvel,26-09-11
200824FT00206,2008,24FT00,206,2,6,8,eneheuvel,26-09-11
200824FT00207,2008,24FT00,207,0,2,2,eneheuvel,26-09-11
200824FT00208,2008,24FT00,208,2,7,9,eneheuvel,26-09-11
200824FT00209,2008,24FT00,209,1,1,2,eneheuvel,26-09-11
200824FT00210,2008,24FT00,210,0,3,3,eneheuvel,26-09-11
200824FT00211,2008,24FT00,211,5,5,10,eneheuvel,26-09-11
200824FT00212,2008,24FT00,212,3,17,20,eneheuvel,26-09-11
200824FT00213,2008,24FT00,213,4,5,9,eneheuvel,26-09-11
200824FT00214,2008,24FT00,214,2,18,20,eneheuvel,26-09-11
200824FT00301,2008,24FT00,301,2,0,2,eneheuvel,26-09-11
200824FT00302,2008,24FT00,302,3,16,19,eneheuvel,26-09-11
200824FT00303,2008,24FT00,303,1,15,16,eneheuvel,26-09-11
200824FT00304,2008,24FT00,304,1,6,7,eneheuvel,26-09-11
200824FT00305,2008,24FT00,305,0,4,4,eneheuvel,26-09-11
200824FT00306,2008,24FT00,306,3,4,7,eneheuvel,26-09-11
200824FT00307,2008,24FT00,307,1,7,8,eneheuvel,26-09-11
200824FT00308,2008,24FT00,308,1,11,12,eneheuvel,26-09-11
200824FT00309,2008,24FT00,309,0,5,5,eneheuvel,26-09-11
200824FT00311,2008,24FT00,311,3,8,11,eneheuvel,26-09-11
200824FT00312,2008,24FT00,312,4,12,16,eneheuvel,26-09-11
200824FT00502,2008,24FT00,502,0,2,2,eneheuvel,26-09-11
200824FT009999,2008,24FT00,9999,0,4,4,eneheuvel,26-09-11
200824MR00108,2008,24MR00,108,0,1,1,eneheuvel,26-09-11
200824MR00201,2008,24MR00,201,0,2,2,eneheuvel,26-09-11
200824MR00207,2008,24MR00,207,1,0,1,eneheuvel,26-09-11
200824MR00208,2008,24MR00,208,1,1,2,eneheuvel,26-09-11
200824MR00301,2008,24MR00,301,1,0,1,eneheuvel,26-09-11
200824MR00305,2008,24MR00,305,1,0,1,eneheuvel,26-09-11
200824MR00306,2008,24MR00,306,10,17,27,eneheuvel,26-09-11
200824MR00307,2008,24MR00,307,110,145,255,eneheuvel,26-09-11
200824MR00308,2008,24MR00,308,5,10,15,eneheuvel,26-09-11
200824MR00309,2008,24MR00,309,1,0,1,eneheuvel,26-09-11
200824MR00311,2008,24MR00,311,1,1,2,eneheuvel,26-09-11
200824MR00502,2008,24MR00,502,0,2,2,eneheuvel,26-09-11
200824RK00108,2008,24RK00,108,0,1,1,eneheuvel,26-09-11
200824RK00202,2008,24RK00,202,9,19,28,eneheuvel,26-09-11
200824RK00203,2008,24RK00,203,12,10,22,eneheuvel,26-09-11
200824RK00204,2008,24RK00,204,9,16,25,eneheuvel,26-09-11
200824RK00205,2008,24RK00,205,7,7,14,eneheuvel,26-09-11
200824RK00206,2008,24RK00,206,4,0,4,eneheuvel,26-09-11
200824RK00207,2008,24RK00,207,7,3,10,eneheuvel,26-09-11
200824RK00208,2008,24RK00,208,4,2,6,eneheuvel,26-09-11
200824RK00210,2008,24RK00,210,0,2,2,eneheuvel,26-09-11
200824RK00211,2008,24RK00,211,2,0,2,eneheuvel,26-09-11
200824RK00212,2008,24RK00,212,2,0,2,eneheuvel,26-09-11
200824RK00213,2008,24RK00,213,1,2,3,eneheuvel,26-09-11
200824RK00214,2008,24RK00,214,1,1,2,eneheuvel,26-09-11
200824RK00216,2008,24RK00,216,1,3,4,eneheuvel,26-09-11
200824RK00301,2008,24RK00,301,1,1,2,eneheuvel,26-09-11
200824RK00302,2008,24RK00,302,4,3,7,eneheuvel,26-09-11
200824RK00303,2008,24RK00,303,8,3,11,eneheuvel,26-09-11
200824RK00304,2008,24RK00,304,3,5,8,eneheuvel,26-09-11
200824RK00305,2008,24RK00,305,0,2,2,eneheuvel,26-09-11
200824RK00306,2008,24RK00,306,4,4,8,eneheuvel,26-09-11
200824RK00307,2008,24RK00,307,6,3,9,eneheuvel,26-09-11
200824RK00308,2008,24RK00,308,5,4,9,eneheuvel,26-09-11
200824RK00309,2008,24RK00,309,3,2,5,eneheuvel,26-09-11
200824RK00311,2008,24RK00,311,1,0,1,eneheuvel,26-09-11
200824RK00312,2008,24RK00,312,1,0,1,eneheuvel,26-09-11
200824RK009999,2008,24RK00,9999,0,2,2,eneheuvel,26-09-11
200824UN00201,2008,24UN00,201,2,0,2,eneheuvel,26-09-11
200824UN00202,2008,24UN00,202,2,0,2,eneheuvel,26-09-11
200824UN00204,2008,24UN00,204,0,1,1,eneheuvel,26-09-11
200824UN00302,2008,24UN00,302,1,0,1,eneheuvel,26-09-11
200824UN00303,2008,24UN00,303,1,0,1,eneheuvel,26-09-11
200824UN00305,2008,24UN00,305,1,0,1,eneheuvel,26-09-11
200824UN00306,2008,24UN00,306,21,26,47,eneheuvel,26-09-11
200824UN00307,2008,24UN00,307,38,42,80,eneheuvel,26-09-11
200824UN00308,2008,24UN00,308,54,48,102,eneheuvel,26-09-11
200824UN00309,2008,24UN00,309,16,14,30,eneheuvel,26-09-11
200824UN00311,2008,24UN00,311,3,2,5,eneheuvel,26-09-11
200824UN00313,2008,24UN00,313,1,0,1,eneheuvel,26-09-11
200824UN009999,2008,24UN00,9999,2,0,2,eneheuvel,26-09-11
200825CF00202,2008,25CF00,202,3,6,9,eneheuvel,26-09-11
200825CF00203,2008,25CF00,203,2,3,5,eneheuvel,26-09-11
200825CF00204,2008,25CF00,204,66,80,146,eneheuvel,26-09-11
200825CF00205,2008,25CF00,205,16,51,67,eneheuvel,26-09-11
200825CF00206,2008,25CF00,206,1,0,1,eneheuvel,26-09-11
200825CF00207,2008,25CF00,207,2,5,7,eneheuvel,26-09-11
200825CF00208,2008,25CF00,208,4,7,11,eneheuvel,26-09-11
200825CF00212,2008,25CF00,212,1,0,1,eneheuvel,26-09-11
200825CF00303,2008,25CF00,303,0,1,1,eneheuvel,26-09-11
200825CF00309,2008,25CF00,309,1,0,1,eneheuvel,26-09-11
200825CF009999,2008,25CF00,9999,1,1,2,eneheuvel,26-09-11
200825KT00101,2008,25KT00,101,1,1,2,eneheuvel,26-09-11
200825KT00107,2008,25KT00,107,1,1,2,eneheuvel,26-09-11
200825KT00202,2008,25KT00,202,47,54,101,eneheuvel,26-09-11
200825KT00203,2008,25KT00,203,99,83,182,eneheuvel,26-09-11
200825KT00204,2008,25KT00,204,88,86,174,eneheuvel,26-09-11
200825KT00205,2008,25KT00,205,3,7,10,eneheuvel,26-09-11
200825KT00206,2008,25KT00,206,1,0,1,eneheuvel,26-09-11
200825KT00207,2008,25KT00,207,20,8,28,eneheuvel,26-09-11
200825KT00208,2008,25KT00,208,40,37,77,eneheuvel,26-09-11
200825KT00211,2008,25KT00,211,1,0,1,eneheuvel,26-09-11
200825KT00214,2008,25KT00,214,0,1,1,eneheuvel,26-09-11
200825KT00302,2008,25KT00,302,2,0,2,eneheuvel,26-09-11
200825KT00309,2008,25KT00,309,1,1,2,eneheuvel,26-09-11
200825KT00502,2008,25KT00,502,3,13,16,eneheuvel,26-09-11
200825KT009999,2008,25KT00,9999,1,0,1,eneheuvel,26-09-11
200825KU00110,2008,25KU00,110,2,2,4,eneheuvel,26-09-11
200825KU00201,2008,25KU00,201,0,1,1,eneheuvel,26-09-11
200825KU00202,2008,25KU00,202,26,28,54,eneheuvel,26-09-11
200825KU00203,2008,25KU00,203,77,59,136,eneheuvel,26-09-11
200825KU00204,2008,25KU00,204,59,77,136,eneheuvel,26-09-11
200825KU00205,2008,25KU00,205,3,3,6,eneheuvel,26-09-11
200825KU00206,2008,25KU00,206,1,0,1,eneheuvel,26-09-11
200825KU00207,2008,25KU00,207,11,6,17,eneheuvel,26-09-11
200825KU00208,2008,25KU00,208,23,32,55,eneheuvel,26-09-11
200825KU00211,2008,25KU00,211,1,1,2,eneheuvel,26-09-11
200825KU00216,2008,25KU00,216,2,0,2,eneheuvel,26-09-11
200825KU00303,2008,25KU00,303,1,0,1,eneheuvel,26-09-11
200825KU00306,2008,25KU00,306,1,0,1,eneheuvel,26-09-11
200825KU00308,2008,25KU00,308,1,0,1,eneheuvel,26-09-11
200825KU00309,2008,25KU00,309,1,0,1,eneheuvel,26-09-11
200825KU00312,2008,25KU00,312,1,0,1,eneheuvel,26-09-11
200825KU00313,2008,25KU00,313,1,0,1,eneheuvel,26-09-11
200825KU00502,2008,25KU00,502,3,13,16,eneheuvel,26-09-11
200825KU009999,2008,25KU00,9999,1,3,4,eneheuvel,26-09-11
200825KV00102,2008,25KV00,102,0,1,1,eneheuvel,26-09-11
200825KV00104,2008,25KV00,104,1,0,1,eneheuvel,26-09-11
200825KV00108,2008,25KV00,108,1,0,1,eneheuvel,26-09-11
200825KV00201,2008,25KV00,201,0,1,1,eneheuvel,26-09-11
200825KV00202,2008,25KV00,202,3,3,6,eneheuvel,26-09-11
200825KV00203,2008,25KV00,203,167,191,358,eneheuvel,26-09-11
200825KV00204,2008,25KV00,204,1,9,10,eneheuvel,26-09-11
200825KV00205,2008,25KV00,205,0,1,1,eneheuvel,26-09-11
200825KV00207,2008,25KV00,207,1,2,3,eneheuvel,26-09-11
200825KV00208,2008,25KV00,208,1,6,7,eneheuvel,26-09-11
200825KV00211,2008,25KV00,211,1,2,3,eneheuvel,26-09-11
200825KV00214,2008,25KV00,214,0,1,1,eneheuvel,26-09-11
200825KV00302,2008,25KV00,302,0,1,1,eneheuvel,26-09-11
200825KV00309,2008,25KV00,309,0,1,1,eneheuvel,26-09-11
200825KV009999,2008,25KV00,9999,0,1,1,eneheuvel,26-09-11
200826AB00101,2008,26AB00,101,0,1,1,eneheuvel,26-09-11
200826AB00109,2008,26AB00,109,1,1,2,eneheuvel,26-09-11
200826AB00208,2008,26AB00,208,0,1,1,eneheuvel,26-09-11
200826AB00211,2008,26AB00,211,0,1,1,eneheuvel,26-09-11
200826AB00214,2008,26AB00,214,1,0,1,eneheuvel,26-09-11
200826AB00301,2008,26AB00,301,2,0,2,eneheuvel,26-09-11
200826AB00302,2008,26AB00,302,15,22,37,eneheuvel,26-09-11
200826AB00303,2008,26AB00,303,174,187,361,eneheuvel,26-09-11
200826AB00304,2008,26AB00,304,3,4,7,eneheuvel,26-09-11
200826AB00305,2008,26AB00,305,1,0,1,eneheuvel,26-09-11
200826AB00306,2008,26AB00,306,0,4,4,eneheuvel,26-09-11
200826AB00308,2008,26AB00,308,0,2,2,eneheuvel,26-09-11
200826AB00309,2008,26AB00,309,4,1,5,eneheuvel,26-09-11
200826AB00310,2008,26AB00,310,1,0,1,eneheuvel,26-09-11
200826AB00311,2008,26AB00,311,4,3,7,eneheuvel,26-09-11
200826AB00312,2008,26AB00,312,2,3,5,eneheuvel,26-09-11
200826AB00313,2008,26AB00,313,4,2,6,eneheuvel,26-09-11
200826AB00402,2008,26AB00,402,0,1,1,eneheuvel,26-09-11
200826AB009999,2008,26AB00,9999,2,3,5,eneheuvel,26-09-11
200826AC00107,2008,26AC00,107,0,4,4,eneheuvel,26-09-11
200826AC00108,2008,26AC00,108,0,1,1,eneheuvel,26-09-11
200826AC00109,2008,26AC00,109,23,10,33,eneheuvel,26-09-11
200826AC00201,2008,26AC00,201,0,1,1,eneheuvel,26-09-11
200826AC00203,2008,26AC00,203,2,0,2,eneheuvel,26-09-11
200826AC00204,2008,26AC00,204,1,1,2,eneheuvel,26-09-11
200826AC00207,2008,26AC00,207,0,1,1,eneheuvel,26-09-11
200826AC00210,2008,26AC00,210,0,1,1,eneheuvel,26-09-11
200826AC00211,2008,26AC00,211,5,7,12,eneheuvel,26-09-11
200826AC00212,2008,26AC00,212,10,14,24,eneheuvel,26-09-11
200826AC00213,2008,26AC00,213,8,17,25,eneheuvel,26-09-11
200826AC00214,2008,26AC00,214,471,361,832,eneheuvel,26-09-11
200826AC00215,2008,26AC00,215,1,0,1,eneheuvel,26-09-11
200826AC00216,2008,26AC00,216,2,0,2,eneheuvel,26-09-11
200826AC00301,2008,26AC00,301,1,0,1,eneheuvel,26-09-11
200826AC00302,2008,26AC00,302,1,0,1,eneheuvel,26-09-11
200826AC00303,2008,26AC00,303,0,1,1,eneheuvel,26-09-11
200826AC00311,2008,26AC00,311,3,0,3,eneheuvel,26-09-11
200826AC00312,2008,26AC00,312,2,0,2,eneheuvel,26-09-11
200826AC00402,2008,26AC00,402,1,1,2,eneheuvel,26-09-11
200826AC009999,2008,26AC00,9999,3,4,7,eneheuvel,26-09-11
200826AD00204,2008,26AD00,204,0,2,2,eneheuvel,26-09-11
200826AD00208,2008,26AD00,208,3,0,3,eneheuvel,26-09-11
200826AD00210,2008,26AD00,210,1,0,1,eneheuvel,26-09-11
200826AD00213,2008,26AD00,213,1,0,1,eneheuvel,26-09-11
200826AD00214,2008,26AD00,214,1,1,2,eneheuvel,26-09-11
200826AD00301,2008,26AD00,301,1,1,2,eneheuvel,26-09-11
200826AD00302,2008,26AD00,302,89,68,157,eneheuvel,26-09-11
200826AD00303,2008,26AD00,303,46,26,72,eneheuvel,26-09-11
200826AD00304,2008,26AD00,304,2,1,3,eneheuvel,26-09-11
200826AD00305,2008,26AD00,305,3,3,6,eneheuvel,26-09-11
200826AD00306,2008,26AD00,306,0,2,2,eneheuvel,26-09-11
200826AD00307,2008,26AD00,307,1,1,2,eneheuvel,26-09-11
200826AD00308,2008,26AD00,308,1,1,2,eneheuvel,26-09-11
200826AD00309,2008,26AD00,309,79,37,116,eneheuvel,26-09-11
200826AD00310,2008,26AD00,310,25,6,31,eneheuvel,26-09-11
200826AD00311,2008,26AD00,311,36,31,67,eneheuvel,26-09-11
200826AD00312,2008,26AD00,312,8,6,14,eneheuvel,26-09-11
200826AD00313,2008,26AD00,313,7,10,17,eneheuvel,26-09-11
200826AD00502,2008,26AD00,502,0,1,1,eneheuvel,26-09-11
200826AD009999,2008,26AD00,9999,0,1,1,eneheuvel,26-09-11
200826PD00101,2008,26PD00,101,0,1,1,eneheuvel,26-09-11
200826PD00104,2008,26PD00,104,2,0,2,eneheuvel,26-09-11
200826PD00108,2008,26PD00,108,3,0,3,eneheuvel,26-09-11
200826PD00204,2008,26PD00,204,1,7,8,eneheuvel,26-09-11
200826PD00205,2008,26PD00,205,5,5,10,eneheuvel,26-09-11
200826PD00207,2008,26PD00,207,148,182,330,eneheuvel,26-09-11
200826PD00208,2008,26PD00,208,32,49,81,eneheuvel,26-09-11
200826PD00211,2008,26PD00,211,0,1,1,eneheuvel,26-09-11
200826PD00308,2008,26PD00,308,2,1,3,eneheuvel,26-09-11
200826PD00309,2008,26PD00,309,0,1,1,eneheuvel,26-09-11
200826PD00401,2008,26PD00,401,0,1,1,eneheuvel,26-09-11
200826PD00502,2008,26PD00,502,2,2,4,eneheuvel,26-09-11
200826PD009999,2008,26PD00,9999,4,3,7,eneheuvel,26-09-11
200826PE00201,2008,26PE00,201,1,1,2,eneheuvel,26-09-11
200826PE00202,2008,26PE00,202,1,0,1,eneheuvel,26-09-11
200826PE00208,2008,26PE00,208,2,1,3,eneheuvel,26-09-11
200826PE00301,2008,26PE00,301,2,0,2,eneheuvel,26-09-11
200826PE00302,2008,26PE00,302,234,251,485,eneheuvel,26-09-11
200826PE00303,2008,26PE00,303,25,17,42,eneheuvel,26-09-11
200826PE00305,2008,26PE00,305,1,0,1,eneheuvel,26-09-11
200826PE00307,2008,26PE00,307,1,0,1,eneheuvel,26-09-11
200826PE00309,2008,26PE00,309,4,1,5,eneheuvel,26-09-11
200826PE00311,2008,26PE00,311,3,6,9,eneheuvel,26-09-11
200826PE00312,2008,26PE00,312,3,5,8,eneheuvel,26-09-11
200826PE00313,2008,26PE00,313,7,4,11,eneheuvel,26-09-11
200826PE00402,2008,26PE00,402,0,1,1,eneheuvel,26-09-11
200826PE009999,2008,26PE00,9999,5,1,6,eneheuvel,26-09-11
200826PF00103,2008,26PF00,103,1,0,1,eneheuvel,26-09-11
200826PF00201,2008,26PF00,201,1,1,2,eneheuvel,26-09-11
200826PF00202,2008,26PF00,202,1,0,1,eneheuvel,26-09-11
200826PF00204,2008,26PF00,204,3,0,3,eneheuvel,26-09-11
200826PF00206,2008,26PF00,206,2,1,3,eneheuvel,26-09-11
200826PF00208,2008,26PF00,208,0,1,1,eneheuvel,26-09-11
200826PF00209,2008,26PF00,209,2,1,3,eneheuvel,26-09-11
200826PF00210,2008,26PF00,210,2,0,2,eneheuvel,26-09-11
200826PF00211,2008,26PF00,211,4,10,14,eneheuvel,26-09-11
200826PF00212,2008,26PF00,212,9,2,11,eneheuvel,26-09-11
200826PF00213,2008,26PF00,213,4,4,8,eneheuvel,26-09-11
200826PF00214,2008,26PF00,214,181,207,388,eneheuvel,26-09-11
200826PF00216,2008,26PF00,216,2,2,4,eneheuvel,26-09-11
200826PF00302,2008,26PF00,302,2,3,5,eneheuvel,26-09-11
200826PF00305,2008,26PF00,305,0,1,1,eneheuvel,26-09-11
200826PF00308,2008,26PF00,308,1,0,1,eneheuvel,26-09-11
200826PF00309,2008,26PF00,309,2,1,3,eneheuvel,26-09-11
200826PF00310,2008,26PF00,310,0,1,1,eneheuvel,26-09-11
200826PF00402,2008,26PF00,402,0,1,1,eneheuvel,26-09-11
200826PF00502,2008,26PF00,502,2,0,2,eneheuvel,26-09-11
200826PF009999,2008,26PF00,9999,8,6,14,eneheuvel,26-09-11
200826PG00101,2008,26PG00,101,1,0,1,eneheuvel,26-09-11
200826PG00103,2008,26PG00,103,0,1,1,eneheuvel,26-09-11
200826PG00108,2008,26PG00,108,1,0,1,eneheuvel,26-09-11
200826PG00207,2008,26PG00,207,1,0,1,eneheuvel,26-09-11
200826PG00209,2008,26PG00,209,1,0,1,eneheuvel,26-09-11
200826PG00210,2008,26PG00,210,1,0,1,eneheuvel,26-09-11
200826PG00211,2008,26PG00,211,2,1,3,eneheuvel,26-09-11
200826PG00212,2008,26PG00,212,0,2,2,eneheuvel,26-09-11
200826PG00213,2008,26PG00,213,1,1,2,eneheuvel,26-09-11
200826PG00214,2008,26PG00,214,62,89,151,eneheuvel,26-09-11
200826PG00307,2008,26PG00,307,0,2,2,eneheuvel,26-09-11
200826PG009999,2008,26PG00,9999,3,2,5,eneheuvel,26-09-11
200826PH00204,2008,26PH00,204,0,1,1,eneheuvel,26-09-11
200826PH00207,2008,26PH00,207,0,1,1,eneheuvel,26-09-11
200826PH00211,2008,26PH00,211,1,0,1,eneheuvel,26-09-11
200826PH00212,2008,26PH00,212,1,0,1,eneheuvel,26-09-11
200826PH00216,2008,26PH00,216,0,2,2,eneheuvel,26-09-11
200826PH00301,2008,26PH00,301,1,0,1,eneheuvel,26-09-11
200826PH00302,2008,26PH00,302,30,15,45,eneheuvel,26-09-11
200826PH00303,2008,26PH00,303,5,9,14,eneheuvel,26-09-11
200826PH00304,2008,26PH00,304,3,1,4,eneheuvel,26-09-11
200826PH00305,2008,26PH00,305,3,1,4,eneheuvel,26-09-11
200826PH00306,2008,26PH00,306,1,0,1,eneheuvel,26-09-11
200826PH00307,2008,26PH00,307,1,0,1,eneheuvel,26-09-11
200826PH00308,2008,26PH00,308,5,3,8,eneheuvel,26-09-11
200826PH00309,2008,26PH00,309,43,30,73,eneheuvel,26-09-11
200826PH00311,2008,26PH00,311,238,206,444,eneheuvel,26-09-11
200826PH00312,2008,26PH00,312,17,7,24,eneheuvel,26-09-11
200826PH00313,2008,26PH00,313,7,4,11,eneheuvel,26-09-11
200826PH009999,2008,26PH00,9999,4,4,8,eneheuvel,26-09-11
200826PW00208,2008,26PW00,208,0,1,1,eneheuvel,26-09-11
200826PW00302,2008,26PW00,302,26,39,65,eneheuvel,26-09-11
200826PW00303,2008,26PW00,303,42,22,64,eneheuvel,26-09-11
200826PW00306,2008,26PW00,306,1,1,2,eneheuvel,26-09-11
200826PW00308,2008,26PW00,308,5,3,8,eneheuvel,26-09-11
200826PW00309,2008,26PW00,309,43,27,70,eneheuvel,26-09-11
200826PW00310,2008,26PW00,310,10,6,16,eneheuvel,26-09-11
200826PW00311,2008,26PW00,311,22,15,37,eneheuvel,26-09-11
200826PW00312,2008,26PW00,312,4,3,7,eneheuvel,26-09-11
200826PW00313,2008,26PW00,313,2,4,6,eneheuvel,26-09-11
200826PW009999,2008,26PW00,9999,2,0,2,eneheuvel,26-09-11
200826ZZ00105,2008,26ZZ00,105,1,0,1,eneheuvel,26-09-11
200826ZZ00202,2008,26ZZ00,202,219,226,445,eneheuvel,26-09-11
200826ZZ00203,2008,26ZZ00,203,7,15,22,eneheuvel,26-09-11
200826ZZ00204,2008,26ZZ00,204,2,4,6,eneheuvel,26-09-11
200826ZZ00205,2008,26ZZ00,205,0,1,1,eneheuvel,26-09-11
200826ZZ00206,2008,26ZZ00,206,0,1,1,eneheuvel,26-09-11
200826ZZ00207,2008,26ZZ00,207,1,0,1,eneheuvel,26-09-11
200826ZZ00208,2008,26ZZ00,208,2,2,4,eneheuvel,26-09-11
200826ZZ00210,2008,26ZZ00,210,0,1,1,eneheuvel,26-09-11
200826ZZ00211,2008,26ZZ00,211,1,0,1,eneheuvel,26-09-11
200826ZZ00212,2008,26ZZ00,212,1,1,2,eneheuvel,26-09-11
200826ZZ00216,2008,26ZZ00,216,0,1,1,eneheuvel,26-09-11
200826ZZ00309,2008,26ZZ00,309,0,2,2,eneheuvel,26-09-11
200826ZZ00313,2008,26ZZ00,313,1,0,1,eneheuvel,26-09-11
200826ZZ00402,2008,26ZZ00,402,1,0,1,eneheuvel,26-09-11
200826ZZ00502,2008,26ZZ00,502,3,2,5,eneheuvel,26-09-11
200826ZZ009999,2008,26ZZ00,9999,3,1,4,eneheuvel,26-09-11
200827AA00106,2008,27AA00,106,1,1,2,eneheuvel,26-09-11
200827AA00201,2008,27AA00,201,1,0,1,eneheuvel,26-09-11
200827AA00202,2008,27AA00,202,3,1,4,eneheuvel,26-09-11
200827AA00203,2008,27AA00,203,3,6,9,eneheuvel,26-09-11
200827AA00204,2008,27AA00,204,9,12,21,eneheuvel,26-09-11
200827AA00205,2008,27AA00,205,2,2,4,eneheuvel,26-09-11
200827AA00206,2008,27AA00,206,0,1,1,eneheuvel,26-09-11
200827AA00207,2008,27AA00,207,79,67,146,eneheuvel,26-09-11
200827AA00208,2008,27AA00,208,192,168,360,eneheuvel,26-09-11
200827AA00209,2008,27AA00,209,1,0,1,eneheuvel,26-09-11
200827AA00210,2008,27AA00,210,2,1,3,eneheuvel,26-09-11
200827AA00211,2008,27AA00,211,0,3,3,eneheuvel,26-09-11
200827AA00212,2008,27AA00,212,0,1,1,eneheuvel,26-09-11
200827AA00214,2008,27AA00,214,1,2,3,eneheuvel,26-09-11
200827AA00216,2008,27AA00,216,0,1,1,eneheuvel,26-09-11
200827AA00303,2008,27AA00,303,2,1,3,eneheuvel,26-09-11
200827AA00305,2008,27AA00,305,0,1,1,eneheuvel,26-09-11
200827AA00307,2008,27AA00,307,3,6,9,eneheuvel,26-09-11
200827AA00308,2008,27AA00,308,2,1,3,eneheuvel,26-09-11
200827AA00309,2008,27AA00,309,0,3,3,eneheuvel,26-09-11
200827AA00312,2008,27AA00,312,1,1,2,eneheuvel,26-09-11
200827AA009999,2008,27AA00,9999,3,1,4,eneheuvel,26-09-11
200827NU00103,2008,27NU00,103,1,0,1,eneheuvel,26-09-11
200827NU00104,2008,27NU00,104,1,0,1,eneheuvel,26-09-11
200827NU00108,2008,27NU00,108,1,0,1,eneheuvel,26-09-11
200827NU00201,2008,27NU00,201,1,0,1,eneheuvel,26-09-11
200827NU00202,2008,27NU00,202,2,0,2,eneheuvel,26-09-11
200827NU00203,2008,27NU00,203,5,5,10,eneheuvel,26-09-11
200827NU00204,2008,27NU00,204,3,3,6,eneheuvel,26-09-11
200827NU00205,2008,27NU00,205,3,0,3,eneheuvel,26-09-11
200827NU00206,2008,27NU00,206,1,0,1,eneheuvel,26-09-11
200827NU00207,2008,27NU00,207,22,13,35,eneheuvel,26-09-11
200827NU00208,2008,27NU00,208,146,131,277,eneheuvel,26-09-11
200827NU00209,2008,27NU00,209,1,0,1,eneheuvel,26-09-11
200827NU00210,2008,27NU00,210,0,1,1,eneheuvel,26-09-11
200827NU00211,2008,27NU00,211,1,0,1,eneheuvel,26-09-11
200827NU00302,2008,27NU00,302,2,0,2,eneheuvel,26-09-11
200827NU00305,2008,27NU00,305,0,1,1,eneheuvel,26-09-11
200827NU00311,2008,27NU00,311,0,1,1,eneheuvel,26-09-11
200827NU00312,2008,27NU00,312,1,2,3,eneheuvel,26-09-11
200827NU00502,2008,27NU00,502,0,2,2,eneheuvel,26-09-11
200827NU009999,2008,27NU00,9999,2,2,4,eneheuvel,26-09-11
200827UB00106,2008,27UB00,106,0,1,1,eneheuvel,26-09-11
200827UB00202,2008,27UB00,202,0,2,2,eneheuvel,26-09-11
200827UB00203,2008,27UB00,203,7,3,10,eneheuvel,26-09-11
200827UB00204,2008,27UB00,204,3,0,3,eneheuvel,26-09-11
200827UB00207,2008,27UB00,207,13,3,16,eneheuvel,26-09-11
200827UB00208,2008,27UB00,208,173,97,270,eneheuvel,26-09-11
200827UB00209,2008,27UB00,209,1,0,1,eneheuvel,26-09-11
200827UB00211,2008,27UB00,211,2,0,2,eneheuvel,26-09-11
200827UB00212,2008,27UB00,212,1,0,1,eneheuvel,26-09-11
200827UB00302,2008,27UB00,302,0,1,1,eneheuvel,26-09-11
200827UB00305,2008,27UB00,305,2,0,2,eneheuvel,26-09-11
200827UB00306,2008,27UB00,306,0,3,3,eneheuvel,26-09-11
200827UB00307,2008,27UB00,307,2,0,2,eneheuvel,26-09-11
200827UB00309,2008,27UB00,309,1,1,2,eneheuvel,26-09-11
200827UB00311,2008,27UB00,311,2,0,2,eneheuvel,26-09-11
200827UB00502,2008,27UB00,502,5,2,7,eneheuvel,26-09-11
200827UB009999,2008,27UB00,9999,1,1,2,eneheuvel,26-09-11
200827XH00201,2008,27XH00,201,0,1,1,eneheuvel,26-09-11
200827XH00202,2008,27XH00,202,2,0,2,eneheuvel,26-09-11
200827XH00203,2008,27XH00,203,1,0,1,eneheuvel,26-09-11
200827XH00206,2008,27XH00,206,1,5,6,eneheuvel,26-09-11
200827XH00207,2008,27XH00,207,0,1,1,eneheuvel,26-09-11
200827XH00208,2008,27XH00,208,1,0,1,eneheuvel,26-09-11
200827XH00209,2008,27XH00,209,3,1,4,eneheuvel,26-09-11
200827XH00210,2008,27XH00,210,7,5,12,eneheuvel,26-09-11
200827XH00212,2008,27XH00,212,2,3,5,eneheuvel,26-09-11
200827XH00213,2008,27XH00,213,0,1,1,eneheuvel,26-09-11
200827XH00214,2008,27XH00,214,7,2,9,eneheuvel,26-09-11
200827XH00215,2008,27XH00,215,14,32,46,eneheuvel,26-09-11
200827XH00216,2008,27XH00,216,100,67,167,eneheuvel,26-09-11
200827XH00311,2008,27XH00,311,1,0,1,eneheuvel,26-09-11
200827XJ00108,2008,27XJ00,108,1,0,1,eneheuvel,26-09-11
200827XJ00201,2008,27XJ00,201,1,0,1,eneheuvel,26-09-11
200827XJ00207,2008,27XJ00,207,1,0,1,eneheuvel,26-09-11
200827XJ00211,2008,27XJ00,211,1,0,1,eneheuvel,26-09-11
200827XJ00212,2008,27XJ00,212,0,1,1,eneheuvel,26-09-11
200827XJ00302,2008,27XJ00,302,17,2,19,eneheuvel,26-09-11
200827XJ00303,2008,27XJ00,303,6,1,7,eneheuvel,26-09-11
200827XJ00304,2008,27XJ00,304,1,0,1,eneheuvel,26-09-11
200827XJ00305,2008,27XJ00,305,0,1,1,eneheuvel,26-09-11
200827XJ00306,2008,27XJ00,306,1,2,3,eneheuvel,26-09-11
200827XJ00307,2008,27XJ00,307,0,1,1,eneheuvel,26-09-11
200827XJ00308,2008,27XJ00,308,2,2,4,eneheuvel,26-09-11
200827XJ00309,2008,27XJ00,309,4,1,5,eneheuvel,26-09-11
200827XJ00311,2008,27XJ00,311,22,3,25,eneheuvel,26-09-11
200827XJ00312,2008,27XJ00,312,142,63,205,eneheuvel,26-09-11
200827XJ00313,2008,27XJ00,313,36,10,46,eneheuvel,26-09-11
200827XJ00502,2008,27XJ00,502,1,2,3,eneheuvel,26-09-11
200827XJ009999,2008,27XJ00,9999,0,2,2,eneheuvel,26-09-11
200827YN00109,2008,27YN00,109,1,0,1,eneheuvel,26-09-11
200827YN00202,2008,27YN00,202,0,1,1,eneheuvel,26-09-11
200827YN00205,2008,27YN00,205,1,0,1,eneheuvel,26-09-11
200827YN00206,2008,27YN00,206,0,2,2,eneheuvel,26-09-11
200827YN00210,2008,27YN00,210,9,6,15,eneheuvel,26-09-11
200827YN00211,2008,27YN00,211,1,3,4,eneheuvel,26-09-11
200827YN00212,2008,27YN00,212,4,6,10,eneheuvel,26-09-11
200827YN00214,2008,27YN00,214,0,2,2,eneheuvel,26-09-11
200827YN00215,2008,27YN00,215,7,5,12,eneheuvel,26-09-11
200827YN00216,2008,27YN00,216,81,70,151,eneheuvel,26-09-11
200827YN00302,2008,27YN00,302,0,2,2,eneheuvel,26-09-11
200827YN00303,2008,27YN00,303,0,1,1,eneheuvel,26-09-11
200827YN00307,2008,27YN00,307,0,1,1,eneheuvel,26-09-11
200827YN00308,2008,27YN00,308,0,1,1,eneheuvel,26-09-11
200827YN00309,2008,27YN00,309,1,1,2,eneheuvel,26-09-11
200828AM00104,2008,28AM00,104,0,1,1,eneheuvel,26-09-11
200828AM00207,2008,28AM00,207,0,1,1,eneheuvel,26-09-11
200828AM00208,2008,28AM00,208,1,1,2,eneheuvel,26-09-11
200828AM00211,2008,28AM00,211,0,1,1,eneheuvel,26-09-11
200828AM00214,2008,28AM00,214,1,0,1,eneheuvel,26-09-11
200828AM00302,2008,28AM00,302,6,2,8,eneheuvel,26-09-11
200828AM00305,2008,28AM00,305,1,0,1,eneheuvel,26-09-11
200828AM00306,2008,28AM00,306,1,2,3,eneheuvel,26-09-11
200828AM00309,2008,28AM00,309,1,0,1,eneheuvel,26-09-11
200828AM00311,2008,28AM00,311,22,1,23,eneheuvel,26-09-11
200828AM00312,2008,28AM00,312,171,138,309,eneheuvel,26-09-11
200828AM00313,2008,28AM00,313,4,4,8,eneheuvel,26-09-11
200828AM009999,2008,28AM00,9999,1,0,1,eneheuvel,26-09-11
200828BR00108,2008,28BR00,108,0,1,1,eneheuvel,26-09-11
200828BR00203,2008,28BR00,203,0,1,1,eneheuvel,26-09-11
200828BR00207,2008,28BR00,207,0,1,1,eneheuvel,26-09-11
200828BR00208,2008,28BR00,208,1,1,2,eneheuvel,26-09-11
200828BR00211,2008,28BR00,211,0,1,1,eneheuvel,26-09-11
200828BR00212,2008,28BR00,212,1,5,6,eneheuvel,26-09-11
200828BR00213,2008,28BR00,213,1,0,1,eneheuvel,26-09-11
200828BR00301,2008,28BR00,301,1,2,3,eneheuvel,26-09-11
200828BR00302,2008,28BR00,302,8,3,11,eneheuvel,26-09-11
200828BR00303,2008,28BR00,303,0,3,3,eneheuvel,26-09-11
200828BR00305,2008,28BR00,305,0,1,1,eneheuvel,26-09-11
200828BR00306,2008,28BR00,306,2,0,2,eneheuvel,26-09-11
200828BR00307,2008,28BR00,307,1,0,1,eneheuvel,26-09-11
200828BR00309,2008,28BR00,309,1,2,3,eneheuvel,26-09-11
200828BR00311,2008,28BR00,311,13,17,30,eneheuvel,26-09-11
200828BR00312,2008,28BR00,312,2,1,3,eneheuvel,26-09-11
200828DJ00101,2008,28DJ00,101,2,0,2,eneheuvel,26-09-11
200828DJ00103,2008,28DJ00,103,0,2,2,eneheuvel,26-09-11
200828DJ00106,2008,28DJ00,106,1,1,2,eneheuvel,26-09-11
200828DJ00107,2008,28DJ00,107,2,0,2,eneheuvel,26-09-11
200828DJ00108,2008,28DJ00,108,1,1,2,eneheuvel,26-09-11
200828DJ00202,2008,28DJ00,202,4,0,4,eneheuvel,26-09-11
200828DJ00203,2008,28DJ00,203,6,4,10,eneheuvel,26-09-11
200828DJ00204,2008,28DJ00,204,1,3,4,eneheuvel,26-09-11
200828DJ00205,2008,28DJ00,205,2,2,4,eneheuvel,26-09-11
200828DJ00206,2008,28DJ00,206,1,1,2,eneheuvel,26-09-11
200828DJ00207,2008,28DJ00,207,15,9,24,eneheuvel,26-09-11
200828DJ00208,2008,28DJ00,208,12,10,22,eneheuvel,26-09-11
200828DJ00209,2008,28DJ00,209,0,1,1,eneheuvel,26-09-11
200828DJ00210,2008,28DJ00,210,2,1,3,eneheuvel,26-09-11
200828DJ00211,2008,28DJ00,211,4,2,6,eneheuvel,26-09-11
200828DJ00212,2008,28DJ00,212,5,4,9,eneheuvel,26-09-11
200828DJ00213,2008,28DJ00,213,2,2,4,eneheuvel,26-09-11
200828DJ00214,2008,28DJ00,214,2,1,3,eneheuvel,26-09-11
200828DJ00216,2008,28DJ00,216,2,0,2,eneheuvel,26-09-11
200828DJ00302,2008,28DJ00,302,6,0,6,eneheuvel,26-09-11
200828DJ00303,2008,28DJ00,303,3,3,6,eneheuvel,26-09-11
200828DJ00304,2008,28DJ00,304,2,1,3,eneheuvel,26-09-11
200828DJ00305,2008,28DJ00,305,5,9,14,eneheuvel,26-09-11
200828DJ00306,2008,28DJ00,306,5,3,8,eneheuvel,26-09-11
200828DJ00307,2008,28DJ00,307,5,5,10,eneheuvel,26-09-11
200828DJ00308,2008,28DJ00,308,6,5,11,eneheuvel,26-09-11
200829UB00102,2008,29UB00,102,1,0,1,eneheuvel,26-09-11
200829UB00107,2008,29UB00,107,1,2,3,eneheuvel,26-09-11
200829UB00207,2008,29UB00,207,0,1,1,eneheuvel,26-09-11
200829UB00208,2008,29UB00,208,1,0,1,eneheuvel,26-09-11
200829UB00211,2008,29UB00,211,1,4,5,eneheuvel,26-09-11
200829UB00212,2008,29UB00,212,4,6,10,eneheuvel,26-09-11
200829UB00214,2008,29UB00,214,15,22,37,eneheuvel,26-09-11
200829UB00311,2008,29UB00,311,0,1,1,eneheuvel,26-09-11
200829UB00402,2008,29UB00,402,1,0,1,eneheuvel,26-09-11
200829UB009999,2008,29UB00,9999,0,1,1,eneheuvel,26-09-11
200829UN00211,2008,29UN00,211,1,0,1,eneheuvel,26-09-11
200829UN00213,2008,29UN00,213,2,0,2,eneheuvel,26-09-11
200829UN00214,2008,29UN00,214,1,0,1,eneheuvel,26-09-11
200829UN00301,2008,29UN00,301,1,2,3,eneheuvel,26-09-11
200829UN00302,2008,29UN00,302,2,0,2,eneheuvel,26-09-11
200829UN00304,2008,29UN00,304,2,2,4,eneheuvel,26-09-11
200829UN00305,2008,29UN00,305,4,3,7,eneheuvel,26-09-11
200829UN00306,2008,29UN00,306,2,2,4,eneheuvel,26-09-11
200829UN00307,2008,29UN00,307,0,3,3,eneheuvel,26-09-11
200829UN00308,2008,29UN00,308,2,0,2,eneheuvel,26-09-11
200829UN00309,2008,29UN00,309,3,1,4,eneheuvel,26-09-11
200829UN00310,2008,29UN00,310,1,0,1,eneheuvel,26-09-11
200829UN00311,2008,29UN00,311,2,3,5,eneheuvel,26-09-11
200829UN00312,2008,29UN00,312,0,2,2,eneheuvel,26-09-11
200829XX00203,2008,29XX00,203,1,1,2,eneheuvel,26-09-11
200829XX00206,2008,29XX00,206,0,1,1,eneheuvel,26-09-11
200829XX00207,2008,29XX00,207,2,3,5,eneheuvel,26-09-11
200829XX00208,2008,29XX00,208,1,1,2,eneheuvel,26-09-11
200829XX00210,2008,29XX00,210,3,2,5,eneheuvel,26-09-11
200829XX00212,2008,29XX00,212,5,0,5,eneheuvel,26-09-11
200829XX00213,2008,29XX00,213,1,1,2,eneheuvel,26-09-11
200829XX00214,2008,29XX00,214,4,5,9,eneheuvel,26-09-11
200829XX00216,2008,29XX00,216,1,0,1,eneheuvel,26-09-11
200829XX00302,2008,29XX00,302,3,2,5,eneheuvel,26-09-11
200829XX00303,2008,29XX00,303,0,1,1,eneheuvel,26-09-11
200829XX00305,2008,29XX00,305,1,0,1,eneheuvel,26-09-11
200829XX00307,2008,29XX00,307,1,1,2,eneheuvel,26-09-11
200829XX00311,2008,29XX00,311,5,4,9,eneheuvel,26-09-11
200829XX00313,2008,29XX00,313,1,0,1,eneheuvel,26-09-11
200906RM00102,2009,06RM00,102,1,3,4,eneheuvel,26-09-11
200906RM00103,2009,06RM00,103,4,1,5,eneheuvel,26-09-11
200906RM00104,2009,06RM00,104,0,2,2,eneheuvel,26-09-11
200906RM00105,2009,06RM00,105,0,1,1,eneheuvel,26-09-11
200906RM00106,2009,06RM00,106,0,2,2,eneheuvel,26-09-11
200906RM00107,2009,06RM00,107,1,0,1,eneheuvel,26-09-11
200906RM00201,2009,06RM00,201,1,0,1,eneheuvel,26-09-11
200906RM00202,2009,06RM00,202,10,6,16,eneheuvel,26-09-11
200906RM00204,2009,06RM00,204,4,4,8,eneheuvel,26-09-11
200906RM00205,2009,06RM00,205,0,1,1,eneheuvel,26-09-11
200906RM00206,2009,06RM00,206,1,5,6,eneheuvel,26-09-11
200906RM00207,2009,06RM00,207,3,1,4,eneheuvel,26-09-11
200906RM00208,2009,06RM00,208,1,0,1,eneheuvel,26-09-11
200906RM00209,2009,06RM00,209,1,0,1,eneheuvel,26-09-11
200906RM00210,2009,06RM00,210,6,10,16,eneheuvel,26-09-11
200906RM00211,2009,06RM00,211,3,9,12,eneheuvel,26-09-11
200906RM00212,2009,06RM00,212,16,39,55,eneheuvel,26-09-11
200906RM00213,2009,06RM00,213,2,8,10,eneheuvel,26-09-11
200906RM00214,2009,06RM00,214,11,14,25,eneheuvel,26-09-11
200906RM00215,2009,06RM00,215,1,3,4,eneheuvel,26-09-11
200906RM00216,2009,06RM00,216,6,6,12,eneheuvel,26-09-11
200906RM00302,2009,06RM00,302,4,4,8,eneheuvel,26-09-11
200906RM00303,2009,06RM00,303,4,1,5,eneheuvel,26-09-11
200906RM00304,2009,06RM00,304,1,2,3,eneheuvel,26-09-11
200906RM00305,2009,06RM00,305,1,0,1,eneheuvel,26-09-11
200906RM00307,2009,06RM00,307,1,0,1,eneheuvel,26-09-11
200906RM00308,2009,06RM00,308,2,0,2,eneheuvel,26-09-11
200906RM00309,2009,06RM00,309,0,3,3,eneheuvel,26-09-11
200906RM00311,2009,06RM00,311,5,0,5,eneheuvel,26-09-11
200906RM00312,2009,06RM00,312,3,4,7,eneheuvel,26-09-11
200906RM00402,2009,06RM00,402,0,1,1,eneheuvel,26-09-11
200906RM00502,2009,06RM00,502,0,4,4,eneheuvel,26-09-11
200906RM009999,2009,06RM00,9999,8,13,21,eneheuvel,26-09-11
200912HU00102,2009,12HU00,102,1,0,1,eneheuvel,26-09-11
200912HU00103,2009,12HU00,103,1,2,3,eneheuvel,26-09-11
200912HU00201,2009,12HU00,201,3,5,8,eneheuvel,26-09-11
200912HU00202,2009,12HU00,202,1,1,2,eneheuvel,26-09-11
200912HU00209,2009,12HU00,209,5,1,6,eneheuvel,26-09-11
200912HU00210,2009,12HU00,210,1,3,4,eneheuvel,26-09-11
200912HU00211,2009,12HU00,211,41,42,83,eneheuvel,26-09-11
200912HU00212,2009,12HU00,212,0,1,1,eneheuvel,26-09-11
200912HU00213,2009,12HU00,213,0,1,1,eneheuvel,26-09-11
200912HU00303,2009,12HU00,303,1,0,1,eneheuvel,26-09-11
200912HU00401,2009,12HU00,401,1,1,2,eneheuvel,26-09-11
200912HU009999,2009,12HU00,9999,1,2,3,eneheuvel,26-09-11
200912PM00101,2009,12PM00,101,7,6,13,eneheuvel,26-09-11
200912PM00102,2009,12PM00,102,11,5,16,eneheuvel,26-09-11
200912PM00103,2009,12PM00,103,32,39,71,eneheuvel,26-09-11
200912PM00104,2009,12PM00,104,2,2,4,eneheuvel,26-09-11
200912PM00106,2009,12PM00,106,3,5,8,eneheuvel,26-09-11
200912PM00107,2009,12PM00,107,20,18,38,eneheuvel,26-09-11
200912PM00108,2009,12PM00,108,22,12,34,eneheuvel,26-09-11
200912PM00109,2009,12PM00,109,8,11,19,eneheuvel,26-09-11
200912PM00206,2009,12PM00,206,1,0,1,eneheuvel,26-09-11
200912PM00211,2009,12PM00,211,1,0,1,eneheuvel,26-09-11
200912PM00212,2009,12PM00,212,0,1,1,eneheuvel,26-09-11
200912PM00216,2009,12PM00,216,0,2,2,eneheuvel,26-09-11
200912PM00303,2009,12PM00,303,1,1,2,eneheuvel,26-09-11
200912PM00304,2009,12PM00,304,0,1,1,eneheuvel,26-09-11
200912PM00311,2009,12PM00,311,1,2,3,eneheuvel,26-09-11
200912PM009999,2009,12PM00,9999,2,1,3,eneheuvel,26-09-11
200912QK00201,2009,12QK00,201,0,1,1,eneheuvel,26-09-11
200912QK00202,2009,12QK00,202,1,0,1,eneheuvel,26-09-11
200912QK00203,2009,12QK00,203,1,0,1,eneheuvel,26-09-11
200912QK00206,2009,12QK00,206,101,94,195,eneheuvel,26-09-11
200912QK00207,2009,12QK00,207,1,3,4,eneheuvel,26-09-11
200912QK00208,2009,12QK00,208,1,1,2,eneheuvel,26-09-11
200912QK00209,2009,12QK00,209,5,3,8,eneheuvel,26-09-11
200912QK00210,2009,12QK00,210,11,8,19,eneheuvel,26-09-11
200912QK00211,2009,12QK00,211,0,2,2,eneheuvel,26-09-11
200912QK00212,2009,12QK00,212,1,0,1,eneheuvel,26-09-11
200912QK00213,2009,12QK00,213,0,1,1,eneheuvel,26-09-11
200912QK00214,2009,12QK00,214,1,0,1,eneheuvel,26-09-11
200912QK00215,2009,12QK00,215,1,3,4,eneheuvel,26-09-11
200912QK00216,2009,12QK00,216,1,0,1,eneheuvel,26-09-11
200912QK00301,2009,12QK00,301,1,0,1,eneheuvel,26-09-11
200912QK00302,2009,12QK00,302,0,1,1,eneheuvel,26-09-11
200912QK00303,2009,12QK00,303,1,0,1,eneheuvel,26-09-11
200912QK00306,2009,12QK00,306,1,0,1,eneheuvel,26-09-11
200912QK00312,2009,12QK00,312,0,1,1,eneheuvel,26-09-11
200912QK009999,2009,12QK00,9999,0,1,1,eneheuvel,26-09-11
200912XA00208,2009,12XA00,208,0,1,1,eneheuvel,26-09-11
200912XA00211,2009,12XA00,211,40,59,99,eneheuvel,26-09-11
200912XA00212,2009,12XA00,212,1,0,1,eneheuvel,26-09-11
200912XA00213,2009,12XA00,213,0,2,2,eneheuvel,26-09-11
200912XA00214,2009,12XA00,214,1,0,1,eneheuvel,26-09-11
200912XA00303,2009,12XA00,303,2,0,2,eneheuvel,26-09-11
200913CW00106,2009,13CW00,106,1,0,1,eneheuvel,26-09-11
200913CW00201,2009,13CW00,201,2,3,5,eneheuvel,26-09-11
200913CW00202,2009,13CW00,202,1,0,1,eneheuvel,26-09-11
200913CW00203,2009,13CW00,203,0,1,1,eneheuvel,26-09-11
200913CW00205,2009,13CW00,205,1,1,2,eneheuvel,26-09-11
200913CW00206,2009,13CW00,206,61,70,131,eneheuvel,26-09-11
200913CW00207,2009,13CW00,207,1,3,4,eneheuvel,26-09-11
200913CW00208,2009,13CW00,208,0,2,2,eneheuvel,26-09-11
200913CW00209,2009,13CW00,209,14,6,20,eneheuvel,26-09-11
200913CW00210,2009,13CW00,210,7,4,11,eneheuvel,26-09-11
200913CW00211,2009,13CW00,211,0,1,1,eneheuvel,26-09-11
200913CW00212,2009,13CW00,212,2,0,2,eneheuvel,26-09-11
200913CW00214,2009,13CW00,214,1,0,1,eneheuvel,26-09-11
200913CW00215,2009,13CW00,215,0,4,4,eneheuvel,26-09-11
200913CW00216,2009,13CW00,216,0,1,1,eneheuvel,26-09-11
200913CW00306,2009,13CW00,306,1,0,1,eneheuvel,26-09-11
200913CW00308,2009,13CW00,308,2,1,3,eneheuvel,26-09-11
200913CW009999,2009,13CW00,9999,3,1,4,eneheuvel,26-09-11
200913IF00105,2009,13IF00,105,0,1,1,eneheuvel,26-09-11
200913IF00201,2009,13IF00,201,1,0,1,eneheuvel,26-09-11
200913IF00207,2009,13IF00,207,0,3,3,eneheuvel,26-09-11
200913IF00208,2009,13IF00,208,3,0,3,eneheuvel,26-09-11
200913IF00214,2009,13IF00,214,0,2,2,eneheuvel,26-09-11
200913IF00301,2009,13IF00,301,7,7,14,eneheuvel,26-09-11
200913IF00302,2009,13IF00,302,1,1,2,eneheuvel,26-09-11
200913IF00303,2009,13IF00,303,8,13,21,eneheuvel,26-09-11
200913IF00304,2009,13IF00,304,30,33,63,eneheuvel,26-09-11
200913IF00305,2009,13IF00,305,6,3,9,eneheuvel,26-09-11
200913IF00306,2009,13IF00,306,8,11,19,eneheuvel,26-09-11
200913IF00307,2009,13IF00,307,3,2,5,eneheuvel,26-09-11
200913IF00308,2009,13IF00,308,3,2,5,eneheuvel,26-09-11
200913IF00309,2009,13IF00,309,2,0,2,eneheuvel,26-09-11
200913IF00310,2009,13IF00,310,2,0,2,eneheuvel,26-09-11
200913IF00401,2009,13IF00,401,0,1,1,eneheuvel,26-09-11
200913IU00101,2009,13IU00,101,0,1,1,eneheuvel,26-09-11
200913IU00102,2009,13IU00,102,11,8,19,eneheuvel,26-09-11
200913IU00103,2009,13IU00,103,9,4,13,eneheuvel,26-09-11
200913IU00104,2009,13IU00,104,3,2,5,eneheuvel,26-09-11
200913IU00105,2009,13IU00,105,3,5,8,eneheuvel,26-09-11
200913IU00106,2009,13IU00,106,56,35,91,eneheuvel,26-09-11
200913IU00107,2009,13IU00,107,7,4,11,eneheuvel,26-09-11
200913IU00108,2009,13IU00,108,1,3,4,eneheuvel,26-09-11
200913IU00109,2009,13IU00,109,3,1,4,eneheuvel,26-09-11
200913IU00110,2009,13IU00,110,1,0,1,eneheuvel,26-09-11
200913IU00202,2009,13IU00,202,1,0,1,eneheuvel,26-09-11
200913IU00211,2009,13IU00,211,0,1,1,eneheuvel,26-09-11
200913IU00212,2009,13IU00,212,0,2,2,eneheuvel,26-09-11
200913IU00311,2009,13IU00,311,1,0,1,eneheuvel,26-09-11
200913IU009999,2009,13IU00,9999,1,0,1,eneheuvel,26-09-11
200913NH00101,2009,13NH00,101,2,2,4,eneheuvel,26-09-11
200913NH00102,2009,13NH00,102,10,9,19,eneheuvel,26-09-11
200913NH00103,2009,13NH00,103,3,2,5,eneheuvel,26-09-11
200913NH00104,2009,13NH00,104,27,18,45,eneheuvel,26-09-11
200913NH00105,2009,13NH00,105,66,68,134,eneheuvel,26-09-11
200913NH00106,2009,13NH00,106,10,11,21,eneheuvel,26-09-11
200913NH00107,2009,13NH00,107,2,1,3,eneheuvel,26-09-11
200913NH00109,2009,13NH00,109,2,0,2,eneheuvel,26-09-11
200913NH00110,2009,13NH00,110,18,12,30,eneheuvel,26-09-11
200913NH00203,2009,13NH00,203,1,0,1,eneheuvel,26-09-11
200913NH00308,2009,13NH00,308,1,0,1,eneheuvel,26-09-11
200913NH00502,2009,13NH00,502,1,2,3,eneheuvel,26-09-11
200913NH009999,2009,13NH00,9999,0,1,1,eneheuvel,26-09-11
200913NU00206,2009,13NU00,206,1,0,1,eneheuvel,26-09-11
200913NU00211,2009,13NU00,211,1,1,2,eneheuvel,26-09-11
200913NU00216,2009,13NU00,216,0,1,1,eneheuvel,26-09-11
200913NU00301,2009,13NU00,301,12,8,20,eneheuvel,26-09-11
200913NU00302,2009,13NU00,302,4,1,5,eneheuvel,26-09-11
200913NU00303,2009,13NU00,303,29,38,67,eneheuvel,26-09-11
200913NU00304,2009,13NU00,304,65,52,117,eneheuvel,26-09-11
200913NU00305,2009,13NU00,305,24,18,42,eneheuvel,26-09-11
200913NU00306,2009,13NU00,306,14,24,38,eneheuvel,26-09-11
200913NU00307,2009,13NU00,307,2,1,3,eneheuvel,26-09-11
200913NU00308,2009,13NU00,308,5,3,8,eneheuvel,26-09-11
200913NU00309,2009,13NU00,309,1,1,2,eneheuvel,26-09-11
200913NU00310,2009,13NU00,310,1,0,1,eneheuvel,26-09-11
200913NU00311,2009,13NU00,311,0,1,1,eneheuvel,26-09-11
200913NU00312,2009,13NU00,312,0,1,1,eneheuvel,26-09-11
200913NU009999,2009,13NU00,9999,1,1,2,eneheuvel,26-09-11
200914QC00108,2009,14QC00,108,1,0,1,eneheuvel,26-09-11
200914QC00109,2009,14QC00,109,2,3,5,eneheuvel,26-09-11
200914QC00110,2009,14QC00,110,1,0,1,eneheuvel,26-09-11
200914QC00201,2009,14QC00,201,3,0,3,eneheuvel,26-09-11
200914QC00202,2009,14QC00,202,53,48,101,eneheuvel,26-09-11
200914QC00203,2009,14QC00,203,39,45,84,eneheuvel,26-09-11
200914QC00204,2009,14QC00,204,25,27,52,eneheuvel,26-09-11
200914QC00205,2009,14QC00,205,19,14,33,eneheuvel,26-09-11
200914QC00206,2009,14QC00,206,25,10,35,eneheuvel,26-09-11
200914QC00207,2009,14QC00,207,10,5,15,eneheuvel,26-09-11
200914QC00208,2009,14QC00,208,27,21,48,eneheuvel,26-09-11
200914QC00209,2009,14QC00,209,3,0,3,eneheuvel,26-09-11
200914QC00210,2009,14QC00,210,10,7,17,eneheuvel,26-09-11
200914QC00211,2009,14QC00,211,11,4,15,eneheuvel,26-09-11
200914QC00212,2009,14QC00,212,2,3,5,eneheuvel,26-09-11
200914QC00213,2009,14QC00,213,2,3,5,eneheuvel,26-09-11
200914QC00214,2009,14QC00,214,3,3,6,eneheuvel,26-09-11
200914QC00215,2009,14QC00,215,1,3,4,eneheuvel,26-09-11
200914QC00216,2009,14QC00,216,3,1,4,eneheuvel,26-09-11
200914QC00302,2009,14QC00,302,3,5,8,eneheuvel,26-09-11
200914QC00303,2009,14QC00,303,16,4,20,eneheuvel,26-09-11
200914QC00304,2009,14QC00,304,2,2,4,eneheuvel,26-09-11
200914QC00306,2009,14QC00,306,1,0,1,eneheuvel,26-09-11
200914QC00307,2009,14QC00,307,4,1,5,eneheuvel,26-09-11
200914QC00309,2009,14QC00,309,0,1,1,eneheuvel,26-09-11
200914QC00311,2009,14QC00,311,8,3,11,eneheuvel,26-09-11
200914QC00312,2009,14QC00,312,5,3,8,eneheuvel,26-09-11
200914QC00313,2009,14QC00,313,0,1,1,eneheuvel,26-09-11
200914QC00502,2009,14QC00,502,16,15,31,eneheuvel,26-09-11
200914QC009999,2009,14QC00,9999,3,1,4,eneheuvel,26-09-11
200914QC02202,2009,14QC02,202,0,1,1,eneheuvel,26-09-11
200914QC02209,2009,14QC02,209,1,1,2,eneheuvel,26-09-11
200914QC02210,2009,14QC02,210,0,2,2,eneheuvel,26-09-11
200914QC02212,2009,14QC02,212,16,23,39,eneheuvel,26-09-11
200914QC02213,2009,14QC02,213,5,5,10,eneheuvel,26-09-11
200914QC02214,2009,14QC02,214,5,3,8,eneheuvel,26-09-11
200914QC02216,2009,14QC02,216,2,1,3,eneheuvel,26-09-11
200915SJ00101,2009,15SJ00,101,0,3,3,eneheuvel,26-09-11
200915SJ00102,2009,15SJ00,102,2,6,8,eneheuvel,26-09-11
200915SJ00103,2009,15SJ00,103,1,5,6,eneheuvel,26-09-11
200915SJ00104,2009,15SJ00,104,2,5,7,eneheuvel,26-09-11
200915SJ00105,2009,15SJ00,105,2,1,3,eneheuvel,26-09-11
200915SJ00106,2009,15SJ00,106,1,3,4,eneheuvel,26-09-11
200915SJ00108,2009,15SJ00,108,1,7,8,eneheuvel,26-09-11
200915SJ00201,2009,15SJ00,201,1,3,4,eneheuvel,26-09-11
200915SJ00202,2009,15SJ00,202,2,12,14,eneheuvel,26-09-11
200915SJ00203,2009,15SJ00,203,1,6,7,eneheuvel,26-09-11
200915SJ00204,2009,15SJ00,204,0,6,6,eneheuvel,26-09-11
200915SJ00205,2009,15SJ00,205,2,8,10,eneheuvel,26-09-11
200915SJ00206,2009,15SJ00,206,3,14,17,eneheuvel,26-09-11
200915SJ00207,2009,15SJ00,207,2,19,21,eneheuvel,26-09-11
200915SJ00208,2009,15SJ00,208,2,10,12,eneheuvel,26-09-11
200915SJ00209,2009,15SJ00,209,1,12,13,eneheuvel,26-09-11
200915SJ00210,2009,15SJ00,210,6,21,27,eneheuvel,26-09-11
200915SJ00211,2009,15SJ00,211,5,23,28,eneheuvel,26-09-11
200915SJ00212,2009,15SJ00,212,2,11,13,eneheuvel,26-09-11
200915SJ00213,2009,15SJ00,213,2,5,7,eneheuvel,26-09-11
200915SJ00214,2009,15SJ00,214,1,9,10,eneheuvel,26-09-11
200915SJ00216,2009,15SJ00,216,1,2,3,eneheuvel,26-09-11
200915SJ00301,2009,15SJ00,301,1,5,6,eneheuvel,26-09-11
200915SJ00302,2009,15SJ00,302,2,7,9,eneheuvel,26-09-11
200915SJ00303,2009,15SJ00,303,2,7,9,eneheuvel,26-09-11
200915SJ00304,2009,15SJ00,304,4,4,8,eneheuvel,26-09-11
200915SJ00305,2009,15SJ00,305,0,6,6,eneheuvel,26-09-11
200915SJ00306,2009,15SJ00,306,1,8,9,eneheuvel,26-09-11
200915SJ00307,2009,15SJ00,307,2,5,7,eneheuvel,26-09-11
200915SJ00308,2009,15SJ00,308,1,7,8,eneheuvel,26-09-11
200915SJ00309,2009,15SJ00,309,4,7,11,eneheuvel,26-09-11
200915SJ00311,2009,15SJ00,311,4,2,6,eneheuvel,26-09-11
200915SJ00312,2009,15SJ00,312,0,1,1,eneheuvel,26-09-11
200915SJ00313,2009,15SJ00,313,0,1,1,eneheuvel,26-09-11
200915SJ00401,2009,15SJ00,401,0,2,2,eneheuvel,26-09-11
200915SJ009999,2009,15SJ00,9999,0,1,1,eneheuvel,26-09-11
200915ZL00203,2009,15ZL00,203,0,1,1,eneheuvel,26-09-11
200915ZL00204,2009,15ZL00,204,0,3,3,eneheuvel,26-09-11
200915ZL00205,2009,15ZL00,205,0,1,1,eneheuvel,26-09-11
200915ZL00206,2009,15ZL00,206,1,0,1,eneheuvel,26-09-11
200915ZL00208,2009,15ZL00,208,4,4,8,eneheuvel,26-09-11
200915ZL00214,2009,15ZL00,214,1,2,3,eneheuvel,26-09-11
200915ZL00216,2009,15ZL00,216,1,0,1,eneheuvel,26-09-11
200915ZL00302,2009,15ZL00,302,4,2,6,eneheuvel,26-09-11
200915ZL00303,2009,15ZL00,303,2,4,6,eneheuvel,26-09-11
200915ZL00304,2009,15ZL00,304,0,2,2,eneheuvel,26-09-11
200915ZL00305,2009,15ZL00,305,45,51,96,eneheuvel,26-09-11
200915ZL00306,2009,15ZL00,306,3,9,12,eneheuvel,26-09-11
200915ZL00307,2009,15ZL00,307,2,7,9,eneheuvel,26-09-11
200915ZL00308,2009,15ZL00,308,3,5,8,eneheuvel,26-09-11
200915ZL00309,2009,15ZL00,309,7,6,13,eneheuvel,26-09-11
200915ZL00311,2009,15ZL00,311,6,1,7,eneheuvel,26-09-11
200915ZL00312,2009,15ZL00,312,1,2,3,eneheuvel,26-09-11
200915ZL00313,2009,15ZL00,313,0,1,1,eneheuvel,26-09-11
200915ZL00502,2009,15ZL00,502,0,2,2,eneheuvel,26-09-11
200915ZL009999,2009,15ZL00,9999,0,2,2,eneheuvel,26-09-11
200915ZL01206,2009,15ZL01,206,1,3,4,eneheuvel,26-09-11
200915ZL01207,2009,15ZL01,207,2,0,2,eneheuvel,26-09-11
200915ZL01209,2009,15ZL01,209,5,9,14,eneheuvel,26-09-11
200915ZL01210,2009,15ZL01,210,71,61,132,eneheuvel,26-09-11
200915ZL01211,2009,15ZL01,211,1,0,1,eneheuvel,26-09-11
200915ZL01212,2009,15ZL01,212,1,1,2,eneheuvel,26-09-11
200915ZL01215,2009,15ZL01,215,1,3,4,eneheuvel,26-09-11
200915ZL01216,2009,15ZL01,216,1,4,5,eneheuvel,26-09-11
200915ZL01307,2009,15ZL01,307,0,1,1,eneheuvel,26-09-11
200915ZL01308,2009,15ZL01,308,1,0,1,eneheuvel,26-09-11
200915ZL01309,2009,15ZL01,309,0,2,2,eneheuvel,26-09-11
200915ZL019999,2009,15ZL01,9999,1,1,2,eneheuvel,26-09-11
200916KK00101,2009,16KK00,101,14,11,25,eneheuvel,26-09-11
200916KK00102,2009,16KK00,102,32,37,69,eneheuvel,26-09-11
200916KK00103,2009,16KK00,103,63,57,120,eneheuvel,26-09-11
200916KK00104,2009,16KK00,104,4,0,4,eneheuvel,26-09-11
200916KK00105,2009,16KK00,105,0,2,2,eneheuvel,26-09-11
200916KK00106,2009,16KK00,106,6,5,11,eneheuvel,26-09-11
200916KK00107,2009,16KK00,107,9,9,18,eneheuvel,26-09-11
200916KK00108,2009,16KK00,108,20,24,44,eneheuvel,26-09-11
200916KK00109,2009,16KK00,109,13,13,26,eneheuvel,26-09-11
200916KK00110,2009,16KK00,110,1,0,1,eneheuvel,26-09-11
200916KK00201,2009,16KK00,201,0,1,1,eneheuvel,26-09-11
200916KK00202,2009,16KK00,202,2,2,4,eneheuvel,26-09-11
200916KK00205,2009,16KK00,205,0,1,1,eneheuvel,26-09-11
200916KK00206,2009,16KK00,206,2,1,3,eneheuvel,26-09-11
200916KK00207,2009,16KK00,207,0,3,3,eneheuvel,26-09-11
200916KK00208,2009,16KK00,208,1,0,1,eneheuvel,26-09-11
200916KK00210,2009,16KK00,210,1,1,2,eneheuvel,26-09-11
200916KK00211,2009,16KK00,211,2,2,4,eneheuvel,26-09-11
200916KK00212,2009,16KK00,212,0,1,1,eneheuvel,26-09-11
200916KK00213,2009,16KK00,213,3,1,4,eneheuvel,26-09-11
200916KK00214,2009,16KK00,214,0,3,3,eneheuvel,26-09-11
200916KK00303,2009,16KK00,303,1,0,1,eneheuvel,26-09-11
200916KK00304,2009,16KK00,304,0,1,1,eneheuvel,26-09-11
200916KK00305,2009,16KK00,305,0,1,1,eneheuvel,26-09-11
200916KK00308,2009,16KK00,308,0,1,1,eneheuvel,26-09-11
200916KK00311,2009,16KK00,311,0,1,1,eneheuvel,26-09-11
200916KK00502,2009,16KK00,502,2,0,2,eneheuvel,26-09-11
200916KK009999,2009,16KK00,9999,1,2,3,eneheuvel,26-09-11
200916LJ00101,2009,16LJ00,101,2,4,6,eneheuvel,26-09-11
200916LJ00102,2009,16LJ00,102,6,5,11,eneheuvel,26-09-11
200916LJ00103,2009,16LJ00,103,1,0,1,eneheuvel,26-09-11
200916LJ00104,2009,16LJ00,104,2,0,2,eneheuvel,26-09-11
200916LJ00105,2009,16LJ00,105,0,1,1,eneheuvel,26-09-11
200916LJ00106,2009,16LJ00,106,48,43,91,eneheuvel,26-09-11
200916LJ00107,2009,16LJ00,107,1,3,4,eneheuvel,26-09-11
200916LJ00108,2009,16LJ00,108,1,5,6,eneheuvel,26-09-11
200916LJ00203,2009,16LJ00,203,2,1,3,eneheuvel,26-09-11
200916LJ00208,2009,16LJ00,208,1,0,1,eneheuvel,26-09-11
200916LJ00210,2009,16LJ00,210,0,1,1,eneheuvel,26-09-11
200916LJ00306,2009,16LJ00,306,1,0,1,eneheuvel,26-09-11
200916LJ009999,2009,16LJ00,9999,0,2,2,eneheuvel,26-09-11
200916ML00101,2009,16ML00,101,2,8,10,eneheuvel,26-09-11
200916ML00102,2009,16ML00,102,24,26,50,eneheuvel,26-09-11
200916ML00103,2009,16ML00,103,5,3,8,eneheuvel,26-09-11
200916ML00104,2009,16ML00,104,55,48,103,eneheuvel,26-09-11
200916ML00105,2009,16ML00,105,19,25,44,eneheuvel,26-09-11
200916ML00106,2009,16ML00,106,2,2,4,eneheuvel,26-09-11
200916ML00107,2009,16ML00,107,3,8,11,eneheuvel,26-09-11
200916ML00108,2009,16ML00,108,2,3,5,eneheuvel,26-09-11
200916ML00109,2009,16ML00,109,4,4,8,eneheuvel,26-09-11
200916ML00110,2009,16ML00,110,1,6,7,eneheuvel,26-09-11
200916ML00201,2009,16ML00,201,0,1,1,eneheuvel,26-09-11
200916ML00202,2009,16ML00,202,1,0,1,eneheuvel,26-09-11
200916ML00203,2009,16ML00,203,0,3,3,eneheuvel,26-09-11
200916ML00205,2009,16ML00,205,0,3,3,eneheuvel,26-09-11
200916ML00209,2009,16ML00,209,0,1,1,eneheuvel,26-09-11
200916ML00210,2009,16ML00,210,0,1,1,eneheuvel,26-09-11
200916ML00211,2009,16ML00,211,0,1,1,eneheuvel,26-09-11
200916ML00212,2009,16ML00,212,1,2,3,eneheuvel,26-09-11
200916ML00213,2009,16ML00,213,0,1,1,eneheuvel,26-09-11
200916ML00214,2009,16ML00,214,0,2,2,eneheuvel,26-09-11
200916ML00303,2009,16ML00,303,1,2,3,eneheuvel,26-09-11
200916ML00306,2009,16ML00,306,0,1,1,eneheuvel,26-09-11
200916ML00307,2009,16ML00,307,1,0,1,eneheuvel,26-09-11
200916ML00311,2009,16ML00,311,1,1,2,eneheuvel,26-09-11
200916ML00502,2009,16ML00,502,2,2,4,eneheuvel,26-09-11
200916ML009999,2009,16ML00,9999,1,2,3,eneheuvel,26-09-11
200916OC00101,2009,16OC00,101,2,2,4,eneheuvel,26-09-11
200916OC00102,2009,16OC00,102,2,0,2,eneheuvel,26-09-11
200916OC00103,2009,16OC00,103,7,9,16,eneheuvel,26-09-11
200916OC00104,2009,16OC00,104,0,2,2,eneheuvel,26-09-11
200916OC00105,2009,16OC00,105,1,1,2,eneheuvel,26-09-11
200916OC00106,2009,16OC00,106,0,2,2,eneheuvel,26-09-11
200916OC00107,2009,16OC00,107,72,81,153,eneheuvel,26-09-11
200916OC00108,2009,16OC00,108,24,23,47,eneheuvel,26-09-11
200916OC00109,2009,16OC00,109,42,54,96,eneheuvel,26-09-11
200916OC00201,2009,16OC00,201,1,2,3,eneheuvel,26-09-11
200916OC00202,2009,16OC00,202,3,1,4,eneheuvel,26-09-11
200916OC00203,2009,16OC00,203,0,3,3,eneheuvel,26-09-11
200916OC00204,2009,16OC00,204,1,0,1,eneheuvel,26-09-11
200916OC00205,2009,16OC00,205,1,1,2,eneheuvel,26-09-11
200916OC00206,2009,16OC00,206,1,2,3,eneheuvel,26-09-11
200916OC00207,2009,16OC00,207,1,2,3,eneheuvel,26-09-11
200916OC00208,2009,16OC00,208,5,6,11,eneheuvel,26-09-11
200916OC00210,2009,16OC00,210,1,1,2,eneheuvel,26-09-11
200916OC00211,2009,16OC00,211,2,4,6,eneheuvel,26-09-11
200916OC00212,2009,16OC00,212,1,1,2,eneheuvel,26-09-11
200916OC00213,2009,16OC00,213,1,4,5,eneheuvel,26-09-11
200916OC00214,2009,16OC00,214,7,10,17,eneheuvel,26-09-11
200916OC00301,2009,16OC00,301,2,0,2,eneheuvel,26-09-11
200916OC00302,2009,16OC00,302,4,1,5,eneheuvel,26-09-11
200916OC00303,2009,16OC00,303,2,3,5,eneheuvel,26-09-11
200916OC00304,2009,16OC00,304,2,2,4,eneheuvel,26-09-11
200916OC00305,2009,16OC00,305,2,0,2,eneheuvel,26-09-11
200916OC00306,2009,16OC00,306,1,1,2,eneheuvel,26-09-11
200916OC00308,2009,16OC00,308,2,0,2,eneheuvel,26-09-11
200916OC00309,2009,16OC00,309,10,1,11,eneheuvel,26-09-11
200916OC00311,2009,16OC00,311,1,1,2,eneheuvel,26-09-11
200916OC00312,2009,16OC00,312,1,2,3,eneheuvel,26-09-11
200916OC00313,2009,16OC00,313,1,1,2,eneheuvel,26-09-11
200916OC00401,2009,16OC00,401,0,2,2,eneheuvel,26-09-11
200916OC00502,2009,16OC00,502,2,0,2,eneheuvel,26-09-11
200916OC009999,2009,16OC00,9999,3,2,5,eneheuvel,26-09-11
200916UK00102,2009,16UK00,102,2,1,3,eneheuvel,26-09-11
200916UK00103,2009,16UK00,103,4,6,10,eneheuvel,26-09-11
200916UK00107,2009,16UK00,107,1,2,3,eneheuvel,26-09-11
200916UK00108,2009,16UK00,108,70,65,135,eneheuvel,26-09-11
200916UK00109,2009,16UK00,109,0,1,1,eneheuvel,26-09-11
200916UK00204,2009,16UK00,204,1,0,1,eneheuvel,26-09-11
200916UK00212,2009,16UK00,212,0,1,1,eneheuvel,26-09-11
200916UK00214,2009,16UK00,214,1,0,1,eneheuvel,26-09-11
200916WV00108,2009,16WV00,108,1,0,1,eneheuvel,26-09-11
200916WV00201,2009,16WV00,201,6,1,7,eneheuvel,26-09-11
200916WV00202,2009,16WV00,202,0,1,1,eneheuvel,26-09-11
200916WV00207,2009,16WV00,207,0,1,1,eneheuvel,26-09-11
200916WV00209,2009,16WV00,209,11,10,21,eneheuvel,26-09-11
200916WV00211,2009,16WV00,211,59,52,111,eneheuvel,26-09-11
200916WV00213,2009,16WV00,213,2,1,3,eneheuvel,26-09-11
200916WV00214,2009,16WV00,214,2,1,3,eneheuvel,26-09-11
200916WV00305,2009,16WV00,305,1,0,1,eneheuvel,26-09-11
200916WV009999,2009,16WV00,9999,3,2,5,eneheuvel,26-09-11
200916YS00201,2009,16YS00,201,10,7,17,eneheuvel,26-09-11
200916YS00202,2009,16YS00,202,1,1,2,eneheuvel,26-09-11
200916YS00207,2009,16YS00,207,2,0,2,eneheuvel,26-09-11
200916YS00208,2009,16YS00,208,0,1,1,eneheuvel,26-09-11
200916YS00209,2009,16YS00,209,1,3,4,eneheuvel,26-09-11
200916YS00210,2009,16YS00,210,0,1,1,eneheuvel,26-09-11
200916YS00211,2009,16YS00,211,81,72,153,eneheuvel,26-09-11
200916YS00212,2009,16YS00,212,2,3,5,eneheuvel,26-09-11
200916YS00213,2009,16YS00,213,1,1,2,eneheuvel,26-09-11
200916YS00214,2009,16YS00,214,1,0,1,eneheuvel,26-09-11
200916YS00216,2009,16YS00,216,1,0,1,eneheuvel,26-09-11
200916YS00302,2009,16YS00,302,0,1,1,eneheuvel,26-09-11
200916YS00303,2009,16YS00,303,1,0,1,eneheuvel,26-09-11
200916YS00309,2009,16YS00,309,1,1,2,eneheuvel,26-09-11
200916YS00312,2009,16YS00,312,2,0,2,eneheuvel,26-09-11
200916YS009999,2009,16YS00,9999,1,0,1,eneheuvel,26-09-11
200916ZG00103,2009,16ZG00,103,0,1,1,eneheuvel,26-09-11
200916ZG00201,2009,16ZG00,201,1,0,1,eneheuvel,26-09-11
200916ZG00202,2009,16ZG00,202,2,0,2,eneheuvel,26-09-11
200916ZG00211,2009,16ZG00,211,78,63,141,eneheuvel,26-09-11
200916ZG00212,2009,16ZG00,212,0,1,1,eneheuvel,26-09-11
200916ZG00213,2009,16ZG00,213,0,2,2,eneheuvel,26-09-11
200916ZG00214,2009,16ZG00,214,0,1,1,eneheuvel,26-09-11
200916ZG00301,2009,16ZG00,301,1,0,1,eneheuvel,26-09-11
200916ZG009999,2009,16ZG00,9999,1,0,1,eneheuvel,26-09-11
200916ZX00105,2009,16ZX00,105,0,1,1,eneheuvel,26-09-11
200916ZX00201,2009,16ZX00,201,1,1,2,eneheuvel,26-09-11
200916ZX00206,2009,16ZX00,206,16,16,32,eneheuvel,26-09-11
200916ZX00209,2009,16ZX00,209,38,28,66,eneheuvel,26-09-11
200916ZX00210,2009,16ZX00,210,2,2,4,eneheuvel,26-09-11
200916ZX00211,2009,16ZX00,211,0,1,1,eneheuvel,26-09-11
200916ZX00304,2009,16ZX00,304,1,0,1,eneheuvel,26-09-11
200916ZX00305,2009,16ZX00,305,0,1,1,eneheuvel,26-09-11
200916ZX009999,2009,16ZX00,9999,1,2,3,eneheuvel,26-09-11
200917AK00201,2009,17AK00,201,1,0,1,eneheuvel,26-09-11
200917AK00204,2009,17AK00,204,1,1,2,eneheuvel,26-09-11
200917AK00205,2009,17AK00,205,1,0,1,eneheuvel,26-09-11
200917AK00206,2009,17AK00,206,52,66,118,eneheuvel,26-09-11
200917AK00207,2009,17AK00,207,0,1,1,eneheuvel,26-09-11
200917AK00209,2009,17AK00,209,3,0,3,eneheuvel,26-09-11
200917AK00210,2009,17AK00,210,3,5,8,eneheuvel,26-09-11
200917AK00211,2009,17AK00,211,0,1,1,eneheuvel,26-09-11
200917AK00303,2009,17AK00,303,1,0,1,eneheuvel,26-09-11
200917AK00304,2009,17AK00,304,0,1,1,eneheuvel,26-09-11
200917AK00306,2009,17AK00,306,1,1,2,eneheuvel,26-09-11
200917AK00307,2009,17AK00,307,0,2,2,eneheuvel,26-09-11
200917AK00309,2009,17AK00,309,1,1,2,eneheuvel,26-09-11
200917AK00312,2009,17AK00,312,1,0,1,eneheuvel,26-09-11
200917AV00202,2009,17AV00,202,0,1,1,eneheuvel,26-09-11
200917AV00204,2009,17AV00,204,1,2,3,eneheuvel,26-09-11
200917AV00205,2009,17AV00,205,2,0,2,eneheuvel,26-09-11
200917AV00206,2009,17AV00,206,67,80,147,eneheuvel,26-09-11
200917AV00207,2009,17AV00,207,2,0,2,eneheuvel,26-09-11
200917AV00208,2009,17AV00,208,1,0,1,eneheuvel,26-09-11
200917AV00209,2009,17AV00,209,3,0,3,eneheuvel,26-09-11
200917AV00215,2009,17AV00,215,1,0,1,eneheuvel,26-09-11
200917AV00216,2009,17AV00,216,0,1,1,eneheuvel,26-09-11
200917AV009999,2009,17AV00,9999,0,2,2,eneheuvel,26-09-11
200917BP00103,2009,17BP00,103,0,2,2,eneheuvel,26-09-11
200917BP00201,2009,17BP00,201,0,1,1,eneheuvel,26-09-11
200917BP00202,2009,17BP00,202,0,1,1,eneheuvel,26-09-11
200917BP00208,2009,17BP00,208,0,1,1,eneheuvel,26-09-11
200917BP00209,2009,17BP00,209,1,0,1,eneheuvel,26-09-11
200917BP00210,2009,17BP00,210,2,1,3,eneheuvel,26-09-11
200917BP00211,2009,17BP00,211,50,54,104,eneheuvel,26-09-11
200917BP00212,2009,17BP00,212,3,7,10,eneheuvel,26-09-11
200917BP00213,2009,17BP00,213,53,73,126,eneheuvel,26-09-11
200917BP00214,2009,17BP00,214,2,2,4,eneheuvel,26-09-11
200917BP00309,2009,17BP00,309,0,1,1,eneheuvel,26-09-11
200917DA00103,2009,17DA00,103,0,1,1,eneheuvel,26-09-11
200917DA00201,2009,17DA00,201,1,0,1,eneheuvel,26-09-11
200917DA00207,2009,17DA00,207,0,1,1,eneheuvel,26-09-11
200917DA00209,2009,17DA00,209,4,7,11,eneheuvel,26-09-11
200917DA00210,2009,17DA00,210,47,56,103,eneheuvel,26-09-11
200917DA00211,2009,17DA00,211,1,1,2,eneheuvel,26-09-11
200917DA00302,2009,17DA00,302,0,3,3,eneheuvel,26-09-11
200917DA00303,2009,17DA00,303,0,1,1,eneheuvel,26-09-11
200917DA00307,2009,17DA00,307,0,1,1,eneheuvel,26-09-11
200917DA00402,2009,17DA00,402,0,1,1,eneheuvel,26-09-11
200917DA009999,2009,17DA00,9999,1,0,1,eneheuvel,26-09-11
200917DK00202,2009,17DK00,202,1,1,2,eneheuvel,26-09-11
200917DK00203,2009,17DK00,203,1,1,2,eneheuvel,26-09-11
200917DK00206,2009,17DK00,206,0,2,2,eneheuvel,26-09-11
200917DK00207,2009,17DK00,207,1,2,3,eneheuvel,26-09-11
200917DK00208,2009,17DK00,208,1,1,2,eneheuvel,26-09-11
200917DK00213,2009,17DK00,213,0,1,1,eneheuvel,26-09-11
200917DK00301,2009,17DK00,301,6,5,11,eneheuvel,26-09-11
200917DK00302,2009,17DK00,302,1,2,3,eneheuvel,26-09-11
200917DK00303,2009,17DK00,303,2,3,5,eneheuvel,26-09-11
200917DK00304,2009,17DK00,304,34,40,74,eneheuvel,26-09-11
200917DK00305,2009,17DK00,305,0,1,1,eneheuvel,26-09-11
200917DK00306,2009,17DK00,306,1,0,1,eneheuvel,26-09-11
200917DK00307,2009,17DK00,307,1,0,1,eneheuvel,26-09-11
200917DK00308,2009,17DK00,308,2,2,4,eneheuvel,26-09-11
200917DK00309,2009,17DK00,309,2,2,4,eneheuvel,26-09-11
200917DK009999,2009,17DK00,9999,1,0,1,eneheuvel,26-09-11
200917DV00106,2009,17DV00,106,0,1,1,eneheuvel,26-09-11
200917DV00108,2009,17DV00,108,0,1,1,eneheuvel,26-09-11
200917DV00202,2009,17DV00,202,0,1,1,eneheuvel,26-09-11
200917DV00203,2009,17DV00,203,0,1,1,eneheuvel,26-09-11
200917DV00204,2009,17DV00,204,0,1,1,eneheuvel,26-09-11
200917DV00207,2009,17DV00,207,2,0,2,eneheuvel,26-09-11
200917DV00211,2009,17DV00,211,1,0,1,eneheuvel,26-09-11
200917DV00212,2009,17DV00,212,0,1,1,eneheuvel,26-09-11
200917DV00214,2009,17DV00,214,0,1,1,eneheuvel,26-09-11
200917DV00216,2009,17DV00,216,1,0,1,eneheuvel,26-09-11
200917DV00301,2009,17DV00,301,20,6,26,eneheuvel,26-09-11
200917DV00302,2009,17DV00,302,3,6,9,eneheuvel,26-09-11
200917DV00303,2009,17DV00,303,29,32,61,eneheuvel,26-09-11
200917DV00304,2009,17DV00,304,34,41,75,eneheuvel,26-09-11
200917DV00305,2009,17DV00,305,8,4,12,eneheuvel,26-09-11
200917DV00306,2009,17DV00,306,13,10,23,eneheuvel,26-09-11
200917DV00307,2009,17DV00,307,4,10,14,eneheuvel,26-09-11
200917DV00308,2009,17DV00,308,12,10,22,eneheuvel,26-09-11
200917DV00309,2009,17DV00,309,14,13,27,eneheuvel,26-09-11
200917DV00310,2009,17DV00,310,1,2,3,eneheuvel,26-09-11
200917DV00311,2009,17DV00,311,7,4,11,eneheuvel,26-09-11
200917DV00312,2009,17DV00,312,1,0,1,eneheuvel,26-09-11
200917DV00502,2009,17DV00,502,0,2,2,eneheuvel,26-09-11
200917DV009999,2009,17DV00,9999,1,2,3,eneheuvel,26-09-11
200917FI00101,2009,17FI00,101,0,1,1,eneheuvel,26-09-11
200917FI00102,2009,17FI00,102,0,3,3,eneheuvel,26-09-11
200917FI00103,2009,17FI00,103,2,4,6,eneheuvel,26-09-11
200917FI00104,2009,17FI00,104,1,0,1,eneheuvel,26-09-11
200917FI00106,2009,17FI00,106,2,2,4,eneheuvel,26-09-11
200917FI00108,2009,17FI00,108,1,7,8,eneheuvel,26-09-11
200917FI00201,2009,17FI00,201,0,1,1,eneheuvel,26-09-11
200917FI00202,2009,17FI00,202,0,18,18,eneheuvel,26-09-11
200917FI00203,2009,17FI00,203,5,11,16,eneheuvel,26-09-11
200917FI00204,2009,17FI00,204,5,7,12,eneheuvel,26-09-11
200917FI00205,2009,17FI00,205,0,6,6,eneheuvel,26-09-11
200917FI00206,2009,17FI00,206,3,6,9,eneheuvel,26-09-11
200917FI00207,2009,17FI00,207,1,3,4,eneheuvel,26-09-11
200917FI00208,2009,17FI00,208,3,12,15,eneheuvel,26-09-11
200917FI00209,2009,17FI00,209,2,2,4,eneheuvel,26-09-11
200917FI00210,2009,17FI00,210,3,4,7,eneheuvel,26-09-11
200917FI00211,2009,17FI00,211,3,6,9,eneheuvel,26-09-11
200917FI00212,2009,17FI00,212,1,8,9,eneheuvel,26-09-11
200917FI00213,2009,17FI00,213,1,5,6,eneheuvel,26-09-11
200917FI00214,2009,17FI00,214,0,6,6,eneheuvel,26-09-11
200917FI00216,2009,17FI00,216,1,3,4,eneheuvel,26-09-11
200917FI00302,2009,17FI00,302,1,4,5,eneheuvel,26-09-11
200917FI00303,2009,17FI00,303,2,3,5,eneheuvel,26-09-11
200917FI00304,2009,17FI00,304,3,6,9,eneheuvel,26-09-11
200917FI00305,2009,17FI00,305,0,7,7,eneheuvel,26-09-11
200917FI00306,2009,17FI00,306,2,2,4,eneheuvel,26-09-11
200917FI00307,2009,17FI00,307,2,5,7,eneheuvel,26-09-11
200917FI00308,2009,17FI00,308,0,2,2,eneheuvel,26-09-11
200917FI00309,2009,17FI00,309,3,4,7,eneheuvel,26-09-11
200917FI00310,2009,17FI00,310,0,1,1,eneheuvel,26-09-11
200917FI00311,2009,17FI00,311,2,4,6,eneheuvel,26-09-11
200917FI00312,2009,17FI00,312,0,1,1,eneheuvel,26-09-11
200917FI00313,2009,17FI00,313,1,0,1,eneheuvel,26-09-11
200917FI00402,2009,17FI00,402,0,1,1,eneheuvel,26-09-11
200917FI00502,2009,17FI00,502,0,1,1,eneheuvel,26-09-11
200917FI009999,2009,17FI00,9999,1,1,2,eneheuvel,26-09-11
200917LP00207,2009,17LP00,207,1,0,1,eneheuvel,26-09-11
200917LP00213,2009,17LP00,213,1,0,1,eneheuvel,26-09-11
200917LP00301,2009,17LP00,301,1,1,2,eneheuvel,26-09-11
200917LP00304,2009,17LP00,304,1,0,1,eneheuvel,26-09-11
200917LP00305,2009,17LP00,305,56,53,109,eneheuvel,26-09-11
200917LP00306,2009,17LP00,306,9,3,12,eneheuvel,26-09-11
200917LP00308,2009,17LP00,308,2,1,3,eneheuvel,26-09-11
200917LP00309,2009,17LP00,309,3,1,4,eneheuvel,26-09-11
200917LP00310,2009,17LP00,310,1,0,1,eneheuvel,26-09-11
200917MH00202,2009,17MH00,202,1,1,2,eneheuvel,26-09-11
200917MH00203,2009,17MH00,203,1,0,1,eneheuvel,26-09-11
200917MH00207,2009,17MH00,207,0,2,2,eneheuvel,26-09-11
200917MH00210,2009,17MH00,210,0,3,3,eneheuvel,26-09-11
200917MH00212,2009,17MH00,212,0,1,1,eneheuvel,26-09-11
200917MH00302,2009,17MH00,302,0,1,1,eneheuvel,26-09-11
200917MH00304,2009,17MH00,304,0,1,1,eneheuvel,26-09-11
200917MH00305,2009,17MH00,305,58,61,119,eneheuvel,26-09-11
200917MH00306,2009,17MH00,306,1,4,5,eneheuvel,26-09-11
200921KO00201,2009,21KO00,201,2,0,2,eneheuvel,26-09-11
200921KO00202,2009,21KO00,202,0,2,2,eneheuvel,26-09-11
200921KO00206,2009,21KO00,206,0,1,1,eneheuvel,26-09-11
200921KO00209,2009,21KO00,209,8,4,12,eneheuvel,26-09-11
200921KO00210,2009,21KO00,210,75,82,157,eneheuvel,26-09-11
200921KO00211,2009,21KO00,211,3,0,3,eneheuvel,26-09-11
200921KO00212,2009,21KO00,212,3,0,3,eneheuvel,26-09-11
200921KO00214,2009,21KO00,214,1,1,2,eneheuvel,26-09-11
200921KO00216,2009,21KO00,216,0,2,2,eneheuvel,26-09-11
200921KO00309,2009,21KO00,309,0,1,1,eneheuvel,26-09-11
200921KO009999,2009,21KO00,9999,0,1,1,eneheuvel,26-09-11
200921NC00103,2009,21NC00,103,0,1,1,eneheuvel,26-09-11
200921NC00110,2009,21NC00,110,2,1,3,eneheuvel,26-09-11
200921NC00210,2009,21NC00,210,1,0,1,eneheuvel,26-09-11
200921NC00211,2009,21NC00,211,7,1,8,eneheuvel,26-09-11
200921NC00212,2009,21NC00,212,6,3,9,eneheuvel,26-09-11
200921NC00213,2009,21NC00,213,47,56,103,eneheuvel,26-09-11
200921NC00214,2009,21NC00,214,7,16,23,eneheuvel,26-09-11
200921NC00301,2009,21NC00,301,0,1,1,eneheuvel,26-09-11
200921NC00303,2009,21NC00,303,1,0,1,eneheuvel,26-09-11
200921NC00309,2009,21NC00,309,0,1,1,eneheuvel,26-09-11
200921NC00310,2009,21NC00,310,1,2,3,eneheuvel,26-09-11
200921NC009999,2009,21NC00,9999,4,0,4,eneheuvel,26-09-11
200921ND00102,2009,21ND00,102,1,1,2,eneheuvel,26-09-11
200921ND00208,2009,21ND00,208,0,1,1,eneheuvel,26-09-11
200921ND00209,2009,21ND00,209,1,0,1,eneheuvel,26-09-11
200921ND00211,2009,21ND00,211,13,16,29,eneheuvel,26-09-11
200921ND00212,2009,21ND00,212,7,4,11,eneheuvel,26-09-11
200921ND00213,2009,21ND00,213,52,94,146,eneheuvel,26-09-11
200921ND00214,2009,21ND00,214,1,0,1,eneheuvel,26-09-11
200921ND00312,2009,21ND00,312,0,1,1,eneheuvel,26-09-11
200921ND00402,2009,21ND00,402,1,0,1,eneheuvel,26-09-11
200922KP00102,2009,22KP00,102,0,1,1,eneheuvel,26-09-11
200922KP00202,2009,22KP00,202,1,0,1,eneheuvel,26-09-11
200922KP00203,2009,22KP00,203,2,0,2,eneheuvel,26-09-11
200922KP00204,2009,22KP00,204,2,0,2,eneheuvel,26-09-11
200922KP00207,2009,22KP00,207,0,1,1,eneheuvel,26-09-11
200922KP00208,2009,22KP00,208,2,0,2,eneheuvel,26-09-11
200922KP00210,2009,22KP00,210,1,1,2,eneheuvel,26-09-11
200922KP00211,2009,22KP00,211,2,0,2,eneheuvel,26-09-11
200922KP00301,2009,22KP00,301,1,1,2,eneheuvel,26-09-11
200922KP00302,2009,22KP00,302,4,3,7,eneheuvel,26-09-11
200922KP00303,2009,22KP00,303,4,4,8,eneheuvel,26-09-11
200922KP00304,2009,22KP00,304,2,6,8,eneheuvel,26-09-11
200922KP00305,2009,22KP00,305,1,0,1,eneheuvel,26-09-11
200922KP00306,2009,22KP00,306,0,2,2,eneheuvel,26-09-11
200922KP00307,2009,22KP00,307,1,4,5,eneheuvel,26-09-11
200922KP00308,2009,22KP00,308,1,11,12,eneheuvel,26-09-11
200922KP00309,2009,22KP00,309,130,151,281,eneheuvel,26-09-11
200922KP00310,2009,22KP00,310,5,5,10,eneheuvel,26-09-11
200922KP00311,2009,22KP00,311,15,18,33,eneheuvel,26-09-11
200922KP00312,2009,22KP00,312,2,4,6,eneheuvel,26-09-11
200922KP009999,2009,22KP00,9999,3,1,4,eneheuvel,26-09-11
200922KQ00109,2009,22KQ00,109,0,1,1,eneheuvel,26-09-11
200922KQ00201,2009,22KQ00,201,2,0,2,eneheuvel,26-09-11
200922KQ00205,2009,22KQ00,205,1,1,2,eneheuvel,26-09-11
200922KQ00206,2009,22KQ00,206,0,1,1,eneheuvel,26-09-11
200922KQ00208,2009,22KQ00,208,1,0,1,eneheuvel,26-09-11
200922KQ00209,2009,22KQ00,209,2,2,4,eneheuvel,26-09-11
200922KQ00210,2009,22KQ00,210,54,79,133,eneheuvel,26-09-11
200922KQ00211,2009,22KQ00,211,1,2,3,eneheuvel,26-09-11
200922KQ00212,2009,22KQ00,212,1,2,3,eneheuvel,26-09-11
200922KQ00307,2009,22KQ00,307,0,1,1,eneheuvel,26-09-11
200922KQ009999,2009,22KQ00,9999,1,1,2,eneheuvel,26-09-11
200923ER00201,2009,23ER00,201,1,0,1,eneheuvel,26-09-11
200923ER00210,2009,23ER00,210,2,0,2,eneheuvel,26-09-11
200923ER00212,2009,23ER00,212,64,86,150,eneheuvel,26-09-11
200923ER00213,2009,23ER00,213,3,0,3,eneheuvel,26-09-11
200923ER00214,2009,23ER00,214,2,3,5,eneheuvel,26-09-11
200923ER00303,2009,23ER00,303,0,2,2,eneheuvel,26-09-11
200923ER009999,2009,23ER00,9999,0,1,1,eneheuvel,26-09-11
200923ET00201,2009,23ET00,201,1,0,1,eneheuvel,26-09-11
200923ET00202,2009,23ET00,202,0,1,1,eneheuvel,26-09-11
200923ET00203,2009,23ET00,203,1,0,1,eneheuvel,26-09-11
200923ET00204,2009,23ET00,204,1,0,1,eneheuvel,26-09-11
200923ET00208,2009,23ET00,208,0,2,2,eneheuvel,26-09-11
200923ET00210,2009,23ET00,210,0,1,1,eneheuvel,26-09-11
200923ET00214,2009,23ET00,214,0,2,2,eneheuvel,26-09-11
200923ET00301,2009,23ET00,301,0,1,1,eneheuvel,26-09-11
200923ET00302,2009,23ET00,302,0,2,2,eneheuvel,26-09-11
200923ET00305,2009,23ET00,305,1,0,1,eneheuvel,26-09-11
200923ET00306,2009,23ET00,306,2,6,8,eneheuvel,26-09-11
200923ET00307,2009,23ET00,307,5,5,10,eneheuvel,26-09-11
200923ET00308,2009,23ET00,308,65,76,141,eneheuvel,26-09-11
200923ET00309,2009,23ET00,309,4,8,12,eneheuvel,26-09-11
200923ET00310,2009,23ET00,310,0,1,1,eneheuvel,26-09-11
200923ET00311,2009,23ET00,311,2,2,4,eneheuvel,26-09-11
200923ET00312,2009,23ET00,312,3,4,7,eneheuvel,26-09-11
200923ET009999,2009,23ET00,9999,0,1,1,eneheuvel,26-09-11
200923EU00207,2009,23EU00,207,1,1,2,eneheuvel,26-09-11
200923EU00208,2009,23EU00,208,0,1,1,eneheuvel,26-09-11
200923EU00301,2009,23EU00,301,0,1,1,eneheuvel,26-09-11
200923EU00302,2009,23EU00,302,1,0,1,eneheuvel,26-09-11
200923EU00303,2009,23EU00,303,0,2,2,eneheuvel,26-09-11
200923EU00305,2009,23EU00,305,0,9,9,eneheuvel,26-09-11
200923EU00306,2009,23EU00,306,86,104,190,eneheuvel,26-09-11
200923EU00307,2009,23EU00,307,8,6,14,eneheuvel,26-09-11
200923EU00308,2009,23EU00,308,0,2,2,eneheuvel,26-09-11
200923EU00309,2009,23EU00,309,2,0,2,eneheuvel,26-09-11
200923EU00310,2009,23EU00,310,0,1,1,eneheuvel,26-09-11
200923EU00311,2009,23EU00,311,1,2,3,eneheuvel,26-09-11
200923EU00313,2009,23EU00,313,0,2,2,eneheuvel,26-09-11
200923EU009999,2009,23EU00,9999,0,1,1,eneheuvel,26-09-11
200923EV00102,2009,23EV00,102,1,0,1,eneheuvel,26-09-11
200923EV00201,2009,23EV00,201,0,1,1,eneheuvel,26-09-11
200923EV00204,2009,23EV00,204,1,0,1,eneheuvel,26-09-11
200923EV00207,2009,23EV00,207,1,2,3,eneheuvel,26-09-11
200923EV00208,2009,23EV00,208,0,1,1,eneheuvel,26-09-11
200923EV00209,2009,23EV00,209,1,0,1,eneheuvel,26-09-11
200923EV00210,2009,23EV00,210,11,8,19,eneheuvel,26-09-11
200923EV00211,2009,23EV00,211,7,12,19,eneheuvel,26-09-11
200923EV00212,2009,23EV00,212,86,119,205,eneheuvel,26-09-11
200923EV00213,2009,23EV00,213,34,16,50,eneheuvel,26-09-11
200923EV00214,2009,23EV00,214,5,3,8,eneheuvel,26-09-11
200923EV00216,2009,23EV00,216,0,1,1,eneheuvel,26-09-11
200923EV00302,2009,23EV00,302,1,0,1,eneheuvel,26-09-11
200923EV00307,2009,23EV00,307,0,2,2,eneheuvel,26-09-11
200923EV00402,2009,23EV00,402,0,1,1,eneheuvel,26-09-11
200923EV00403,2009,23EV00,403,0,1,1,eneheuvel,26-09-11
200923EV009999,2009,23EV00,9999,4,0,4,eneheuvel,26-09-11
200923EY00103,2009,23EY00,103,1,0,1,eneheuvel,26-09-11
200923EY00201,2009,23EY00,201,2,1,3,eneheuvel,26-09-11
200923EY00202,2009,23EY00,202,1,1,2,eneheuvel,26-09-11
200923EY00206,2009,23EY00,206,0,1,1,eneheuvel,26-09-11
200923EY00208,2009,23EY00,208,1,4,5,eneheuvel,26-09-11
200923EY00209,2009,23EY00,209,0,1,1,eneheuvel,26-09-11
200923EY00210,2009,23EY00,210,6,11,17,eneheuvel,26-09-11
200923EY00211,2009,23EY00,211,13,14,27,eneheuvel,26-09-11
200923EY00212,2009,23EY00,212,116,112,228,eneheuvel,26-09-11
200923EY00213,2009,23EY00,213,25,21,46,eneheuvel,26-09-11
200923EY00214,2009,23EY00,214,4,3,7,eneheuvel,26-09-11
200923EY00215,2009,23EY00,215,2,0,2,eneheuvel,26-09-11
200923EY00216,2009,23EY00,216,0,2,2,eneheuvel,26-09-11
200923EY00302,2009,23EY00,302,1,0,1,eneheuvel,26-09-11
200923EY00304,2009,23EY00,304,0,1,1,eneheuvel,26-09-11
200923EY00311,2009,23EY00,311,1,0,1,eneheuvel,26-09-11
200923EY00502,2009,23EY00,502,0,1,1,eneheuvel,26-09-11
200923EY009999,2009,23EY00,9999,2,0,2,eneheuvel,26-09-11
200923ZU00110,2009,23ZU00,110,1,0,1,eneheuvel,26-09-11
200923ZU00201,2009,23ZU00,201,1,0,1,eneheuvel,26-09-11
200923ZU00202,2009,23ZU00,202,71,82,153,eneheuvel,26-09-11
200923ZU00203,2009,23ZU00,203,7,8,15,eneheuvel,26-09-11
200923ZU00204,2009,23ZU00,204,51,40,91,eneheuvel,26-09-11
200923ZU00205,2009,23ZU00,205,84,98,182,eneheuvel,26-09-11
200923ZU00206,2009,23ZU00,206,2,1,3,eneheuvel,26-09-11
200923ZU00207,2009,23ZU00,207,34,19,53,eneheuvel,26-09-11
200923ZU00208,2009,23ZU00,208,13,15,28,eneheuvel,26-09-11
200923ZU00209,2009,23ZU00,209,1,0,1,eneheuvel,26-09-11
200923ZU00210,2009,23ZU00,210,1,3,4,eneheuvel,26-09-11
200923ZU00211,2009,23ZU00,211,1,1,2,eneheuvel,26-09-11
200923ZU00214,2009,23ZU00,214,0,2,2,eneheuvel,26-09-11
200923ZU00215,2009,23ZU00,215,0,2,2,eneheuvel,26-09-11
200923ZU00216,2009,23ZU00,216,4,3,7,eneheuvel,26-09-11
200923ZU00302,2009,23ZU00,302,1,1,2,eneheuvel,26-09-11
200923ZU00303,2009,23ZU00,303,0,6,6,eneheuvel,26-09-11
200923ZU00306,2009,23ZU00,306,2,0,2,eneheuvel,26-09-11
200923ZU00307,2009,23ZU00,307,0,1,1,eneheuvel,26-09-11
200923ZU00309,2009,23ZU00,309,0,2,2,eneheuvel,26-09-11
200923ZU00311,2009,23ZU00,311,2,1,3,eneheuvel,26-09-11
200923ZU00502,2009,23ZU00,502,0,1,1,eneheuvel,26-09-11
200923ZU009999,2009,23ZU00,9999,1,0,1,eneheuvel,26-09-11
200923ZV00103,2009,23ZV00,103,0,1,1,eneheuvel,26-09-11
200923ZV00107,2009,23ZV00,107,0,1,1,eneheuvel,26-09-11
200923ZV00110,2009,23ZV00,110,0,1,1,eneheuvel,26-09-11
200923ZV00201,2009,23ZV00,201,3,3,6,eneheuvel,26-09-11
200923ZV00202,2009,23ZV00,202,31,37,68,eneheuvel,26-09-11
200923ZV00203,2009,23ZV00,203,4,4,8,eneheuvel,26-09-11
200923ZV00204,2009,23ZV00,204,21,33,54,eneheuvel,26-09-11
200923ZV00205,2009,23ZV00,205,34,53,87,eneheuvel,26-09-11
200923ZV00206,2009,23ZV00,206,0,1,1,eneheuvel,26-09-11
200923ZV00207,2009,23ZV00,207,10,11,21,eneheuvel,26-09-11
200923ZV00208,2009,23ZV00,208,3,9,12,eneheuvel,26-09-11
200923ZV00210,2009,23ZV00,210,1,2,3,eneheuvel,26-09-11
200923ZV00211,2009,23ZV00,211,1,1,2,eneheuvel,26-09-11
200923ZV00212,2009,23ZV00,212,2,1,3,eneheuvel,26-09-11
200923ZV00302,2009,23ZV00,302,0,1,1,eneheuvel,26-09-11
200923ZV00306,2009,23ZV00,306,1,0,1,eneheuvel,26-09-11
200923ZV00308,2009,23ZV00,308,1,1,2,eneheuvel,26-09-11
200923ZV00309,2009,23ZV00,309,1,0,1,eneheuvel,26-09-11
200923ZV00311,2009,23ZV00,311,1,0,1,eneheuvel,26-09-11
200923ZV009999,2009,23ZV00,9999,1,2,3,eneheuvel,26-09-11
200923ZW00206,2009,23ZW00,206,1,0,1,eneheuvel,26-09-11
200923ZW00207,2009,23ZW00,207,1,0,1,eneheuvel,26-09-11
200923ZW00208,2009,23ZW00,208,2,5,7,eneheuvel,26-09-11
200923ZW00214,2009,23ZW00,214,1,1,2,eneheuvel,26-09-11
200923ZW00301,2009,23ZW00,301,3,1,4,eneheuvel,26-09-11
200923ZW00302,2009,23ZW00,302,6,2,8,eneheuvel,26-09-11
200923ZW00303,2009,23ZW00,303,4,4,8,eneheuvel,26-09-11
200923ZW00304,2009,23ZW00,304,2,3,5,eneheuvel,26-09-11
200923ZW00305,2009,23ZW00,305,2,4,6,eneheuvel,26-09-11
200923ZW00306,2009,23ZW00,306,25,28,53,eneheuvel,26-09-11
200923ZW00307,2009,23ZW00,307,79,81,160,eneheuvel,26-09-11
200923ZW00308,2009,23ZW00,308,85,85,170,eneheuvel,26-09-11
200923ZW00309,2009,23ZW00,309,7,5,12,eneheuvel,26-09-11
200923ZW00310,2009,23ZW00,310,1,2,3,eneheuvel,26-09-11
200923ZW00311,2009,23ZW00,311,1,0,1,eneheuvel,26-09-11
200923ZW00312,2009,23ZW00,312,2,5,7,eneheuvel,26-09-11
200923ZW00313,2009,23ZW00,313,0,1,1,eneheuvel,26-09-11
200923ZW00502,2009,23ZW00,502,4,0,4,eneheuvel,26-09-11
200923ZW009999,2009,23ZW00,9999,3,3,6,eneheuvel,26-09-11
200923ZX00110,2009,23ZX00,110,0,1,1,eneheuvel,26-09-11
200923ZX00201,2009,23ZX00,201,9,4,13,eneheuvel,26-09-11
200923ZX00202,2009,23ZX00,202,117,150,267,eneheuvel,26-09-11
200923ZX00203,2009,23ZX00,203,2,2,4,eneheuvel,26-09-11
200923ZX00204,2009,23ZX00,204,3,3,6,eneheuvel,26-09-11
200923ZX00205,2009,23ZX00,205,5,8,13,eneheuvel,26-09-11
200923ZX00207,2009,23ZX00,207,2,7,9,eneheuvel,26-09-11
200923ZX00208,2009,23ZX00,208,5,9,14,eneheuvel,26-09-11
200923ZX00209,2009,23ZX00,209,4,1,5,eneheuvel,26-09-11
200923ZX00210,2009,23ZX00,210,0,1,1,eneheuvel,26-09-11
200923ZX00211,2009,23ZX00,211,6,2,8,eneheuvel,26-09-11
200923ZX00301,2009,23ZX00,301,1,0,1,eneheuvel,26-09-11
200923ZX00306,2009,23ZX00,306,1,1,2,eneheuvel,26-09-11
200923ZX00307,2009,23ZX00,307,0,1,1,eneheuvel,26-09-11
200923ZX009999,2009,23ZX00,9999,0,1,1,eneheuvel,26-09-11
200923ZY00107,2009,23ZY00,107,1,0,1,eneheuvel,26-09-11
200923ZY00203,2009,23ZY00,203,1,0,1,eneheuvel,26-09-11
200923ZY00206,2009,23ZY00,206,1,1,2,eneheuvel,26-09-11
200923ZY00207,2009,23ZY00,207,1,0,1,eneheuvel,26-09-11
200923ZY00210,2009,23ZY00,210,3,0,3,eneheuvel,26-09-11
200923ZY00211,2009,23ZY00,211,1,1,2,eneheuvel,26-09-11
200923ZY00212,2009,23ZY00,212,157,178,335,eneheuvel,26-09-11
200923ZY00213,2009,23ZY00,213,3,1,4,eneheuvel,26-09-11
200923ZY00214,2009,23ZY00,214,1,2,3,eneheuvel,26-09-11
200923ZY00215,2009,23ZY00,215,1,1,2,eneheuvel,26-09-11
200923ZY00216,2009,23ZY00,216,0,1,1,eneheuvel,26-09-11
200923ZY00302,2009,23ZY00,302,1,1,2,eneheuvel,26-09-11
200923ZY009999,2009,23ZY00,9999,1,0,1,eneheuvel,26-09-11
200924EJ00101,2009,24EJ00,101,1,0,1,eneheuvel,26-09-11
200924EJ00102,2009,24EJ00,102,2,4,6,eneheuvel,26-09-11
200924EJ00106,2009,24EJ00,106,0,2,2,eneheuvel,26-09-11
200924EJ00107,2009,24EJ00,107,2,1,3,eneheuvel,26-09-11
200924EJ00108,2009,24EJ00,108,2,1,3,eneheuvel,26-09-11
200924EJ00201,2009,24EJ00,201,2,0,2,eneheuvel,26-09-11
200924EJ00202,2009,24EJ00,202,6,3,9,eneheuvel,26-09-11
200924EJ00203,2009,24EJ00,203,1,2,3,eneheuvel,26-09-11
200924EJ00204,2009,24EJ00,204,5,8,13,eneheuvel,26-09-11
200924EJ00206,2009,24EJ00,206,1,3,4,eneheuvel,26-09-11
200924EJ00207,2009,24EJ00,207,3,2,5,eneheuvel,26-09-11
200924EJ00208,2009,24EJ00,208,1,6,7,eneheuvel,26-09-11
200924EJ00209,2009,24EJ00,209,12,10,22,eneheuvel,26-09-11
200924EJ00210,2009,24EJ00,210,22,17,39,eneheuvel,26-09-11
200924EJ00211,2009,24EJ00,211,37,32,69,eneheuvel,26-09-11
200924EJ00212,2009,24EJ00,212,9,11,20,eneheuvel,26-09-11
200924EJ00213,2009,24EJ00,213,5,6,11,eneheuvel,26-09-11
200924EJ00214,2009,24EJ00,214,5,1,6,eneheuvel,26-09-11
200924EJ00303,2009,24EJ00,303,0,2,2,eneheuvel,26-09-11
200924EJ00305,2009,24EJ00,305,3,0,3,eneheuvel,26-09-11
200924EJ00308,2009,24EJ00,308,1,0,1,eneheuvel,26-09-11
200924EJ00309,2009,24EJ00,309,1,0,1,eneheuvel,26-09-11
200924EJ009999,2009,24EJ00,9999,3,2,5,eneheuvel,26-09-11
200924FT00102,2009,24FT00,102,0,2,2,eneheuvel,26-09-11
200924FT00103,2009,24FT00,103,0,3,3,eneheuvel,26-09-11
200924FT00104,2009,24FT00,104,1,0,1,eneheuvel,26-09-11
200924FT00105,2009,24FT00,105,0,2,2,eneheuvel,26-09-11
200924FT00106,2009,24FT00,106,0,2,2,eneheuvel,26-09-11
200924FT00107,2009,24FT00,107,1,0,1,eneheuvel,26-09-11
200924FT00108,2009,24FT00,108,0,2,2,eneheuvel,26-09-11
200924FT00109,2009,24FT00,109,1,0,1,eneheuvel,26-09-11
200924FT00203,2009,24FT00,203,1,4,5,eneheuvel,26-09-11
200924FT00204,2009,24FT00,204,0,2,2,eneheuvel,26-09-11
200924FT00205,2009,24FT00,205,1,3,4,eneheuvel,26-09-11
200924FT00206,2009,24FT00,206,1,6,7,eneheuvel,26-09-11
200924FT00207,2009,24FT00,207,2,2,4,eneheuvel,26-09-11
200924FT00208,2009,24FT00,208,3,6,9,eneheuvel,26-09-11
200924FT00209,2009,24FT00,209,1,0,1,eneheuvel,26-09-11
200924FT00210,2009,24FT00,210,0,3,3,eneheuvel,26-09-11
200924FT00211,2009,24FT00,211,8,12,20,eneheuvel,26-09-11
200924FT00212,2009,24FT00,212,3,18,21,eneheuvel,26-09-11
200924FT00213,2009,24FT00,213,2,9,11,eneheuvel,26-09-11
200924FT00214,2009,24FT00,214,3,15,18,eneheuvel,26-09-11
200924FT00216,2009,24FT00,216,0,1,1,eneheuvel,26-09-11
200924FT00301,2009,24FT00,301,2,0,2,eneheuvel,26-09-11
200924FT00302,2009,24FT00,302,1,20,21,eneheuvel,26-09-11
200924FT00303,2009,24FT00,303,1,17,18,eneheuvel,26-09-11
200924FT00304,2009,24FT00,304,1,5,6,eneheuvel,26-09-11
200924FT00305,2009,24FT00,305,0,3,3,eneheuvel,26-09-11
200924FT00306,2009,24FT00,306,2,5,7,eneheuvel,26-09-11
200924FT00307,2009,24FT00,307,0,9,9,eneheuvel,26-09-11
200924FT00308,2009,24FT00,308,0,11,11,eneheuvel,26-09-11
200924FT00309,2009,24FT00,309,1,9,10,eneheuvel,26-09-11
200924FT00311,2009,24FT00,311,3,9,12,eneheuvel,26-09-11
200924FT00312,2009,24FT00,312,5,14,19,eneheuvel,26-09-11
200924FT00313,2009,24FT00,313,0,1,1,eneheuvel,26-09-11
200924FT00502,2009,24FT00,502,0,1,1,eneheuvel,26-09-11
200924FT009999,2009,24FT00,9999,0,2,2,eneheuvel,26-09-11
200924MR00201,2009,24MR00,201,0,2,2,eneheuvel,26-09-11
200924MR00205,2009,24MR00,205,1,0,1,eneheuvel,26-09-11
200924MR00208,2009,24MR00,208,2,1,3,eneheuvel,26-09-11
200924MR00301,2009,24MR00,301,1,0,1,eneheuvel,26-09-11
200924MR00302,2009,24MR00,302,1,0,1,eneheuvel,26-09-11
200924MR00305,2009,24MR00,305,2,1,3,eneheuvel,26-09-11
200924MR00306,2009,24MR00,306,9,15,24,eneheuvel,26-09-11
200924MR00307,2009,24MR00,307,104,135,239,eneheuvel,26-09-11
200924MR00308,2009,24MR00,308,3,8,11,eneheuvel,26-09-11
200924MR00309,2009,24MR00,309,1,0,1,eneheuvel,26-09-11
200924MR00311,2009,24MR00,311,1,1,2,eneheuvel,26-09-11
200924MR00502,2009,24MR00,502,0,2,2,eneheuvel,26-09-11
200924RK00202,2009,24RK00,202,13,14,27,eneheuvel,26-09-11
200924RK00203,2009,24RK00,203,15,8,23,eneheuvel,26-09-11
200924RK00204,2009,24RK00,204,11,13,24,eneheuvel,26-09-11
200924RK00205,2009,24RK00,205,8,5,13,eneheuvel,26-09-11
200924RK00206,2009,24RK00,206,4,1,5,eneheuvel,26-09-11
200924RK00207,2009,24RK00,207,6,4,10,eneheuvel,26-09-11
200924RK00208,2009,24RK00,208,6,2,8,eneheuvel,26-09-11
200924RK00210,2009,24RK00,210,0,2,2,eneheuvel,26-09-11
200924RK00211,2009,24RK00,211,2,0,2,eneheuvel,26-09-11
200924RK00212,2009,24RK00,212,1,1,2,eneheuvel,26-09-11
200924RK00213,2009,24RK00,213,2,2,4,eneheuvel,26-09-11
200924RK00214,2009,24RK00,214,1,1,2,eneheuvel,26-09-11
200924RK00216,2009,24RK00,216,1,3,4,eneheuvel,26-09-11
200924RK00301,2009,24RK00,301,2,1,3,eneheuvel,26-09-11
200924RK00302,2009,24RK00,302,4,5,9,eneheuvel,26-09-11
200924RK00303,2009,24RK00,303,3,5,8,eneheuvel,26-09-11
200924RK00304,2009,24RK00,304,2,4,6,eneheuvel,26-09-11
200924RK00305,2009,24RK00,305,1,2,3,eneheuvel,26-09-11
200924RK00306,2009,24RK00,306,3,2,5,eneheuvel,26-09-11
200924RK00307,2009,24RK00,307,5,5,10,eneheuvel,26-09-11
200924RK00308,2009,24RK00,308,5,3,8,eneheuvel,26-09-11
200924RK00309,2009,24RK00,309,2,3,5,eneheuvel,26-09-11
200924RK00311,2009,24RK00,311,1,0,1,eneheuvel,26-09-11
200924RK00312,2009,24RK00,312,2,0,2,eneheuvel,26-09-11
200924RK009999,2009,24RK00,9999,0,2,2,eneheuvel,26-09-11
200924UN00202,2009,24UN00,202,3,1,4,eneheuvel,26-09-11
200924UN00204,2009,24UN00,204,0,1,1,eneheuvel,26-09-11
200924UN00210,2009,24UN00,210,0,1,1,eneheuvel,26-09-11
200924UN00302,2009,24UN00,302,1,1,2,eneheuvel,26-09-11
200924UN00303,2009,24UN00,303,2,0,2,eneheuvel,26-09-11
200924UN00305,2009,24UN00,305,0,1,1,eneheuvel,26-09-11
200924UN00306,2009,24UN00,306,15,29,44,eneheuvel,26-09-11
200924UN00307,2009,24UN00,307,35,42,77,eneheuvel,26-09-11
200924UN00308,2009,24UN00,308,56,48,104,eneheuvel,26-09-11
200924UN00309,2009,24UN00,309,12,15,27,eneheuvel,26-09-11
200924UN00311,2009,24UN00,311,1,1,2,eneheuvel,26-09-11
200924UN00312,2009,24UN00,312,0,1,1,eneheuvel,26-09-11
200924UN00313,2009,24UN00,313,0,1,1,eneheuvel,26-09-11
200924UN009999,2009,24UN00,9999,1,1,2,eneheuvel,26-09-11
200925CF00201,2009,25CF00,201,1,1,2,eneheuvel,26-09-11
200925CF00202,2009,25CF00,202,3,8,11,eneheuvel,26-09-11
200925CF00203,2009,25CF00,203,2,5,7,eneheuvel,26-09-11
200925CF00204,2009,25CF00,204,58,73,131,eneheuvel,26-09-11
200925CF00205,2009,25CF00,205,12,42,54,eneheuvel,26-09-11
200925CF00206,2009,25CF00,206,1,0,1,eneheuvel,26-09-11
200925CF00207,2009,25CF00,207,2,6,8,eneheuvel,26-09-11
200925CF00208,2009,25CF00,208,3,4,7,eneheuvel,26-09-11
200925CF00212,2009,25CF00,212,2,0,2,eneheuvel,26-09-11
200925CF00213,2009,25CF00,213,0,1,1,eneheuvel,26-09-11
200925CF00307,2009,25CF00,307,1,0,1,eneheuvel,26-09-11
200925CF00309,2009,25CF00,309,1,0,1,eneheuvel,26-09-11
200925CF009999,2009,25CF00,9999,1,0,1,eneheuvel,26-09-11
200925KT00101,2009,25KT00,101,1,1,2,eneheuvel,26-09-11
200925KT00105,2009,25KT00,105,1,0,1,eneheuvel,26-09-11
200925KT00107,2009,25KT00,107,0,1,1,eneheuvel,26-09-11
200925KT00109,2009,25KT00,109,1,0,1,eneheuvel,26-09-11
200925KT00202,2009,25KT00,202,36,53,89,eneheuvel,26-09-11
200925KT00203,2009,25KT00,203,96,90,186,eneheuvel,26-09-11
200925KT00204,2009,25KT00,204,76,85,161,eneheuvel,26-09-11
200925KT00205,2009,25KT00,205,2,6,8,eneheuvel,26-09-11
200925KT00207,2009,25KT00,207,18,6,24,eneheuvel,26-09-11
200925KT00208,2009,25KT00,208,34,38,72,eneheuvel,26-09-11
200925KT00214,2009,25KT00,214,1,0,1,eneheuvel,26-09-11
200925KT00302,2009,25KT00,302,0,1,1,eneheuvel,26-09-11
200925KT00306,2009,25KT00,306,1,1,2,eneheuvel,26-09-11
200925KT00308,2009,25KT00,308,1,0,1,eneheuvel,26-09-11
200925KT00309,2009,25KT00,309,0,2,2,eneheuvel,26-09-11
200925KT00402,2009,25KT00,402,0,1,1,eneheuvel,26-09-11
200925KT00502,2009,25KT00,502,3,11,14,eneheuvel,26-09-11
200925KT009999,2009,25KT00,9999,2,0,2,eneheuvel,26-09-11
200925KU00110,2009,25KU00,110,1,3,4,eneheuvel,26-09-11
200925KU00201,2009,25KU00,201,0,2,2,eneheuvel,26-09-11
200925KU00202,2009,25KU00,202,25,31,56,eneheuvel,26-09-11
200925KU00203,2009,25KU00,203,68,56,124,eneheuvel,26-09-11
200925KU00204,2009,25KU00,204,55,74,129,eneheuvel,26-09-11
200925KU00205,2009,25KU00,205,3,3,6,eneheuvel,26-09-11
200925KU00206,2009,25KU00,206,0,1,1,eneheuvel,26-09-11
200925KU00207,2009,25KU00,207,6,6,12,eneheuvel,26-09-11
200925KU00208,2009,25KU00,208,21,25,46,eneheuvel,26-09-11
200925KU00211,2009,25KU00,211,1,0,1,eneheuvel,26-09-11
200925KU00212,2009,25KU00,212,0,2,2,eneheuvel,26-09-11
200925KU00216,2009,25KU00,216,2,0,2,eneheuvel,26-09-11
200925KU00309,2009,25KU00,309,0,1,1,eneheuvel,26-09-11
200925KU00312,2009,25KU00,312,1,0,1,eneheuvel,26-09-11
200925KU00313,2009,25KU00,313,0,1,1,eneheuvel,26-09-11
200925KU00401,2009,25KU00,401,1,0,1,eneheuvel,26-09-11
200925KU00402,2009,25KU00,402,1,0,1,eneheuvel,26-09-11
200925KU00502,2009,25KU00,502,3,8,11,eneheuvel,26-09-11
200925KU009999,2009,25KU00,9999,0,3,3,eneheuvel,26-09-11
200925KV00104,2009,25KV00,104,0,1,1,eneheuvel,26-09-11
200925KV00108,2009,25KV00,108,1,0,1,eneheuvel,26-09-11
200925KV00202,2009,25KV00,202,2,1,3,eneheuvel,26-09-11
200925KV00203,2009,25KV00,203,154,197,351,eneheuvel,26-09-11
200925KV00204,2009,25KV00,204,2,7,9,eneheuvel,26-09-11
200925KV00205,2009,25KV00,205,1,1,2,eneheuvel,26-09-11
200925KV00207,2009,25KV00,207,0,2,2,eneheuvel,26-09-11
200925KV00208,2009,25KV00,208,1,3,4,eneheuvel,26-09-11
200925KV00211,2009,25KV00,211,0,1,1,eneheuvel,26-09-11
200925KV00212,2009,25KV00,212,1,0,1,eneheuvel,26-09-11
200925KV00308,2009,25KV00,308,0,1,1,eneheuvel,26-09-11
200925KV00312,2009,25KV00,312,1,0,1,eneheuvel,26-09-11
200926AB00205,2009,26AB00,205,1,0,1,eneheuvel,26-09-11
200926AB00211,2009,26AB00,211,0,1,1,eneheuvel,26-09-11
200926AB00215,2009,26AB00,215,0,1,1,eneheuvel,26-09-11
200926AB00301,2009,26AB00,301,2,0,2,eneheuvel,26-09-11
200926AB00302,2009,26AB00,302,16,26,42,eneheuvel,26-09-11
200926AB00303,2009,26AB00,303,159,182,341,eneheuvel,26-09-11
200926AB00304,2009,26AB00,304,3,6,9,eneheuvel,26-09-11
200926AB00305,2009,26AB00,305,1,0,1,eneheuvel,26-09-11
200926AB00306,2009,26AB00,306,0,3,3,eneheuvel,26-09-11
200926AB00309,2009,26AB00,309,5,3,8,eneheuvel,26-09-11
200926AB00310,2009,26AB00,310,2,0,2,eneheuvel,26-09-11
200926AB00311,2009,26AB00,311,2,5,7,eneheuvel,26-09-11
200926AB00312,2009,26AB00,312,1,4,5,eneheuvel,26-09-11
200926AB00313,2009,26AB00,313,3,3,6,eneheuvel,26-09-11
200926AB009999,2009,26AB00,9999,1,0,1,eneheuvel,26-09-11
200926AC00107,2009,26AC00,107,1,3,4,eneheuvel,26-09-11
200926AC00108,2009,26AC00,108,0,2,2,eneheuvel,26-09-11
200926AC00109,2009,26AC00,109,26,13,39,eneheuvel,26-09-11
200926AC00110,2009,26AC00,110,0,1,1,eneheuvel,26-09-11
200926AC00201,2009,26AC00,201,0,1,1,eneheuvel,26-09-11
200926AC00202,2009,26AC00,202,0,1,1,eneheuvel,26-09-11
200926AC00203,2009,26AC00,203,3,0,3,eneheuvel,26-09-11
200926AC00204,2009,26AC00,204,1,0,1,eneheuvel,26-09-11
200926AC00205,2009,26AC00,205,1,1,2,eneheuvel,26-09-11
200926AC00207,2009,26AC00,207,0,1,1,eneheuvel,26-09-11
200926AC00210,2009,26AC00,210,0,2,2,eneheuvel,26-09-11
200926AC00211,2009,26AC00,211,8,5,13,eneheuvel,26-09-11
200926AC00212,2009,26AC00,212,8,13,21,eneheuvel,26-09-11
200926AC00213,2009,26AC00,213,7,17,24,eneheuvel,26-09-11
200926AC00214,2009,26AC00,214,443,377,820,eneheuvel,26-09-11
200926AC00215,2009,26AC00,215,1,0,1,eneheuvel,26-09-11
200926AC00301,2009,26AC00,301,1,0,1,eneheuvel,26-09-11
200926AC00303,2009,26AC00,303,1,0,1,eneheuvel,26-09-11
200926AC00309,2009,26AC00,309,1,0,1,eneheuvel,26-09-11
200926AC00311,2009,26AC00,311,0,3,3,eneheuvel,26-09-11
200926AC00312,2009,26AC00,312,2,0,2,eneheuvel,26-09-11
200926AC00401,2009,26AC00,401,0,1,1,eneheuvel,26-09-11
200926AC00402,2009,26AC00,402,0,2,2,eneheuvel,26-09-11
200926AC00403,2009,26AC00,403,2,1,3,eneheuvel,26-09-11
200926AC009999,2009,26AC00,9999,2,3,5,eneheuvel,26-09-11
200926AD00101,2009,26AD00,101,0,1,1,eneheuvel,26-09-11
200926AD00206,2009,26AD00,206,1,0,1,eneheuvel,26-09-11
200926AD00207,2009,26AD00,207,1,1,2,eneheuvel,26-09-11
200926AD00208,2009,26AD00,208,3,1,4,eneheuvel,26-09-11
200926AD00210,2009,26AD00,210,1,0,1,eneheuvel,26-09-11
200926AD00212,2009,26AD00,212,0,1,1,eneheuvel,26-09-11
200926AD00214,2009,26AD00,214,1,1,2,eneheuvel,26-09-11
200926AD00216,2009,26AD00,216,0,2,2,eneheuvel,26-09-11
200926AD00301,2009,26AD00,301,3,0,3,eneheuvel,26-09-11
200926AD00302,2009,26AD00,302,95,60,155,eneheuvel,26-09-11
200926AD00303,2009,26AD00,303,35,26,61,eneheuvel,26-09-11
200926AD00304,2009,26AD00,304,2,1,3,eneheuvel,26-09-11
200926AD00305,2009,26AD00,305,2,2,4,eneheuvel,26-09-11
200926AD00306,2009,26AD00,306,0,2,2,eneheuvel,26-09-11
200926AD00307,2009,26AD00,307,1,1,2,eneheuvel,26-09-11
200926AD00308,2009,26AD00,308,2,1,3,eneheuvel,26-09-11
200926AD00309,2009,26AD00,309,69,50,119,eneheuvel,26-09-11
200926AD00310,2009,26AD00,310,20,10,30,eneheuvel,26-09-11
200926AD00311,2009,26AD00,311,34,27,61,eneheuvel,26-09-11
200926AD00312,2009,26AD00,312,9,10,19,eneheuvel,26-09-11
200926AD00313,2009,26AD00,313,7,7,14,eneheuvel,26-09-11
200926AD00502,2009,26AD00,502,0,1,1,eneheuvel,26-09-11
200926AD009999,2009,26AD00,9999,0,2,2,eneheuvel,26-09-11
200926PD00101,2009,26PD00,101,0,2,2,eneheuvel,26-09-11
200926PD00104,2009,26PD00,104,2,0,2,eneheuvel,26-09-11
200926PD00108,2009,26PD00,108,1,0,1,eneheuvel,26-09-11
200926PD00204,2009,26PD00,204,1,2,3,eneheuvel,26-09-11
200926PD00205,2009,26PD00,205,3,6,9,eneheuvel,26-09-11
200926PD00207,2009,26PD00,207,128,156,284,eneheuvel,26-09-11
200926PD00208,2009,26PD00,208,29,31,60,eneheuvel,26-09-11
200926PD00211,2009,26PD00,211,0,1,1,eneheuvel,26-09-11
200926PD00304,2009,26PD00,304,0,1,1,eneheuvel,26-09-11
200926PD00308,2009,26PD00,308,1,0,1,eneheuvel,26-09-11
200926PD00309,2009,26PD00,309,0,1,1,eneheuvel,26-09-11
200926PD00502,2009,26PD00,502,2,2,4,eneheuvel,26-09-11
200926PD009999,2009,26PD00,9999,0,4,4,eneheuvel,26-09-11
200926PE00201,2009,26PE00,201,1,1,2,eneheuvel,26-09-11
200926PE00202,2009,26PE00,202,1,0,1,eneheuvel,26-09-11
200926PE00203,2009,26PE00,203,1,1,2,eneheuvel,26-09-11
200926PE00208,2009,26PE00,208,1,0,1,eneheuvel,26-09-11
200926PE00301,2009,26PE00,301,3,0,3,eneheuvel,26-09-11
200926PE00302,2009,26PE00,302,239,250,489,eneheuvel,26-09-11
200926PE00303,2009,26PE00,303,28,18,46,eneheuvel,26-09-11
200926PE00304,2009,26PE00,304,0,1,1,eneheuvel,26-09-11
200926PE00306,2009,26PE00,306,0,1,1,eneheuvel,26-09-11
200926PE00307,2009,26PE00,307,1,0,1,eneheuvel,26-09-11
200926PE00308,2009,26PE00,308,1,0,1,eneheuvel,26-09-11
200926PE00309,2009,26PE00,309,3,2,5,eneheuvel,26-09-11
200926PE00311,2009,26PE00,311,7,9,16,eneheuvel,26-09-11
200926PE00312,2009,26PE00,312,3,4,7,eneheuvel,26-09-11
200926PE00313,2009,26PE00,313,6,3,9,eneheuvel,26-09-11
200926PE009999,2009,26PE00,9999,1,1,2,eneheuvel,26-09-11
200926PF00103,2009,26PF00,103,1,0,1,eneheuvel,26-09-11
200926PF00201,2009,26PF00,201,4,1,5,eneheuvel,26-09-11
200926PF00202,2009,26PF00,202,3,4,7,eneheuvel,26-09-11
200926PF00203,2009,26PF00,203,1,0,1,eneheuvel,26-09-11
200926PF00206,2009,26PF00,206,1,2,3,eneheuvel,26-09-11
200926PF00207,2009,26PF00,207,2,3,5,eneheuvel,26-09-11
200926PF00209,2009,26PF00,209,6,1,7,eneheuvel,26-09-11
200926PF00210,2009,26PF00,210,2,0,2,eneheuvel,26-09-11
200926PF00211,2009,26PF00,211,6,9,15,eneheuvel,26-09-11
200926PF00212,2009,26PF00,212,15,7,22,eneheuvel,26-09-11
200926PF00213,2009,26PF00,213,8,2,10,eneheuvel,26-09-11
200926PF00214,2009,26PF00,214,178,203,381,eneheuvel,26-09-11
200926PF00216,2009,26PF00,216,2,1,3,eneheuvel,26-09-11
200926PF00302,2009,26PF00,302,0,5,5,eneheuvel,26-09-11
200926PF00305,2009,26PF00,305,0,1,1,eneheuvel,26-09-11
200926PF00306,2009,26PF00,306,0,1,1,eneheuvel,26-09-11
200926PF00307,2009,26PF00,307,1,0,1,eneheuvel,26-09-11
200926PF00309,2009,26PF00,309,2,1,3,eneheuvel,26-09-11
200926PF00312,2009,26PF00,312,1,0,1,eneheuvel,26-09-11
200926PF00401,2009,26PF00,401,2,0,2,eneheuvel,26-09-11
200926PF00403,2009,26PF00,403,0,1,1,eneheuvel,26-09-11
200926PF009999,2009,26PF00,9999,6,6,12,eneheuvel,26-09-11
200926PG00101,2009,26PG00,101,1,0,1,eneheuvel,26-09-11
200926PG00103,2009,26PG00,103,0,1,1,eneheuvel,26-09-11
200926PG00108,2009,26PG00,108,1,0,1,eneheuvel,26-09-11
200926PG00207,2009,26PG00,207,0,1,1,eneheuvel,26-09-11
200926PG00209,2009,26PG00,209,1,0,1,eneheuvel,26-09-11
200926PG00210,2009,26PG00,210,1,0,1,eneheuvel,26-09-11
200926PG00211,2009,26PG00,211,2,1,3,eneheuvel,26-09-11
200926PG00212,2009,26PG00,212,0,1,1,eneheuvel,26-09-11
200926PG00213,2009,26PG00,213,1,1,2,eneheuvel,26-09-11
200926PG00214,2009,26PG00,214,48,70,118,eneheuvel,26-09-11
200926PG009999,2009,26PG00,9999,2,2,4,eneheuvel,26-09-11
200926PH00102,2009,26PH00,102,1,1,2,eneheuvel,26-09-11
200926PH00203,2009,26PH00,203,1,0,1,eneheuvel,26-09-11
200926PH00207,2009,26PH00,207,0,1,1,eneheuvel,26-09-11
200926PH00208,2009,26PH00,208,0,1,1,eneheuvel,26-09-11
200926PH00214,2009,26PH00,214,1,0,1,eneheuvel,26-09-11
200926PH00216,2009,26PH00,216,1,3,4,eneheuvel,26-09-11
200926PH00302,2009,26PH00,302,27,25,52,eneheuvel,26-09-11
200926PH00303,2009,26PH00,303,5,9,14,eneheuvel,26-09-11
200926PH00304,2009,26PH00,304,2,1,3,eneheuvel,26-09-11
200926PH00305,2009,26PH00,305,2,2,4,eneheuvel,26-09-11
200926PH00306,2009,26PH00,306,4,1,5,eneheuvel,26-09-11
200926PH00307,2009,26PH00,307,2,1,3,eneheuvel,26-09-11
200926PH00308,2009,26PH00,308,5,2,7,eneheuvel,26-09-11
200926PH00309,2009,26PH00,309,39,40,79,eneheuvel,26-09-11
200926PH00310,2009,26PH00,310,2,0,2,eneheuvel,26-09-11
200926PH00311,2009,26PH00,311,224,210,434,eneheuvel,26-09-11
200926PH00312,2009,26PH00,312,15,15,30,eneheuvel,26-09-11
200926PH00313,2009,26PH00,313,7,5,12,eneheuvel,26-09-11
200926PH009999,2009,26PH00,9999,3,1,4,eneheuvel,26-09-11
200926PW00216,2009,26PW00,216,0,2,2,eneheuvel,26-09-11
200926PW00302,2009,26PW00,302,23,36,59,eneheuvel,26-09-11
200926PW00303,2009,26PW00,303,31,25,56,eneheuvel,26-09-11
200926PW00308,2009,26PW00,308,3,4,7,eneheuvel,26-09-11
200926PW00309,2009,26PW00,309,37,32,69,eneheuvel,26-09-11
200926PW00310,2009,26PW00,310,10,8,18,eneheuvel,26-09-11
200926PW00311,2009,26PW00,311,19,20,39,eneheuvel,26-09-11
200926PW00312,2009,26PW00,312,4,3,7,eneheuvel,26-09-11
200926PW00313,2009,26PW00,313,0,5,5,eneheuvel,26-09-11
200926PW009999,2009,26PW00,9999,2,0,2,eneheuvel,26-09-11
200926ZZ00104,2009,26ZZ00,104,0,1,1,eneheuvel,26-09-11
200926ZZ00106,2009,26ZZ00,106,0,3,3,eneheuvel,26-09-11
200926ZZ00201,2009,26ZZ00,201,1,1,2,eneheuvel,26-09-11
200926ZZ00202,2009,26ZZ00,202,224,218,442,eneheuvel,26-09-11
200926ZZ00203,2009,26ZZ00,203,15,13,28,eneheuvel,26-09-11
200926ZZ00204,2009,26ZZ00,204,2,2,4,eneheuvel,26-09-11
200926ZZ00205,2009,26ZZ00,205,0,1,1,eneheuvel,26-09-11
200926ZZ00207,2009,26ZZ00,207,1,1,2,eneheuvel,26-09-11
200926ZZ00208,2009,26ZZ00,208,1,2,3,eneheuvel,26-09-11
200926ZZ00210,2009,26ZZ00,210,1,1,2,eneheuvel,26-09-11
200926ZZ00211,2009,26ZZ00,211,1,0,1,eneheuvel,26-09-11
200926ZZ00212,2009,26ZZ00,212,0,1,1,eneheuvel,26-09-11
200926ZZ00216,2009,26ZZ00,216,1,1,2,eneheuvel,26-09-11
200926ZZ00302,2009,26ZZ00,302,1,1,2,eneheuvel,26-09-11
200926ZZ00309,2009,26ZZ00,309,0,2,2,eneheuvel,26-09-11
200926ZZ00313,2009,26ZZ00,313,1,0,1,eneheuvel,26-09-11
200926ZZ00502,2009,26ZZ00,502,1,3,4,eneheuvel,26-09-11
200926ZZ009999,2009,26ZZ00,9999,0,1,1,eneheuvel,26-09-11
200927AA00106,2009,27AA00,106,2,1,3,eneheuvel,26-09-11
200927AA00201,2009,27AA00,201,2,0,2,eneheuvel,26-09-11
200927AA00202,2009,27AA00,202,5,0,5,eneheuvel,26-09-11
200927AA00203,2009,27AA00,203,4,7,11,eneheuvel,26-09-11
200927AA00204,2009,27AA00,204,5,14,19,eneheuvel,26-09-11
200927AA00205,2009,27AA00,205,4,3,7,eneheuvel,26-09-11
200927AA00206,2009,27AA00,206,0,1,1,eneheuvel,26-09-11
200927AA00207,2009,27AA00,207,90,68,158,eneheuvel,26-09-11
200927AA00208,2009,27AA00,208,178,162,340,eneheuvel,26-09-11
200927AA00209,2009,27AA00,209,1,0,1,eneheuvel,26-09-11
200927AA00210,2009,27AA00,210,1,1,2,eneheuvel,26-09-11
200927AA00211,2009,27AA00,211,0,3,3,eneheuvel,26-09-11
200927AA00212,2009,27AA00,212,1,0,1,eneheuvel,26-09-11
200927AA00214,2009,27AA00,214,1,1,2,eneheuvel,26-09-11
200927AA00303,2009,27AA00,303,3,2,5,eneheuvel,26-09-11
200927AA00305,2009,27AA00,305,0,1,1,eneheuvel,26-09-11
200927AA00306,2009,27AA00,306,0,1,1,eneheuvel,26-09-11
200927AA00307,2009,27AA00,307,2,3,5,eneheuvel,26-09-11
200927AA00308,2009,27AA00,308,1,2,3,eneheuvel,26-09-11
200927AA00312,2009,27AA00,312,1,1,2,eneheuvel,26-09-11
200927NU00103,2009,27NU00,103,1,0,1,eneheuvel,26-09-11
200927NU00104,2009,27NU00,104,1,0,1,eneheuvel,26-09-11
200927NU00108,2009,27NU00,108,1,0,1,eneheuvel,26-09-11
200927NU00201,2009,27NU00,201,1,0,1,eneheuvel,26-09-11
200927NU00202,2009,27NU00,202,1,0,1,eneheuvel,26-09-11
200927NU00203,2009,27NU00,203,2,7,9,eneheuvel,26-09-11
200927NU00204,2009,27NU00,204,4,3,7,eneheuvel,26-09-11
200927NU00205,2009,27NU00,205,2,1,3,eneheuvel,26-09-11
200927NU00206,2009,27NU00,206,0,1,1,eneheuvel,26-09-11
200927NU00207,2009,27NU00,207,33,16,49,eneheuvel,26-09-11
200927NU00208,2009,27NU00,208,145,154,299,eneheuvel,26-09-11
200927NU00209,2009,27NU00,209,1,0,1,eneheuvel,26-09-11
200927NU00210,2009,27NU00,210,0,2,2,eneheuvel,26-09-11
200927NU00211,2009,27NU00,211,1,0,1,eneheuvel,26-09-11
200927NU00214,2009,27NU00,214,0,1,1,eneheuvel,26-09-11
200927NU00216,2009,27NU00,216,1,0,1,eneheuvel,26-09-11
200927NU00302,2009,27NU00,302,1,0,1,eneheuvel,26-09-11
200927NU00304,2009,27NU00,304,1,0,1,eneheuvel,26-09-11
200927NU00305,2009,27NU00,305,0,1,1,eneheuvel,26-09-11
200927NU00311,2009,27NU00,311,0,1,1,eneheuvel,26-09-11
200927NU00312,2009,27NU00,312,0,1,1,eneheuvel,26-09-11
200927NU00401,2009,27NU00,401,1,0,1,eneheuvel,26-09-11
200927NU00502,2009,27NU00,502,0,2,2,eneheuvel,26-09-11
200927NU009999,2009,27NU00,9999,1,1,2,eneheuvel,26-09-11
200927UB00104,2009,27UB00,104,1,0,1,eneheuvel,26-09-11
200927UB00105,2009,27UB00,105,0,1,1,eneheuvel,26-09-11
200927UB00201,2009,27UB00,201,1,0,1,eneheuvel,26-09-11
200927UB00202,2009,27UB00,202,1,2,3,eneheuvel,26-09-11
200927UB00203,2009,27UB00,203,6,4,10,eneheuvel,26-09-11
200927UB00204,2009,27UB00,204,4,1,5,eneheuvel,26-09-11
200927UB00205,2009,27UB00,205,0,2,2,eneheuvel,26-09-11
200927UB00207,2009,27UB00,207,15,7,22,eneheuvel,26-09-11
200927UB00208,2009,27UB00,208,187,112,299,eneheuvel,26-09-11
200927UB00209,2009,27UB00,209,1,0,1,eneheuvel,26-09-11
200927UB00212,2009,27UB00,212,1,0,1,eneheuvel,26-09-11
200927UB00216,2009,27UB00,216,1,0,1,eneheuvel,26-09-11
200927UB00302,2009,27UB00,302,0,1,1,eneheuvel,26-09-11
200927UB00305,2009,27UB00,305,1,0,1,eneheuvel,26-09-11
200927UB00306,2009,27UB00,306,0,3,3,eneheuvel,26-09-11
200927UB00307,2009,27UB00,307,2,1,3,eneheuvel,26-09-11
200927UB00308,2009,27UB00,308,0,1,1,eneheuvel,26-09-11
200927UB00309,2009,27UB00,309,1,1,2,eneheuvel,26-09-11
200927UB00311,2009,27UB00,311,1,0,1,eneheuvel,26-09-11
200927UB00502,2009,27UB00,502,5,1,6,eneheuvel,26-09-11
200927UB009999,2009,27UB00,9999,2,1,3,eneheuvel,26-09-11
200927XH00201,2009,27XH00,201,1,0,1,eneheuvel,26-09-11
200927XH00202,2009,27XH00,202,0,1,1,eneheuvel,26-09-11
200927XH00203,2009,27XH00,203,1,0,1,eneheuvel,26-09-11
200927XH00206,2009,27XH00,206,0,1,1,eneheuvel,26-09-11
200927XH00209,2009,27XH00,209,3,1,4,eneheuvel,26-09-11
200927XH00210,2009,27XH00,210,7,5,12,eneheuvel,26-09-11
200927XH00212,2009,27XH00,212,2,4,6,eneheuvel,26-09-11
200927XH00213,2009,27XH00,213,0,1,1,eneheuvel,26-09-11
200927XH00214,2009,27XH00,214,4,1,5,eneheuvel,26-09-11
200927XH00215,2009,27XH00,215,15,24,39,eneheuvel,26-09-11
200927XH00216,2009,27XH00,216,118,87,205,eneheuvel,26-09-11
200927XH00311,2009,27XH00,311,1,0,1,eneheuvel,26-09-11
200927XJ00108,2009,27XJ00,108,1,0,1,eneheuvel,26-09-11
200927XJ00201,2009,27XJ00,201,1,0,1,eneheuvel,26-09-11
200927XJ00207,2009,27XJ00,207,1,0,1,eneheuvel,26-09-11
200927XJ00212,2009,27XJ00,212,0,1,1,eneheuvel,26-09-11
200927XJ00302,2009,27XJ00,302,15,2,17,eneheuvel,26-09-11
200927XJ00303,2009,27XJ00,303,8,1,9,eneheuvel,26-09-11
200927XJ00306,2009,27XJ00,306,2,2,4,eneheuvel,26-09-11
200927XJ00307,2009,27XJ00,307,0,1,1,eneheuvel,26-09-11
200927XJ00308,2009,27XJ00,308,1,1,2,eneheuvel,26-09-11
200927XJ00309,2009,27XJ00,309,6,2,8,eneheuvel,26-09-11
200927XJ00311,2009,27XJ00,311,27,5,32,eneheuvel,26-09-11
200927XJ00312,2009,27XJ00,312,162,89,251,eneheuvel,26-09-11
200927XJ00313,2009,27XJ00,313,46,14,60,eneheuvel,26-09-11
200927XJ00403,2009,27XJ00,403,1,0,1,eneheuvel,26-09-11
200927XJ00502,2009,27XJ00,502,0,2,2,eneheuvel,26-09-11
200927XJ009999,2009,27XJ00,9999,0,2,2,eneheuvel,26-09-11
200927YN00107,2009,27YN00,107,2,0,2,eneheuvel,26-09-11
200927YN00109,2009,27YN00,109,1,0,1,eneheuvel,26-09-11
200927YN00110,2009,27YN00,110,1,2,3,eneheuvel,26-09-11
200927YN00202,2009,27YN00,202,1,1,2,eneheuvel,26-09-11
200927YN00203,2009,27YN00,203,0,1,1,eneheuvel,26-09-11
200927YN00206,2009,27YN00,206,1,1,2,eneheuvel,26-09-11
200927YN00208,2009,27YN00,208,1,1,2,eneheuvel,26-09-11
200927YN00209,2009,27YN00,209,1,0,1,eneheuvel,26-09-11
200927YN00210,2009,27YN00,210,13,14,27,eneheuvel,26-09-11
200927YN00211,2009,27YN00,211,4,4,8,eneheuvel,26-09-11
200927YN00212,2009,27YN00,212,5,5,10,eneheuvel,26-09-11
200927YN00213,2009,27YN00,213,2,0,2,eneheuvel,26-09-11
200927YN00214,2009,27YN00,214,2,2,4,eneheuvel,26-09-11
200927YN00215,2009,27YN00,215,4,5,9,eneheuvel,26-09-11
200927YN00216,2009,27YN00,216,129,96,225,eneheuvel,26-09-11
200927YN00302,2009,27YN00,302,0,2,2,eneheuvel,26-09-11
200927YN00303,2009,27YN00,303,1,1,2,eneheuvel,26-09-11
200927YN00304,2009,27YN00,304,0,3,3,eneheuvel,26-09-11
200927YN00307,2009,27YN00,307,0,1,1,eneheuvel,26-09-11
200927YN00308,2009,27YN00,308,0,1,1,eneheuvel,26-09-11
200927YN009999,2009,27YN00,9999,1,0,1,eneheuvel,26-09-11
200928AM00102,2009,28AM00,102,0,1,1,eneheuvel,26-09-11
200928AM00103,2009,28AM00,103,2,1,3,eneheuvel,26-09-11
200928AM00207,2009,28AM00,207,3,1,4,eneheuvel,26-09-11
200928AM00208,2009,28AM00,208,0,2,2,eneheuvel,26-09-11
200928AM00211,2009,28AM00,211,0,1,1,eneheuvel,26-09-11
200928AM00214,2009,28AM00,214,0,1,1,eneheuvel,26-09-11
200928AM00302,2009,28AM00,302,6,1,7,eneheuvel,26-09-11
200928AM00305,2009,28AM00,305,1,0,1,eneheuvel,26-09-11
200928AM00309,2009,28AM00,309,1,1,2,eneheuvel,26-09-11
200928AM00311,2009,28AM00,311,26,2,28,eneheuvel,26-09-11
200928AM00312,2009,28AM00,312,183,156,339,eneheuvel,26-09-11
200928AM00313,2009,28AM00,313,6,5,11,eneheuvel,26-09-11
200928BR00203,2009,28BR00,203,0,1,1,eneheuvel,26-09-11
200928BR00208,2009,28BR00,208,0,1,1,eneheuvel,26-09-11
200928BR00212,2009,28BR00,212,0,4,4,eneheuvel,26-09-11
200928BR00213,2009,28BR00,213,1,0,1,eneheuvel,26-09-11
200928BR00301,2009,28BR00,301,0,1,1,eneheuvel,26-09-11
200928BR00302,2009,28BR00,302,3,5,8,eneheuvel,26-09-11
200928BR00303,2009,28BR00,303,0,1,1,eneheuvel,26-09-11
200928BR00304,2009,28BR00,304,0,1,1,eneheuvel,26-09-11
200928BR00306,2009,28BR00,306,4,0,4,eneheuvel,26-09-11
200928BR00307,2009,28BR00,307,0,1,1,eneheuvel,26-09-11
200928BR00309,2009,28BR00,309,1,2,3,eneheuvel,26-09-11
200928BR00311,2009,28BR00,311,9,10,19,eneheuvel,26-09-11
200928BR00312,2009,28BR00,312,0,2,2,eneheuvel,26-09-11
200928BR009999,2009,28BR00,9999,0,1,1,eneheuvel,26-09-11
200928DJ00106,2009,28DJ00,106,1,1,2,eneheuvel,26-09-11
200928DJ00107,2009,28DJ00,107,2,2,4,eneheuvel,26-09-11
200928DJ00108,2009,28DJ00,108,1,0,1,eneheuvel,26-09-11
200928DJ00202,2009,28DJ00,202,3,0,3,eneheuvel,26-09-11
200928DJ00203,2009,28DJ00,203,2,6,8,eneheuvel,26-09-11
200928DJ00204,2009,28DJ00,204,1,1,2,eneheuvel,26-09-11
200928DJ00205,2009,28DJ00,205,4,2,6,eneheuvel,26-09-11
200928DJ00206,2009,28DJ00,206,1,0,1,eneheuvel,26-09-11
200928DJ00207,2009,28DJ00,207,11,7,18,eneheuvel,26-09-11
200928DJ00208,2009,28DJ00,208,10,15,25,eneheuvel,26-09-11
200928DJ00210,2009,28DJ00,210,1,1,2,eneheuvel,26-09-11
200928DJ00211,2009,28DJ00,211,5,3,8,eneheuvel,26-09-11
200928DJ00212,2009,28DJ00,212,2,3,5,eneheuvel,26-09-11
200928DJ00213,2009,28DJ00,213,2,1,3,eneheuvel,26-09-11
200928DJ00214,2009,28DJ00,214,1,2,3,eneheuvel,26-09-11
200928DJ00215,2009,28DJ00,215,0,1,1,eneheuvel,26-09-11
200928DJ00216,2009,28DJ00,216,2,0,2,eneheuvel,26-09-11
200928DJ00301,2009,28DJ00,301,1,0,1,eneheuvel,26-09-11
200928DJ00302,2009,28DJ00,302,6,2,8,eneheuvel,26-09-11
200928DJ00303,2009,28DJ00,303,2,4,6,eneheuvel,26-09-11
200928DJ00304,2009,28DJ00,304,2,1,3,eneheuvel,26-09-11
200928DJ00305,2009,28DJ00,305,3,4,7,eneheuvel,26-09-11
200928DJ00306,2009,28DJ00,306,4,2,6,eneheuvel,26-09-11
200928DJ00307,2009,28DJ00,307,3,4,7,eneheuvel,26-09-11
200928DJ00308,2009,28DJ00,308,6,4,10,eneheuvel,26-09-11
200928DJ00309,2009,28DJ00,309,2,0,2,eneheuvel,26-09-11
200928DJ00311,2009,28DJ00,311,0,1,1,eneheuvel,26-09-11
200928DJ00312,2009,28DJ00,312,1,0,1,eneheuvel,26-09-11
200928DJ009999,2009,28DJ00,9999,1,0,1,eneheuvel,26-09-11
200929UB00102,2009,29UB00,102,1,1,2,eneheuvel,26-09-11
200929UB00107,2009,29UB00,107,1,1,2,eneheuvel,26-09-11
200929UB00202,2009,29UB00,202,1,0,1,eneheuvel,26-09-11
200929UB00203,2009,29UB00,203,1,0,1,eneheuvel,26-09-11
200929UB00206,2009,29UB00,206,1,0,1,eneheuvel,26-09-11
200929UB00207,2009,29UB00,207,0,1,1,eneheuvel,26-09-11
200929UB00208,2009,29UB00,208,1,0,1,eneheuvel,26-09-11
200929UB00209,2009,29UB00,209,0,1,1,eneheuvel,26-09-11
200929UB00210,2009,29UB00,210,0,4,4,eneheuvel,26-09-11
200929UB00211,2009,29UB00,211,1,2,3,eneheuvel,26-09-11
200929UB00212,2009,29UB00,212,6,8,14,eneheuvel,26-09-11
200929UB00213,2009,29UB00,213,1,2,3,eneheuvel,26-09-11
200929UB00214,2009,29UB00,214,27,30,57,eneheuvel,26-09-11
200929UB00216,2009,29UB00,216,1,0,1,eneheuvel,26-09-11
200929UB00306,2009,29UB00,306,1,0,1,eneheuvel,26-09-11
200929UB00309,2009,29UB00,309,1,0,1,eneheuvel,26-09-11
200929UB00401,2009,29UB00,401,10,7,17,eneheuvel,26-09-11
200929UB00402,2009,29UB00,402,29,15,44,eneheuvel,26-09-11
200929UB00403,2009,29UB00,403,12,4,16,eneheuvel,26-09-11
200929UB009999,2009,29UB00,9999,3,0,3,eneheuvel,26-09-11
200929UN00207,2009,29UN00,207,1,2,3,eneheuvel,26-09-11
200929UN00209,2009,29UN00,209,1,0,1,eneheuvel,26-09-11
200929UN00211,2009,29UN00,211,0,1,1,eneheuvel,26-09-11
200929UN00213,2009,29UN00,213,1,1,2,eneheuvel,26-09-11
200929UN00301,2009,29UN00,301,2,2,4,eneheuvel,26-09-11
200929UN00302,2009,29UN00,302,4,0,4,eneheuvel,26-09-11
200929UN00304,2009,29UN00,304,2,3,5,eneheuvel,26-09-11
200929UN00305,2009,29UN00,305,4,10,14,eneheuvel,26-09-11
200929UN00306,2009,29UN00,306,2,3,5,eneheuvel,26-09-11
200929UN00307,2009,29UN00,307,1,2,3,eneheuvel,26-09-11
200929UN00308,2009,29UN00,308,3,2,5,eneheuvel,26-09-11
200929UN00309,2009,29UN00,309,3,3,6,eneheuvel,26-09-11
200929UN00310,2009,29UN00,310,1,0,1,eneheuvel,26-09-11
200929UN00311,2009,29UN00,311,3,6,9,eneheuvel,26-09-11
200929UN00312,2009,29UN00,312,2,2,4,eneheuvel,26-09-11
200929XC00207,2009,29XC00,207,0,2,2,eneheuvel,26-09-11
200929XC00213,2009,29XC00,213,1,1,2,eneheuvel,26-09-11
200929XC00402,2009,29XC00,402,1,1,2,eneheuvel,26-09-11
200929XC00403,2009,29XC00,403,0,1,1,eneheuvel,26-09-11
200929XT00104,2009,29XT00,104,1,0,1,eneheuvel,26-09-11
200929XT00203,2009,29XT00,203,1,0,1,eneheuvel,26-09-11
200929XT00212,2009,29XT00,212,1,2,3,eneheuvel,26-09-11
200929XT00214,2009,29XT00,214,9,1,10,eneheuvel,26-09-11
200929XT00302,2009,29XT00,302,1,0,1,eneheuvel,26-09-11
200929XT00304,2009,29XT00,304,2,1,3,eneheuvel,26-09-11
200929XT00311,2009,29XT00,311,2,0,2,eneheuvel,26-09-11
200929XT00313,2009,29XT00,313,2,1,3,eneheuvel,26-09-11
200929XT00401,2009,29XT00,401,12,7,19,eneheuvel,26-09-11
200929XT00402,2009,29XT00,402,4,1,5,eneheuvel,26-09-11
200929XT009999,2009,29XT00,9999,2,0,2,eneheuvel,26-09-11
200929XU00203,2009,29XU00,203,0,2,2,eneheuvel,26-09-11
200929XU00216,2009,29XU00,216,0,1,1,eneheuvel,26-09-11
200929XU00302,2009,29XU00,302,0,1,1,eneheuvel,26-09-11
200929XU00401,2009,29XU00,401,9,4,13,eneheuvel,26-09-11
200929XU00402,2009,29XU00,402,1,3,4,eneheuvel,26-09-11
200929XU009999,2009,29XU00,9999,1,0,1,eneheuvel,26-09-11
200929XX00202,2009,29XX00,202,1,1,2,eneheuvel,26-09-11
200929XX00203,2009,29XX00,203,1,1,2,eneheuvel,26-09-11
200929XX00205,2009,29XX00,205,0,1,1,eneheuvel,26-09-11
200929XX00206,2009,29XX00,206,0,1,1,eneheuvel,26-09-11
200929XX00207,2009,29XX00,207,1,4,5,eneheuvel,26-09-11
200929XX00208,2009,29XX00,208,1,3,4,eneheuvel,26-09-11
200929XX00209,2009,29XX00,209,1,2,3,eneheuvel,26-09-11
200929XX00210,2009,29XX00,210,5,3,8,eneheuvel,26-09-11
200929XX00211,2009,29XX00,211,1,0,1,eneheuvel,26-09-11
200929XX00212,2009,29XX00,212,8,1,9,eneheuvel,26-09-11
200929XX00213,2009,29XX00,213,0,1,1,eneheuvel,26-09-11
200929XX00214,2009,29XX00,214,8,9,17,eneheuvel,26-09-11
200929XX00216,2009,29XX00,216,1,2,3,eneheuvel,26-09-11
200929XX00302,2009,29XX00,302,5,5,10,eneheuvel,26-09-11
200929XX00303,2009,29XX00,303,0,1,1,eneheuvel,26-09-11
200929XX00305,2009,29XX00,305,2,0,2,eneheuvel,26-09-11
200929XX00307,2009,29XX00,307,1,1,2,eneheuvel,26-09-11
200929XX00309,2009,29XX00,309,1,0,1,eneheuvel,26-09-11
200929XX00311,2009,29XX00,311,4,5,9,eneheuvel,26-09-11
200929XX00312,2009,29XX00,312,2,0,2,eneheuvel,26-09-11
200929XX00313,2009,29XX00,313,0,2,2,eneheuvel,26-09-11
200929XX009999,2009,29XX00,9999,0,1,1,eneheuvel,26-09-11
200930AJ00107,2009,30AJ00,107,0,1,1,eneheuvel,26-09-11
200930AJ00203,2009,30AJ00,203,0,2,2,eneheuvel,26-09-11
200930AJ00402,2009,30AJ00,402,6,4,10,eneheuvel,26-09-11
200930AJ009999,2009,30AJ00,9999,1,2,3,eneheuvel,26-09-11
201006RM00102,2010,06RM00,102,2,3,5,eneheuvel,26-09-11
201006RM00103,2010,06RM00,103,1,4,5,eneheuvel,26-09-11
201006RM00104,2010,06RM00,104,1,2,3,eneheuvel,26-09-11
201006RM00105,2010,06RM00,105,0,1,1,eneheuvel,26-09-11
201006RM00106,2010,06RM00,106,0,1,1,eneheuvel,26-09-11
201006RM00107,2010,06RM00,107,2,0,2,eneheuvel,26-09-11
201006RM00201,2010,06RM00,201,1,0,1,eneheuvel,26-09-11
201006RM00202,2010,06RM00,202,12,3,15,eneheuvel,26-09-11
201006RM00204,2010,06RM00,204,2,4,6,eneheuvel,26-09-11
201006RM00206,2010,06RM00,206,2,2,4,eneheuvel,26-09-11
201006RM00207,2010,06RM00,207,5,3,8,eneheuvel,26-09-11
201006RM00208,2010,06RM00,208,2,1,3,eneheuvel,26-09-11
201006RM00209,2010,06RM00,209,2,0,2,eneheuvel,26-09-11
201006RM00210,2010,06RM00,210,7,10,17,eneheuvel,26-09-11
201006RM00211,2010,06RM00,211,5,7,12,eneheuvel,26-09-11
201006RM00212,2010,06RM00,212,17,25,42,eneheuvel,26-09-11
201006RM00213,2010,06RM00,213,5,6,11,eneheuvel,26-09-11
201006RM00214,2010,06RM00,214,12,8,20,eneheuvel,26-09-11
201006RM00215,2010,06RM00,215,0,3,3,eneheuvel,26-09-11
201006RM00216,2010,06RM00,216,6,8,14,eneheuvel,26-09-11
201006RM00302,2010,06RM00,302,4,3,7,eneheuvel,26-09-11
201006RM00303,2010,06RM00,303,5,2,7,eneheuvel,26-09-11
201006RM00304,2010,06RM00,304,1,1,2,eneheuvel,26-09-11
201006RM00305,2010,06RM00,305,0,1,1,eneheuvel,26-09-11
201006RM00307,2010,06RM00,307,0,1,1,eneheuvel,26-09-11
201006RM00308,2010,06RM00,308,2,0,2,eneheuvel,26-09-11
201006RM00309,2010,06RM00,309,1,2,3,eneheuvel,26-09-11
201006RM00311,2010,06RM00,311,2,1,3,eneheuvel,26-09-11
201006RM00312,2010,06RM00,312,1,4,5,eneheuvel,26-09-11
201006RM00313,2010,06RM00,313,1,0,1,eneheuvel,26-09-11
201006RM00402,2010,06RM00,402,0,1,1,eneheuvel,26-09-11
201006RM00502,2010,06RM00,502,2,5,7,eneheuvel,26-09-11
201006RM009999,2010,06RM00,9999,0,5,5,eneheuvel,26-09-11
201012HU00102,2010,12HU00,102,0,1,1,eneheuvel,26-09-11
201012HU00103,2010,12HU00,103,1,2,3,eneheuvel,26-09-11
201012HU00201,2010,12HU00,201,4,2,6,eneheuvel,26-09-11
201012HU00202,2010,12HU00,202,1,1,2,eneheuvel,26-09-11
201012HU00203,2010,12HU00,203,1,0,1,eneheuvel,26-09-11
201012HU00209,2010,12HU00,209,6,2,8,eneheuvel,26-09-11
201012HU00210,2010,12HU00,210,1,2,3,eneheuvel,26-09-11
201012HU00211,2010,12HU00,211,33,35,68,eneheuvel,26-09-11
201012HU00213,2010,12HU00,213,1,0,1,eneheuvel,26-09-11
201012HU00307,2010,12HU00,307,0,1,1,eneheuvel,26-09-11
201012HU00312,2010,12HU00,312,1,0,1,eneheuvel,26-09-11
201012HU00401,2010,12HU00,401,1,1,2,eneheuvel,26-09-11
201012HU009999,2010,12HU00,9999,1,2,3,eneheuvel,26-09-11
201012PM00101,2010,12PM00,101,6,6,12,eneheuvel,26-09-11
201012PM00102,2010,12PM00,102,14,8,22,eneheuvel,26-09-11
201012PM00103,2010,12PM00,103,35,27,62,eneheuvel,26-09-11
201012PM00104,2010,12PM00,104,4,2,6,eneheuvel,26-09-11
201012PM00105,2010,12PM00,105,0,1,1,eneheuvel,26-09-11
201012PM00106,2010,12PM00,106,2,3,5,eneheuvel,26-09-11
201012PM00107,2010,12PM00,107,14,14,28,eneheuvel,26-09-11
201012PM00108,2010,12PM00,108,22,15,37,eneheuvel,26-09-11
201012PM00109,2010,12PM00,109,4,8,12,eneheuvel,26-09-11
201012PM00201,2010,12PM00,201,1,0,1,eneheuvel,26-09-11
201012PM00207,2010,12PM00,207,0,1,1,eneheuvel,26-09-11
201012PM00212,2010,12PM00,212,0,2,2,eneheuvel,26-09-11
201012PM00214,2010,12PM00,214,1,0,1,eneheuvel,26-09-11
201012PM00303,2010,12PM00,303,1,1,2,eneheuvel,26-09-11
201012PM00311,2010,12PM00,311,1,1,2,eneheuvel,26-09-11
201012PM009999,2010,12PM00,9999,1,1,2,eneheuvel,26-09-11
201012QK00105,2010,12QK00,105,0,1,1,eneheuvel,26-09-11
201012QK00202,2010,12QK00,202,1,0,1,eneheuvel,26-09-11
201012QK00203,2010,12QK00,203,1,0,1,eneheuvel,26-09-11
201012QK00206,2010,12QK00,206,91,102,193,eneheuvel,26-09-11
201012QK00207,2010,12QK00,207,1,1,2,eneheuvel,26-09-11
201012QK00208,2010,12QK00,208,2,1,3,eneheuvel,26-09-11
201012QK00209,2010,12QK00,209,3,3,6,eneheuvel,26-09-11
201012QK00210,2010,12QK00,210,9,9,18,eneheuvel,26-09-11
201012QK00211,2010,12QK00,211,0,1,1,eneheuvel,26-09-11
201012QK00214,2010,12QK00,214,2,1,3,eneheuvel,26-09-11
201012QK00215,2010,12QK00,215,0,5,5,eneheuvel,26-09-11
201012QK00302,2010,12QK00,302,0,1,1,eneheuvel,26-09-11
201012QK00303,2010,12QK00,303,3,1,4,eneheuvel,26-09-11
201012QK00306,2010,12QK00,306,2,0,2,eneheuvel,26-09-11
201012QK00309,2010,12QK00,309,1,0,1,eneheuvel,26-09-11
201012QK00312,2010,12QK00,312,0,1,1,eneheuvel,26-09-11
201012QK009999,2010,12QK00,9999,2,0,2,eneheuvel,26-09-11
201012XA00201,2010,12XA00,201,0,1,1,eneheuvel,26-09-11
201012XA00206,2010,12XA00,206,0,1,1,eneheuvel,26-09-11
201012XA00208,2010,12XA00,208,0,1,1,eneheuvel,26-09-11
201012XA00211,2010,12XA00,211,37,47,84,eneheuvel,26-09-11
201012XA00212,2010,12XA00,212,0,1,1,eneheuvel,26-09-11
201012XA00213,2010,12XA00,213,0,1,1,eneheuvel,26-09-11
201012XA00214,2010,12XA00,214,1,0,1,eneheuvel,26-09-11
201012XA00303,2010,12XA00,303,1,1,2,eneheuvel,26-09-11
201013CW00106,2010,13CW00,106,1,0,1,eneheuvel,26-09-11
201013CW00201,2010,13CW00,201,0,1,1,eneheuvel,26-09-11
201013CW00202,2010,13CW00,202,1,0,1,eneheuvel,26-09-11
201013CW00203,2010,13CW00,203,0,1,1,eneheuvel,26-09-11
201013CW00205,2010,13CW00,205,0,2,2,eneheuvel,26-09-11
201013CW00206,2010,13CW00,206,58,63,121,eneheuvel,26-09-11
201013CW00207,2010,13CW00,207,2,1,3,eneheuvel,26-09-11
201013CW00208,2010,13CW00,208,0,2,2,eneheuvel,26-09-11
201013CW00209,2010,13CW00,209,15,9,24,eneheuvel,26-09-11
201013CW00210,2010,13CW00,210,10,5,15,eneheuvel,26-09-11
201013CW00211,2010,13CW00,211,0,1,1,eneheuvel,26-09-11
201013CW00212,2010,13CW00,212,2,0,2,eneheuvel,26-09-11
201013CW00214,2010,13CW00,214,2,0,2,eneheuvel,26-09-11
201013CW00215,2010,13CW00,215,0,3,3,eneheuvel,26-09-11
201013CW00216,2010,13CW00,216,0,1,1,eneheuvel,26-09-11
201013CW00308,2010,13CW00,308,0,4,4,eneheuvel,26-09-11
201013CW009999,2010,13CW00,9999,3,1,4,eneheuvel,26-09-11
201013IF00101,2010,13IF00,101,2,0,2,eneheuvel,26-09-11
201013IF00201,2010,13IF00,201,0,2,2,eneheuvel,26-09-11
201013IF00208,2010,13IF00,208,2,1,3,eneheuvel,26-09-11
201013IF00210,2010,13IF00,210,1,0,1,eneheuvel,26-09-11
201013IF00211,2010,13IF00,211,0,1,1,eneheuvel,26-09-11
201013IF00214,2010,13IF00,214,0,2,2,eneheuvel,26-09-11
201013IF00301,2010,13IF00,301,7,9,16,eneheuvel,26-09-11
201013IF00302,2010,13IF00,302,3,3,6,eneheuvel,26-09-11
201013IF00303,2010,13IF00,303,4,11,15,eneheuvel,26-09-11
201013IF00304,2010,13IF00,304,32,37,69,eneheuvel,26-09-11
201013IF00305,2010,13IF00,305,5,4,9,eneheuvel,26-09-11
201013IF00306,2010,13IF00,306,8,9,17,eneheuvel,26-09-11
201013IF00307,2010,13IF00,307,3,4,7,eneheuvel,26-09-11
201013IF00308,2010,13IF00,308,2,2,4,eneheuvel,26-09-11
201013IF00309,2010,13IF00,309,3,0,3,eneheuvel,26-09-11
201013IF00311,2010,13IF00,311,0,1,1,eneheuvel,26-09-11
201013IF009999,2010,13IF00,9999,0,2,2,eneheuvel,26-09-11
201013IU00102,2010,13IU00,102,6,8,14,eneheuvel,26-09-11
201013IU00103,2010,13IU00,103,9,5,14,eneheuvel,26-09-11
201013IU00104,2010,13IU00,104,1,2,3,eneheuvel,26-09-11
201013IU00105,2010,13IU00,105,3,3,6,eneheuvel,26-09-11
201013IU00106,2010,13IU00,106,45,39,84,eneheuvel,26-09-11
201013IU00107,2010,13IU00,107,7,4,11,eneheuvel,26-09-11
201013IU00108,2010,13IU00,108,1,4,5,eneheuvel,26-09-11
201013IU00109,2010,13IU00,109,2,2,4,eneheuvel,26-09-11
201013IU00110,2010,13IU00,110,1,2,3,eneheuvel,26-09-11
201013IU00202,2010,13IU00,202,1,0,1,eneheuvel,26-09-11
201013IU00211,2010,13IU00,211,0,1,1,eneheuvel,26-09-11
201013IU00212,2010,13IU00,212,0,2,2,eneheuvel,26-09-11
201013IU00301,2010,13IU00,301,0,1,1,eneheuvel,26-09-11
201013IU00311,2010,13IU00,311,1,0,1,eneheuvel,26-09-11
201013IU00403,2010,13IU00,403,1,0,1,eneheuvel,26-09-11
201013IU009999,2010,13IU00,9999,1,0,1,eneheuvel,26-09-11
201013NH00101,2010,13NH00,101,1,3,4,eneheuvel,26-09-11
201013NH00102,2010,13NH00,102,11,7,18,eneheuvel,26-09-11
201013NH00103,2010,13NH00,103,1,3,4,eneheuvel,26-09-11
201013NH00104,2010,13NH00,104,29,17,46,eneheuvel,26-09-11
201013NH00105,2010,13NH00,105,67,56,123,eneheuvel,26-09-11
201013NH00106,2010,13NH00,106,9,14,23,eneheuvel,26-09-11
201013NH00107,2010,13NH00,107,2,2,4,eneheuvel,26-09-11
201013NH00108,2010,13NH00,108,1,1,2,eneheuvel,26-09-11
201013NH00109,2010,13NH00,109,1,0,1,eneheuvel,26-09-11
201013NH00110,2010,13NH00,110,16,17,33,eneheuvel,26-09-11
201013NH00208,2010,13NH00,208,2,1,3,eneheuvel,26-09-11
201013NH00211,2010,13NH00,211,0,1,1,eneheuvel,26-09-11
201013NH00212,2010,13NH00,212,1,0,1,eneheuvel,26-09-11
201013NH00214,2010,13NH00,214,1,0,1,eneheuvel,26-09-11
201013NH00304,2010,13NH00,304,1,0,1,eneheuvel,26-09-11
201013NH00502,2010,13NH00,502,2,2,4,eneheuvel,26-09-11
201013NH009999,2010,13NH00,9999,3,1,4,eneheuvel,26-09-11
201013NU00204,2010,13NU00,204,1,0,1,eneheuvel,26-09-11
201013NU00205,2010,13NU00,205,0,2,2,eneheuvel,26-09-11
201013NU00211,2010,13NU00,211,2,2,4,eneheuvel,26-09-11
201013NU00216,2010,13NU00,216,0,1,1,eneheuvel,26-09-11
201013NU00301,2010,13NU00,301,12,7,19,eneheuvel,26-09-11
201013NU00302,2010,13NU00,302,3,2,5,eneheuvel,26-09-11
201013NU00303,2010,13NU00,303,24,32,56,eneheuvel,26-09-11
201013NU00304,2010,13NU00,304,56,50,106,eneheuvel,26-09-11
201013NU00305,2010,13NU00,305,18,10,28,eneheuvel,26-09-11
201013NU00306,2010,13NU00,306,16,21,37,eneheuvel,26-09-11
201013NU00307,2010,13NU00,307,1,1,2,eneheuvel,26-09-11
201013NU00308,2010,13NU00,308,2,3,5,eneheuvel,26-09-11
201013NU00309,2010,13NU00,309,1,1,2,eneheuvel,26-09-11
201013NU009999,2010,13NU00,9999,1,0,1,eneheuvel,26-09-11
201014QC00101,2010,14QC00,101,1,0,1,eneheuvel,26-09-11
201014QC00108,2010,14QC00,108,1,0,1,eneheuvel,26-09-11
201014QC00109,2010,14QC00,109,1,3,4,eneheuvel,26-09-11
201014QC00110,2010,14QC00,110,3,0,3,eneheuvel,26-09-11
201014QC00201,2010,14QC00,201,5,0,5,eneheuvel,26-09-11
201014QC00202,2010,14QC00,202,55,44,99,eneheuvel,26-09-11
201014QC00203,2010,14QC00,203,31,37,68,eneheuvel,26-09-11
201014QC00204,2010,14QC00,204,23,21,44,eneheuvel,26-09-11
201014QC00205,2010,14QC00,205,17,15,32,eneheuvel,26-09-11
201014QC00206,2010,14QC00,206,36,9,45,eneheuvel,26-09-11
201014QC00207,2010,14QC00,207,17,8,25,eneheuvel,26-09-11
201014QC00208,2010,14QC00,208,28,19,47,eneheuvel,26-09-11
201014QC00209,2010,14QC00,209,7,0,7,eneheuvel,26-09-11
201014QC00210,2010,14QC00,210,8,5,13,eneheuvel,26-09-11
201014QC00211,2010,14QC00,211,12,7,19,eneheuvel,26-09-11
201014QC00212,2010,14QC00,212,2,4,6,eneheuvel,26-09-11
201014QC00213,2010,14QC00,213,0,4,4,eneheuvel,26-09-11
201014QC00214,2010,14QC00,214,2,1,3,eneheuvel,26-09-11
201014QC00215,2010,14QC00,215,1,3,4,eneheuvel,26-09-11
201014QC00216,2010,14QC00,216,1,2,3,eneheuvel,26-09-11
201014QC00301,2010,14QC00,301,1,0,1,eneheuvel,26-09-11
201014QC00302,2010,14QC00,302,4,4,8,eneheuvel,26-09-11
201014QC00303,2010,14QC00,303,21,5,26,eneheuvel,26-09-11
201014QC00304,2010,14QC00,304,0,2,2,eneheuvel,26-09-11
201014QC00306,2010,14QC00,306,2,0,2,eneheuvel,26-09-11
201014QC00307,2010,14QC00,307,4,2,6,eneheuvel,26-09-11
201014QC00309,2010,14QC00,309,2,1,3,eneheuvel,26-09-11
201014QC00311,2010,14QC00,311,9,6,15,eneheuvel,26-09-11
201014QC00312,2010,14QC00,312,5,4,9,eneheuvel,26-09-11
201014QC00313,2010,14QC00,313,0,1,1,eneheuvel,26-09-11
201014QC00403,2010,14QC00,403,4,3,7,eneheuvel,26-09-11
201014QC00502,2010,14QC00,502,14,10,24,eneheuvel,26-09-11
201014QC009999,2010,14QC00,9999,5,1,6,eneheuvel,26-09-11
201014QC02202,2010,14QC02,202,0,1,1,eneheuvel,26-09-11
201014QC02209,2010,14QC02,209,1,1,2,eneheuvel,26-09-11
201014QC02210,2010,14QC02,210,0,2,2,eneheuvel,26-09-11
201014QC02211,2010,14QC02,211,2,0,2,eneheuvel,26-09-11
201014QC02212,2010,14QC02,212,22,24,46,eneheuvel,26-09-11
201014QC02213,2010,14QC02,213,4,5,9,eneheuvel,26-09-11
201014QC02214,2010,14QC02,214,4,4,8,eneheuvel,26-09-11
201014QC02216,2010,14QC02,216,0,2,2,eneheuvel,26-09-11
201014QC02403,2010,14QC02,403,1,0,1,eneheuvel,26-09-11
201015SJ00101,2010,15SJ00,101,1,3,4,eneheuvel,26-09-11
201015SJ00102,2010,15SJ00,102,1,10,11,eneheuvel,26-09-11
201015SJ00103,2010,15SJ00,103,1,7,8,eneheuvel,26-09-11
201015SJ00104,2010,15SJ00,104,2,3,5,eneheuvel,26-09-11
201015SJ00105,2010,15SJ00,105,1,2,3,eneheuvel,26-09-11
201015SJ00106,2010,15SJ00,106,1,1,2,eneheuvel,26-09-11
201015SJ00108,2010,15SJ00,108,0,8,8,eneheuvel,26-09-11
201015SJ00201,2010,15SJ00,201,0,1,1,eneheuvel,26-09-11
201015SJ00202,2010,15SJ00,202,1,9,10,eneheuvel,26-09-11
201015SJ00203,2010,15SJ00,203,1,8,9,eneheuvel,26-09-11
201015SJ00204,2010,15SJ00,204,0,6,6,eneheuvel,26-09-11
201015SJ00205,2010,15SJ00,205,0,9,9,eneheuvel,26-09-11
201015SJ00206,2010,15SJ00,206,4,13,17,eneheuvel,26-09-11
201015SJ00207,2010,15SJ00,207,1,16,17,eneheuvel,26-09-11
201015SJ00208,2010,15SJ00,208,2,8,10,eneheuvel,26-09-11
201015SJ00209,2010,15SJ00,209,1,9,10,eneheuvel,26-09-11
201015SJ00210,2010,15SJ00,210,2,25,27,eneheuvel,26-09-11
201015SJ00211,2010,15SJ00,211,1,20,21,eneheuvel,26-09-11
201015SJ00212,2010,15SJ00,212,1,11,12,eneheuvel,26-09-11
201015SJ00213,2010,15SJ00,213,0,4,4,eneheuvel,26-09-11
201015SJ00214,2010,15SJ00,214,1,11,12,eneheuvel,26-09-11
201015SJ00216,2010,15SJ00,216,0,6,6,eneheuvel,26-09-11
201015SJ00301,2010,15SJ00,301,0,4,4,eneheuvel,26-09-11
201015SJ00302,2010,15SJ00,302,1,6,7,eneheuvel,26-09-11
201015SJ00303,2010,15SJ00,303,0,9,9,eneheuvel,26-09-11
201015SJ00304,2010,15SJ00,304,1,7,8,eneheuvel,26-09-11
201015SJ00305,2010,15SJ00,305,0,9,9,eneheuvel,26-09-11
201015SJ00306,2010,15SJ00,306,0,8,8,eneheuvel,26-09-11
201015SJ00307,2010,15SJ00,307,2,6,8,eneheuvel,26-09-11
201015SJ00308,2010,15SJ00,308,1,8,9,eneheuvel,26-09-11
201015SJ00309,2010,15SJ00,309,3,7,10,eneheuvel,26-09-11
201015SJ00311,2010,15SJ00,311,4,3,7,eneheuvel,26-09-11
201015SJ00312,2010,15SJ00,312,0,1,1,eneheuvel,26-09-11
201015SJ00401,2010,15SJ00,401,0,2,2,eneheuvel,26-09-11
201015SJ00402,2010,15SJ00,402,0,1,1,eneheuvel,26-09-11
201015SJ009999,2010,15SJ00,9999,1,7,8,eneheuvel,26-09-11
201015ZL00305,2010,15ZL00,305,2,1,3,eneheuvel,26-09-11
201015ZL01206,2010,15ZL01,206,1,1,2,eneheuvel,26-09-11
201015ZL01207,2010,15ZL01,207,0,1,1,eneheuvel,26-09-11
201015ZL01209,2010,15ZL01,209,7,9,16,eneheuvel,26-09-11
201015ZL01210,2010,15ZL01,210,77,63,140,eneheuvel,26-09-11
201015ZL01211,2010,15ZL01,211,1,0,1,eneheuvel,26-09-11
201015ZL01212,2010,15ZL01,212,1,1,2,eneheuvel,26-09-11
201015ZL01215,2010,15ZL01,215,1,1,2,eneheuvel,26-09-11
201015ZL01216,2010,15ZL01,216,1,1,2,eneheuvel,26-09-11
201015ZL01307,2010,15ZL01,307,0,1,1,eneheuvel,26-09-11
201015ZL01309,2010,15ZL01,309,0,1,1,eneheuvel,26-09-11
201015ZL019999,2010,15ZL01,9999,0,2,2,eneheuvel,26-09-11
201016CK00103,2010,16CK00,103,1,0,1,eneheuvel,26-09-11
201016CK00105,2010,16CK00,105,1,0,1,eneheuvel,26-09-11
201016CK00106,2010,16CK00,106,1,0,1,eneheuvel,26-09-11
201016CK00108,2010,16CK00,108,1,0,1,eneheuvel,26-09-11
201016CK00202,2010,16CK00,202,2,0,2,eneheuvel,26-09-11
201016CK00203,2010,16CK00,203,1,0,1,eneheuvel,26-09-11
201016CK00204,2010,16CK00,204,4,0,4,eneheuvel,26-09-11
201016CK00205,2010,16CK00,205,1,0,1,eneheuvel,26-09-11
201016CK00206,2010,16CK00,206,6,0,6,eneheuvel,26-09-11
201016CK00208,2010,16CK00,208,1,0,1,eneheuvel,26-09-11
201016CK00209,2010,16CK00,209,1,0,1,eneheuvel,26-09-11
201016CK00210,2010,16CK00,210,5,0,5,eneheuvel,26-09-11
201016CK00211,2010,16CK00,211,4,0,4,eneheuvel,26-09-11
201016CK00212,2010,16CK00,212,2,0,2,eneheuvel,26-09-11
201016CK00213,2010,16CK00,213,2,0,2,eneheuvel,26-09-11
201016CK00214,2010,16CK00,214,1,0,1,eneheuvel,26-09-11
201016CK00216,2010,16CK00,216,1,0,1,eneheuvel,26-09-11
201016CK00303,2010,16CK00,303,1,0,1,eneheuvel,26-09-11
201016CK00305,2010,16CK00,305,1,0,1,eneheuvel,26-09-11
201016CK00308,2010,16CK00,308,1,0,1,eneheuvel,26-09-11
201016CK00309,2010,16CK00,309,3,0,3,eneheuvel,26-09-11
201016CK00311,2010,16CK00,311,2,0,2,eneheuvel,26-09-11
201016CK00312,2010,16CK00,312,3,0,3,eneheuvel,26-09-11
201016CK00402,2010,16CK00,402,1,0,1,eneheuvel,26-09-11
201016CK009999,2010,16CK00,9999,1,0,1,eneheuvel,26-09-11
201016KK00101,2010,16KK00,101,14,12,26,eneheuvel,26-09-11
201016KK00102,2010,16KK00,102,34,36,70,eneheuvel,26-09-11
201016KK00103,2010,16KK00,103,63,52,115,eneheuvel,26-09-11
201016KK00104,2010,16KK00,104,4,0,4,eneheuvel,26-09-11
201016KK00105,2010,16KK00,105,1,2,3,eneheuvel,26-09-11
201016KK00106,2010,16KK00,106,4,5,9,eneheuvel,26-09-11
201016KK00107,2010,16KK00,107,7,11,18,eneheuvel,26-09-11
201016KK00108,2010,16KK00,108,23,26,49,eneheuvel,26-09-11
201016KK00109,2010,16KK00,109,10,12,22,eneheuvel,26-09-11
201016KK00110,2010,16KK00,110,1,0,1,eneheuvel,26-09-11
201016KK00201,2010,16KK00,201,0,1,1,eneheuvel,26-09-11
201016KK00202,2010,16KK00,202,1,4,5,eneheuvel,26-09-11
201016KK00206,2010,16KK00,206,2,1,3,eneheuvel,26-09-11
201016KK00207,2010,16KK00,207,0,3,3,eneheuvel,26-09-11
201016KK00208,2010,16KK00,208,0,1,1,eneheuvel,26-09-11
201016KK00210,2010,16KK00,210,2,1,3,eneheuvel,26-09-11
201016KK00211,2010,16KK00,211,1,3,4,eneheuvel,26-09-11
201016KK00213,2010,16KK00,213,0,1,1,eneheuvel,26-09-11
201016KK00214,2010,16KK00,214,0,1,1,eneheuvel,26-09-11
201016KK00308,2010,16KK00,308,0,1,1,eneheuvel,26-09-11
201016KK00309,2010,16KK00,309,0,1,1,eneheuvel,26-09-11
201016KK00311,2010,16KK00,311,0,1,1,eneheuvel,26-09-11
201016KK00502,2010,16KK00,502,1,1,2,eneheuvel,26-09-11
201016KK009999,2010,16KK00,9999,2,3,5,eneheuvel,26-09-11
201016LJ00101,2010,16LJ00,101,3,3,6,eneheuvel,26-09-11
201016LJ00102,2010,16LJ00,102,7,7,14,eneheuvel,26-09-11
201016LJ00103,2010,16LJ00,103,2,0,2,eneheuvel,26-09-11
201016LJ00104,2010,16LJ00,104,2,1,3,eneheuvel,26-09-11
201016LJ00105,2010,16LJ00,105,0,1,1,eneheuvel,26-09-11
201016LJ00106,2010,16LJ00,106,42,49,91,eneheuvel,26-09-11
201016LJ00107,2010,16LJ00,107,1,1,2,eneheuvel,26-09-11
201016LJ00108,2010,16LJ00,108,2,2,4,eneheuvel,26-09-11
201016LJ00203,2010,16LJ00,203,1,2,3,eneheuvel,26-09-11
201016LJ00208,2010,16LJ00,208,0,1,1,eneheuvel,26-09-11
201016LJ00209,2010,16LJ00,209,0,1,1,eneheuvel,26-09-11
201016LJ00212,2010,16LJ00,212,1,1,2,eneheuvel,26-09-11
201016LJ00312,2010,16LJ00,312,1,1,2,eneheuvel,26-09-11
201016LJ009999,2010,16LJ00,9999,0,1,1,eneheuvel,26-09-11
201016ML00101,2010,16ML00,101,5,5,10,eneheuvel,26-09-11
201016ML00102,2010,16ML00,102,25,26,51,eneheuvel,26-09-11
201016ML00103,2010,16ML00,103,5,6,11,eneheuvel,26-09-11
201016ML00104,2010,16ML00,104,47,45,92,eneheuvel,26-09-11
201016ML00105,2010,16ML00,105,25,24,49,eneheuvel,26-09-11
201016ML00106,2010,16ML00,106,3,2,5,eneheuvel,26-09-11
201016ML00107,2010,16ML00,107,3,4,7,eneheuvel,26-09-11
201016ML00108,2010,16ML00,108,2,4,6,eneheuvel,26-09-11
201016ML00109,2010,16ML00,109,0,3,3,eneheuvel,26-09-11
201016ML00110,2010,16ML00,110,2,5,7,eneheuvel,26-09-11
201016ML00201,2010,16ML00,201,0,1,1,eneheuvel,26-09-11
201016ML00202,2010,16ML00,202,0,3,3,eneheuvel,26-09-11
201016ML00203,2010,16ML00,203,0,2,2,eneheuvel,26-09-11
201016ML00205,2010,16ML00,205,0,1,1,eneheuvel,26-09-11
201016ML00206,2010,16ML00,206,1,1,2,eneheuvel,26-09-11
201016ML00209,2010,16ML00,209,0,1,1,eneheuvel,26-09-11
201016ML00210,2010,16ML00,210,0,1,1,eneheuvel,26-09-11
201016ML00211,2010,16ML00,211,0,1,1,eneheuvel,26-09-11
201016ML00212,2010,16ML00,212,0,3,3,eneheuvel,26-09-11
201016ML00213,2010,16ML00,213,0,1,1,eneheuvel,26-09-11
201016ML00303,2010,16ML00,303,0,1,1,eneheuvel,26-09-11
201016ML00307,2010,16ML00,307,1,0,1,eneheuvel,26-09-11
201016ML00311,2010,16ML00,311,1,0,1,eneheuvel,26-09-11
201016ML00502,2010,16ML00,502,4,2,6,eneheuvel,26-09-11
201016ML009999,2010,16ML00,9999,1,3,4,eneheuvel,26-09-11
201016OC00101,2010,16OC00,101,2,3,5,eneheuvel,26-09-11
201016OC00102,2010,16OC00,102,1,3,4,eneheuvel,26-09-11
201016OC00103,2010,16OC00,103,9,12,21,eneheuvel,26-09-11
201016OC00104,2010,16OC00,104,0,2,2,eneheuvel,26-09-11
201016OC00105,2010,16OC00,105,1,2,3,eneheuvel,26-09-11
201016OC00106,2010,16OC00,106,4,2,6,eneheuvel,26-09-11
201016OC00107,2010,16OC00,107,65,71,136,eneheuvel,26-09-11
201016OC00108,2010,16OC00,108,22,19,41,eneheuvel,26-09-11
201016OC00109,2010,16OC00,109,40,56,96,eneheuvel,26-09-11
201016OC00203,2010,16OC00,203,1,1,2,eneheuvel,26-09-11
201016OC00207,2010,16OC00,207,1,0,1,eneheuvel,26-09-11
201016OC00208,2010,16OC00,208,1,0,1,eneheuvel,26-09-11
201016OC00213,2010,16OC00,213,0,2,2,eneheuvel,26-09-11
201016OC00214,2010,16OC00,214,1,0,1,eneheuvel,26-09-11
201016OC00309,2010,16OC00,309,1,1,2,eneheuvel,26-09-11
201016OC00502,2010,16OC00,502,2,0,2,eneheuvel,26-09-11
201016OC009999,2010,16OC00,9999,2,1,3,eneheuvel,26-09-11
201016UK00101,2010,16UK00,101,1,0,1,eneheuvel,26-09-11
201016UK00102,2010,16UK00,102,0,1,1,eneheuvel,26-09-11
201016UK00103,2010,16UK00,103,4,5,9,eneheuvel,26-09-11
201016UK00108,2010,16UK00,108,58,67,125,eneheuvel,26-09-11
201016UK00109,2010,16UK00,109,0,1,1,eneheuvel,26-09-11
201016UK009999,2010,16UK00,9999,1,4,5,eneheuvel,26-09-11
201016WV00108,2010,16WV00,108,1,0,1,eneheuvel,26-09-11
201016WV00201,2010,16WV00,201,6,2,8,eneheuvel,26-09-11
201016WV00202,2010,16WV00,202,0,1,1,eneheuvel,26-09-11
201016WV00204,2010,16WV00,204,1,1,2,eneheuvel,26-09-11
201016WV00209,2010,16WV00,209,5,16,21,eneheuvel,26-09-11
201016WV00211,2010,16WV00,211,60,49,109,eneheuvel,26-09-11
201016WV00213,2010,16WV00,213,2,0,2,eneheuvel,26-09-11
201016WV00214,2010,16WV00,214,2,1,3,eneheuvel,26-09-11
201016WV00403,2010,16WV00,403,1,0,1,eneheuvel,26-09-11
201016WV009999,2010,16WV00,9999,1,2,3,eneheuvel,26-09-11
201016YS00108,2010,16YS00,108,2,0,2,eneheuvel,26-09-11
201016YS00201,2010,16YS00,201,8,5,13,eneheuvel,26-09-11
201016YS00202,2010,16YS00,202,1,2,3,eneheuvel,26-09-11
201016YS00205,2010,16YS00,205,0,1,1,eneheuvel,26-09-11
201016YS00207,2010,16YS00,207,3,1,4,eneheuvel,26-09-11
201016YS00209,2010,16YS00,209,1,1,2,eneheuvel,26-09-11
201016YS00210,2010,16YS00,210,1,0,1,eneheuvel,26-09-11
201016YS00211,2010,16YS00,211,75,82,157,eneheuvel,26-09-11
201016YS00212,2010,16YS00,212,1,3,4,eneheuvel,26-09-11
201016YS00213,2010,16YS00,213,1,2,3,eneheuvel,26-09-11
201016YS00303,2010,16YS00,303,1,0,1,eneheuvel,26-09-11
201016YS00307,2010,16YS00,307,1,0,1,eneheuvel,26-09-11
201016YS00309,2010,16YS00,309,1,1,2,eneheuvel,26-09-11
201016YS00311,2010,16YS00,311,1,0,1,eneheuvel,26-09-11
201016ZG00103,2010,16ZG00,103,0,1,1,eneheuvel,26-09-11
201016ZG00201,2010,16ZG00,201,1,0,1,eneheuvel,26-09-11
201016ZG00208,2010,16ZG00,208,1,0,1,eneheuvel,26-09-11
201016ZG00210,2010,16ZG00,210,0,1,1,eneheuvel,26-09-11
201016ZG00211,2010,16ZG00,211,64,58,122,eneheuvel,26-09-11
201016ZG00213,2010,16ZG00,213,0,1,1,eneheuvel,26-09-11
201016ZG00214,2010,16ZG00,214,0,1,1,eneheuvel,26-09-11
201016ZG00301,2010,16ZG00,301,1,0,1,eneheuvel,26-09-11
201016ZG00303,2010,16ZG00,303,1,0,1,eneheuvel,26-09-11
201016ZG00305,2010,16ZG00,305,0,1,1,eneheuvel,26-09-11
201016ZX00201,2010,16ZX00,201,0,1,1,eneheuvel,26-09-11
201016ZX00206,2010,16ZX00,206,12,14,26,eneheuvel,26-09-11
201016ZX00208,2010,16ZX00,208,1,0,1,eneheuvel,26-09-11
201016ZX00209,2010,16ZX00,209,32,25,57,eneheuvel,26-09-11
201016ZX00210,2010,16ZX00,210,1,0,1,eneheuvel,26-09-11
201016ZX00212,2010,16ZX00,212,0,1,1,eneheuvel,26-09-11
201016ZX00214,2010,16ZX00,214,1,0,1,eneheuvel,26-09-11
201016ZX00304,2010,16ZX00,304,1,0,1,eneheuvel,26-09-11
201016ZX009999,2010,16ZX00,9999,1,2,3,eneheuvel,26-09-11
201017AK00201,2010,17AK00,201,1,0,1,eneheuvel,26-09-11
201017AK00205,2010,17AK00,205,0,1,1,eneheuvel,26-09-11
201017AK00206,2010,17AK00,206,53,61,114,eneheuvel,26-09-11
201017AK00207,2010,17AK00,207,1,2,3,eneheuvel,26-09-11
201017AK00209,2010,17AK00,209,2,1,3,eneheuvel,26-09-11
201017AK00210,2010,17AK00,210,4,4,8,eneheuvel,26-09-11
201017AK00211,2010,17AK00,211,1,1,2,eneheuvel,26-09-11
201017AK00303,2010,17AK00,303,1,0,1,eneheuvel,26-09-11
201017AK00306,2010,17AK00,306,1,1,2,eneheuvel,26-09-11
201017AK00307,2010,17AK00,307,0,2,2,eneheuvel,26-09-11
201017AK00309,2010,17AK00,309,0,2,2,eneheuvel,26-09-11
201017AK00312,2010,17AK00,312,2,0,2,eneheuvel,26-09-11
201017AV00202,2010,17AV00,202,0,1,1,eneheuvel,26-09-11
201017AV00205,2010,17AV00,205,3,1,4,eneheuvel,26-09-11
201017AV00206,2010,17AV00,206,66,69,135,eneheuvel,26-09-11
201017AV00207,2010,17AV00,207,2,0,2,eneheuvel,26-09-11
201017AV00209,2010,17AV00,209,2,1,3,eneheuvel,26-09-11
201017AV00210,2010,17AV00,210,0,1,1,eneheuvel,26-09-11
201017AV00216,2010,17AV00,216,0,1,1,eneheuvel,26-09-11
201017AV00307,2010,17AV00,307,0,1,1,eneheuvel,26-09-11
201017AV00311,2010,17AV00,311,1,0,1,eneheuvel,26-09-11
201017AV00312,2010,17AV00,312,1,0,1,eneheuvel,26-09-11
201017AV009999,2010,17AV00,9999,0,3,3,eneheuvel,26-09-11
201017BP00103,2010,17BP00,103,1,0,1,eneheuvel,26-09-11
201017BP00201,2010,17BP00,201,2,0,2,eneheuvel,26-09-11
201017BP00209,2010,17BP00,209,3,1,4,eneheuvel,26-09-11
201017BP00210,2010,17BP00,210,1,2,3,eneheuvel,26-09-11
201017BP00211,2010,17BP00,211,49,46,95,eneheuvel,26-09-11
201017BP00212,2010,17BP00,212,4,5,9,eneheuvel,26-09-11
201017BP00213,2010,17BP00,213,53,71,124,eneheuvel,26-09-11
201017BP00214,2010,17BP00,214,0,3,3,eneheuvel,26-09-11
201017BP009999,2010,17BP00,9999,0,1,1,eneheuvel,26-09-11
201017DA00201,2010,17DA00,201,1,0,1,eneheuvel,26-09-11
201017DA00207,2010,17DA00,207,0,1,1,eneheuvel,26-09-11
201017DA00209,2010,17DA00,209,3,7,10,eneheuvel,26-09-11
201017DA00210,2010,17DA00,210,40,53,93,eneheuvel,26-09-11
201017DA00302,2010,17DA00,302,0,2,2,eneheuvel,26-09-11
201017DA00303,2010,17DA00,303,0,2,2,eneheuvel,26-09-11
201017DA00307,2010,17DA00,307,0,1,1,eneheuvel,26-09-11
201017DA00402,2010,17DA00,402,0,1,1,eneheuvel,26-09-11
201017DA00403,2010,17DA00,403,1,0,1,eneheuvel,26-09-11
201017DK00202,2010,17DK00,202,1,1,2,eneheuvel,26-09-11
201017DK00203,2010,17DK00,203,0,1,1,eneheuvel,26-09-11
201017DK00206,2010,17DK00,206,1,2,3,eneheuvel,26-09-11
201017DK00207,2010,17DK00,207,1,1,2,eneheuvel,26-09-11
201017DK00208,2010,17DK00,208,3,1,4,eneheuvel,26-09-11
201017DK00301,2010,17DK00,301,2,6,8,eneheuvel,26-09-11
201017DK00302,2010,17DK00,302,1,2,3,eneheuvel,26-09-11
201017DK00303,2010,17DK00,303,1,3,4,eneheuvel,26-09-11
201017DK00304,2010,17DK00,304,44,46,90,eneheuvel,26-09-11
201017DK00305,2010,17DK00,305,6,3,9,eneheuvel,26-09-11
201017DK00306,2010,17DK00,306,1,3,4,eneheuvel,26-09-11
201017DK00307,2010,17DK00,307,1,0,1,eneheuvel,26-09-11
201017DK00308,2010,17DK00,308,2,1,3,eneheuvel,26-09-11
201017DK00309,2010,17DK00,309,2,3,5,eneheuvel,26-09-11
201017DK009999,2010,17DK00,9999,0,1,1,eneheuvel,26-09-11
201017DV00101,2010,17DV00,101,1,0,1,eneheuvel,26-09-11
201017DV00108,2010,17DV00,108,0,1,1,eneheuvel,26-09-11
201017DV00201,2010,17DV00,201,4,0,4,eneheuvel,26-09-11
201017DV00202,2010,17DV00,202,0,1,1,eneheuvel,26-09-11
201017DV00203,2010,17DV00,203,2,1,3,eneheuvel,26-09-11
201017DV00204,2010,17DV00,204,0,1,1,eneheuvel,26-09-11
201017DV00205,2010,17DV00,205,1,1,2,eneheuvel,26-09-11
201017DV00207,2010,17DV00,207,4,4,8,eneheuvel,26-09-11
201017DV00208,2010,17DV00,208,2,0,2,eneheuvel,26-09-11
201017DV00211,2010,17DV00,211,1,0,1,eneheuvel,26-09-11
201017DV00216,2010,17DV00,216,1,1,2,eneheuvel,26-09-11
201017DV00301,2010,17DV00,301,19,8,27,eneheuvel,26-09-11
201017DV00302,2010,17DV00,302,5,7,12,eneheuvel,26-09-11
201017DV00303,2010,17DV00,303,29,34,63,eneheuvel,26-09-11
201017DV00304,2010,17DV00,304,31,43,74,eneheuvel,26-09-11
201017DV00305,2010,17DV00,305,8,7,15,eneheuvel,26-09-11
201017DV00306,2010,17DV00,306,11,8,19,eneheuvel,26-09-11
201017DV00307,2010,17DV00,307,5,9,14,eneheuvel,26-09-11
201017DV00308,2010,17DV00,308,14,9,23,eneheuvel,26-09-11
201017DV00309,2010,17DV00,309,23,16,39,eneheuvel,26-09-11
201017DV00310,2010,17DV00,310,0,2,2,eneheuvel,26-09-11
201017DV00311,2010,17DV00,311,5,6,11,eneheuvel,26-09-11
201017DV00312,2010,17DV00,312,4,1,5,eneheuvel,26-09-11
201017DV00502,2010,17DV00,502,0,1,1,eneheuvel,26-09-11
201017DV009999,2010,17DV00,9999,2,2,4,eneheuvel,26-09-11
201017FI00101,2010,17FI00,101,0,1,1,eneheuvel,26-09-11
201017FI00102,2010,17FI00,102,0,7,7,eneheuvel,26-09-11
201017FI00103,2010,17FI00,103,1,1,2,eneheuvel,26-09-11
201017FI00106,2010,17FI00,106,0,3,3,eneheuvel,26-09-11
201017FI00108,2010,17FI00,108,0,7,7,eneheuvel,26-09-11
201017FI00202,2010,17FI00,202,1,22,23,eneheuvel,26-09-11
201017FI00203,2010,17FI00,203,1,6,7,eneheuvel,26-09-11
201017FI00204,2010,17FI00,204,0,10,10,eneheuvel,26-09-11
201017FI00205,2010,17FI00,205,0,3,3,eneheuvel,26-09-11
201017FI00206,2010,17FI00,206,1,7,8,eneheuvel,26-09-11
201017FI00207,2010,17FI00,207,0,5,5,eneheuvel,26-09-11
201017FI00208,2010,17FI00,208,1,14,15,eneheuvel,26-09-11
201017FI00209,2010,17FI00,209,1,4,5,eneheuvel,26-09-11
201017FI00210,2010,17FI00,210,1,5,6,eneheuvel,26-09-11
201017FI00211,2010,17FI00,211,5,9,14,eneheuvel,26-09-11
201017FI00212,2010,17FI00,212,0,6,6,eneheuvel,26-09-11
201017FI00213,2010,17FI00,213,2,5,7,eneheuvel,26-09-11
201017FI00214,2010,17FI00,214,0,9,9,eneheuvel,26-09-11
201017FI00216,2010,17FI00,216,1,2,3,eneheuvel,26-09-11
201017FI00302,2010,17FI00,302,1,3,4,eneheuvel,26-09-11
201017FI00303,2010,17FI00,303,1,5,6,eneheuvel,26-09-11
201017FI00304,2010,17FI00,304,0,5,5,eneheuvel,26-09-11
201017FI00305,2010,17FI00,305,0,5,5,eneheuvel,26-09-11
201017FI00306,2010,17FI00,306,1,2,3,eneheuvel,26-09-11
201017FI00307,2010,17FI00,307,0,7,7,eneheuvel,26-09-11
201017FI00308,2010,17FI00,308,1,2,3,eneheuvel,26-09-11
201017FI00309,2010,17FI00,309,1,3,4,eneheuvel,26-09-11
201017FI00310,2010,17FI00,310,0,1,1,eneheuvel,26-09-11
201017FI00311,2010,17FI00,311,1,4,5,eneheuvel,26-09-11
201017FI00312,2010,17FI00,312,0,4,4,eneheuvel,26-09-11
201017FI00402,2010,17FI00,402,0,1,1,eneheuvel,26-09-11
201017FI00403,2010,17FI00,403,0,1,1,eneheuvel,26-09-11
201017FI00502,2010,17FI00,502,0,1,1,eneheuvel,26-09-11
201017FI009999,2010,17FI00,9999,0,7,7,eneheuvel,26-09-11
201017LP00207,2010,17LP00,207,1,0,1,eneheuvel,26-09-11
201017LP00210,2010,17LP00,210,1,0,1,eneheuvel,26-09-11
201017LP00212,2010,17LP00,212,0,1,1,eneheuvel,26-09-11
201017LP00301,2010,17LP00,301,0,1,1,eneheuvel,26-09-11
201017LP00303,2010,17LP00,303,1,0,1,eneheuvel,26-09-11
201017LP00304,2010,17LP00,304,1,0,1,eneheuvel,26-09-11
201017LP00305,2010,17LP00,305,57,53,110,eneheuvel,26-09-11
201017LP00306,2010,17LP00,306,8,4,12,eneheuvel,26-09-11
201017LP00309,2010,17LP00,309,1,1,2,eneheuvel,26-09-11
201017LP00310,2010,17LP00,310,0,1,1,eneheuvel,26-09-11
201017LP00312,2010,17LP00,312,2,0,2,eneheuvel,26-09-11
201017MH00202,2010,17MH00,202,1,2,3,eneheuvel,26-09-11
201017MH00203,2010,17MH00,203,0,1,1,eneheuvel,26-09-11
201017MH00205,2010,17MH00,205,0,1,1,eneheuvel,26-09-11
201017MH00206,2010,17MH00,206,0,1,1,eneheuvel,26-09-11
201017MH00207,2010,17MH00,207,0,2,2,eneheuvel,26-09-11
201017MH00208,2010,17MH00,208,0,2,2,eneheuvel,26-09-11
201017MH00209,2010,17MH00,209,2,0,2,eneheuvel,26-09-11
201017MH00210,2010,17MH00,210,0,2,2,eneheuvel,26-09-11
201017MH00211,2010,17MH00,211,0,2,2,eneheuvel,26-09-11
201017MH00212,2010,17MH00,212,0,1,1,eneheuvel,26-09-11
201017MH00216,2010,17MH00,216,0,1,1,eneheuvel,26-09-11
201017MH00302,2010,17MH00,302,1,1,2,eneheuvel,26-09-11
201017MH00303,2010,17MH00,303,1,2,3,eneheuvel,26-09-11
201017MH00304,2010,17MH00,304,0,3,3,eneheuvel,26-09-11
201017MH00305,2010,17MH00,305,86,107,193,eneheuvel,26-09-11
201017MH00306,2010,17MH00,306,5,7,12,eneheuvel,26-09-11
201017MH00307,2010,17MH00,307,1,4,5,eneheuvel,26-09-11
201017MH00308,2010,17MH00,308,3,2,5,eneheuvel,26-09-11
201017MH00309,2010,17MH00,309,5,5,10,eneheuvel,26-09-11
201017MH00311,2010,17MH00,311,3,1,4,eneheuvel,26-09-11
201017MH00312,2010,17MH00,312,0,1,1,eneheuvel,26-09-11
201017MH00403,2010,17MH00,403,1,0,1,eneheuvel,26-09-11
201017MH009999,2010,17MH00,9999,2,0,2,eneheuvel,26-09-11
201021KO00108,2010,21KO00,108,1,0,1,eneheuvel,26-09-11
201021KO00201,2010,21KO00,201,2,0,2,eneheuvel,26-09-11
201021KO00202,2010,21KO00,202,0,1,1,eneheuvel,26-09-11
201021KO00206,2010,21KO00,206,0,1,1,eneheuvel,26-09-11
201021KO00209,2010,21KO00,209,8,6,14,eneheuvel,26-09-11
201021KO00210,2010,21KO00,210,73,78,151,eneheuvel,26-09-11
201021KO00211,2010,21KO00,211,2,3,5,eneheuvel,26-09-11
201021KO00212,2010,21KO00,212,2,0,2,eneheuvel,26-09-11
201021KO00216,2010,21KO00,216,0,3,3,eneheuvel,26-09-11
201021NC00103,2010,21NC00,103,0,1,1,eneheuvel,26-09-11
201021NC00211,2010,21NC00,211,5,3,8,eneheuvel,26-09-11
201021NC00212,2010,21NC00,212,5,7,12,eneheuvel,26-09-11
201021NC00213,2010,21NC00,213,54,54,108,eneheuvel,26-09-11
201021NC00214,2010,21NC00,214,7,16,23,eneheuvel,26-09-11
201021NC00216,2010,21NC00,216,0,1,1,eneheuvel,26-09-11
201021NC00301,2010,21NC00,301,1,0,1,eneheuvel,26-09-11
201021NC00401,2010,21NC00,401,0,1,1,eneheuvel,26-09-11
201021NC00402,2010,21NC00,402,0,1,1,eneheuvel,26-09-11
201021NC009999,2010,21NC00,9999,3,1,4,eneheuvel,26-09-11
201021ND00102,2010,21ND00,102,0,1,1,eneheuvel,26-09-11
201021ND00103,2010,21ND00,103,0,1,1,eneheuvel,26-09-11
201021ND00202,2010,21ND00,202,1,0,1,eneheuvel,26-09-11
201021ND00209,2010,21ND00,209,0,1,1,eneheuvel,26-09-11
201021ND00211,2010,21ND00,211,14,15,29,eneheuvel,26-09-11
201021ND00212,2010,21ND00,212,7,5,12,eneheuvel,26-09-11
201021ND00213,2010,21ND00,213,60,83,143,eneheuvel,26-09-11
201021ND00214,2010,21ND00,214,1,1,2,eneheuvel,26-09-11
201021ND00402,2010,21ND00,402,1,0,1,eneheuvel,26-09-11
201022KP00202,2010,22KP00,202,2,0,2,eneheuvel,26-09-11
201022KP00203,2010,22KP00,203,0,1,1,eneheuvel,26-09-11
201022KP00204,2010,22KP00,204,1,0,1,eneheuvel,26-09-11
201022KP00205,2010,22KP00,205,0,1,1,eneheuvel,26-09-11
201022KP00208,2010,22KP00,208,3,4,7,eneheuvel,26-09-11
201022KP00210,2010,22KP00,210,1,1,2,eneheuvel,26-09-11
201022KP00211,2010,22KP00,211,3,0,3,eneheuvel,26-09-11
201022KP00212,2010,22KP00,212,0,1,1,eneheuvel,26-09-11
201022KP00301,2010,22KP00,301,2,1,3,eneheuvel,26-09-11
201022KP00302,2010,22KP00,302,6,7,13,eneheuvel,26-09-11
201022KP00303,2010,22KP00,303,3,6,9,eneheuvel,26-09-11
201022KP00304,2010,22KP00,304,1,3,4,eneheuvel,26-09-11
201022KP00305,2010,22KP00,305,1,0,1,eneheuvel,26-09-11
201022KP00306,2010,22KP00,306,0,2,2,eneheuvel,26-09-11
201022KP00307,2010,22KP00,307,1,3,4,eneheuvel,26-09-11
201022KP00308,2010,22KP00,308,2,12,14,eneheuvel,26-09-11
201022KP00309,2010,22KP00,309,124,151,275,eneheuvel,26-09-11
201022KP00310,2010,22KP00,310,9,3,12,eneheuvel,26-09-11
201022KP00311,2010,22KP00,311,18,17,35,eneheuvel,26-09-11
201022KP00312,2010,22KP00,312,0,6,6,eneheuvel,26-09-11
201022KP009999,2010,22KP00,9999,1,1,2,eneheuvel,26-09-11
201022KQ00201,2010,22KQ00,201,2,2,4,eneheuvel,26-09-11
201022KQ00205,2010,22KQ00,205,1,1,2,eneheuvel,26-09-11
201022KQ00208,2010,22KQ00,208,2,0,2,eneheuvel,26-09-11
201022KQ00209,2010,22KQ00,209,2,2,4,eneheuvel,26-09-11
201022KQ00210,2010,22KQ00,210,48,76,124,eneheuvel,26-09-11
201022KQ00211,2010,22KQ00,211,1,2,3,eneheuvel,26-09-11
201022KQ00212,2010,22KQ00,212,1,2,3,eneheuvel,26-09-11
201022KQ00307,2010,22KQ00,307,0,1,1,eneheuvel,26-09-11
201022KQ009999,2010,22KQ00,9999,1,0,1,eneheuvel,26-09-11
201023ER00201,2010,23ER00,201,1,0,1,eneheuvel,26-09-11
201023ER00210,2010,23ER00,210,1,0,1,eneheuvel,26-09-11
201023ER00212,2010,23ER00,212,52,74,126,eneheuvel,26-09-11
201023ER00213,2010,23ER00,213,3,0,3,eneheuvel,26-09-11
201023ER00214,2010,23ER00,214,0,1,1,eneheuvel,26-09-11
201023ER00216,2010,23ER00,216,0,1,1,eneheuvel,26-09-11
201023ER00303,2010,23ER00,303,0,2,2,eneheuvel,26-09-11
201023ER009999,2010,23ER00,9999,1,1,2,eneheuvel,26-09-11
201023ET00108,2010,23ET00,108,0,1,1,eneheuvel,26-09-11
201023ET00201,2010,23ET00,201,1,1,2,eneheuvel,26-09-11
201023ET00202,2010,23ET00,202,1,1,2,eneheuvel,26-09-11
201023ET00203,2010,23ET00,203,0,1,1,eneheuvel,26-09-11
201023ET00204,2010,23ET00,204,0,1,1,eneheuvel,26-09-11
201023ET00207,2010,23ET00,207,0,1,1,eneheuvel,26-09-11
201023ET00208,2010,23ET00,208,1,2,3,eneheuvel,26-09-11
201023ET00210,2010,23ET00,210,0,1,1,eneheuvel,26-09-11
201023ET00211,2010,23ET00,211,0,1,1,eneheuvel,26-09-11
201023ET00214,2010,23ET00,214,0,1,1,eneheuvel,26-09-11
201023ET00302,2010,23ET00,302,0,2,2,eneheuvel,26-09-11
201023ET00305,2010,23ET00,305,1,0,1,eneheuvel,26-09-11
201023ET00306,2010,23ET00,306,1,5,6,eneheuvel,26-09-11
201023ET00307,2010,23ET00,307,3,6,9,eneheuvel,26-09-11
201023ET00308,2010,23ET00,308,62,67,129,eneheuvel,26-09-11
201023ET00309,2010,23ET00,309,1,10,11,eneheuvel,26-09-11
201023ET00311,2010,23ET00,311,3,1,4,eneheuvel,26-09-11
201023ET00312,2010,23ET00,312,1,6,7,eneheuvel,26-09-11
201023ET009999,2010,23ET00,9999,0,1,1,eneheuvel,26-09-11
201023EU00207,2010,23EU00,207,1,2,3,eneheuvel,26-09-11
201023EU00301,2010,23EU00,301,0,1,1,eneheuvel,26-09-11
201023EU00302,2010,23EU00,302,0,1,1,eneheuvel,26-09-11
201023EU00303,2010,23EU00,303,1,3,4,eneheuvel,26-09-11
201023EU00305,2010,23EU00,305,1,7,8,eneheuvel,26-09-11
201023EU00306,2010,23EU00,306,72,107,179,eneheuvel,26-09-11
201023EU00307,2010,23EU00,307,7,5,12,eneheuvel,26-09-11
201023EU00309,2010,23EU00,309,1,0,1,eneheuvel,26-09-11
201023EU00311,2010,23EU00,311,1,2,3,eneheuvel,26-09-11
201023EU00313,2010,23EU00,313,0,1,1,eneheuvel,26-09-11
201023EU009999,2010,23EU00,9999,0,1,1,eneheuvel,26-09-11
201023EV00102,2010,23EV00,102,1,0,1,eneheuvel,26-09-11
201023EV00110,2010,23EV00,110,1,1,2,eneheuvel,26-09-11
201023EV00201,2010,23EV00,201,0,1,1,eneheuvel,26-09-11
201023EV00203,2010,23EV00,203,0,1,1,eneheuvel,26-09-11
201023EV00204,2010,23EV00,204,0,1,1,eneheuvel,26-09-11
201023EV00206,2010,23EV00,206,0,2,2,eneheuvel,26-09-11
201023EV00208,2010,23EV00,208,0,1,1,eneheuvel,26-09-11
201023EV00210,2010,23EV00,210,11,8,19,eneheuvel,26-09-11
201023EV00211,2010,23EV00,211,7,8,15,eneheuvel,26-09-11
201023EV00212,2010,23EV00,212,74,105,179,eneheuvel,26-09-11
201023EV00213,2010,23EV00,213,32,21,53,eneheuvel,26-09-11
201023EV00214,2010,23EV00,214,4,4,8,eneheuvel,26-09-11
201023EV00302,2010,23EV00,302,1,0,1,eneheuvel,26-09-11
201023EV00312,2010,23EV00,312,0,1,1,eneheuvel,26-09-11
201023EV00403,2010,23EV00,403,0,1,1,eneheuvel,26-09-11
201023EV009999,2010,23EV00,9999,2,2,4,eneheuvel,26-09-11
201023EY00103,2010,23EY00,103,1,0,1,eneheuvel,26-09-11
201023EY00201,2010,23EY00,201,0,1,1,eneheuvel,26-09-11
201023EY00202,2010,23EY00,202,1,0,1,eneheuvel,26-09-11
201023EY00206,2010,23EY00,206,0,1,1,eneheuvel,26-09-11
201023EY00208,2010,23EY00,208,1,1,2,eneheuvel,26-09-11
201023EY00209,2010,23EY00,209,1,1,2,eneheuvel,26-09-11
201023EY00210,2010,23EY00,210,11,11,22,eneheuvel,26-09-11
201023EY00211,2010,23EY00,211,10,14,24,eneheuvel,26-09-11
201023EY00212,2010,23EY00,212,115,112,227,eneheuvel,26-09-11
201023EY00213,2010,23EY00,213,24,26,50,eneheuvel,26-09-11
201023EY00214,2010,23EY00,214,4,3,7,eneheuvel,26-09-11
201023EY00215,2010,23EY00,215,1,1,2,eneheuvel,26-09-11
201023EY00216,2010,23EY00,216,0,2,2,eneheuvel,26-09-11
201023EY00304,2010,23EY00,304,0,1,1,eneheuvel,26-09-11
201023EY00311,2010,23EY00,311,1,0,1,eneheuvel,26-09-11
201023EY00401,2010,23EY00,401,0,1,1,eneheuvel,26-09-11
201023EY009999,2010,23EY00,9999,2,3,5,eneheuvel,26-09-11
201023ZU00110,2010,23ZU00,110,2,0,2,eneheuvel,26-09-11
201023ZU00201,2010,23ZU00,201,3,0,3,eneheuvel,26-09-11
201023ZU00202,2010,23ZU00,202,68,84,152,eneheuvel,26-09-11
201023ZU00203,2010,23ZU00,203,14,9,23,eneheuvel,26-09-11
201023ZU00204,2010,23ZU00,204,54,48,102,eneheuvel,26-09-11
201023ZU00205,2010,23ZU00,205,71,105,176,eneheuvel,26-09-11
201023ZU00206,2010,23ZU00,206,3,2,5,eneheuvel,26-09-11
201023ZU00207,2010,23ZU00,207,31,26,57,eneheuvel,26-09-11
201023ZU00208,2010,23ZU00,208,21,20,41,eneheuvel,26-09-11
201023ZU00209,2010,23ZU00,209,4,0,4,eneheuvel,26-09-11
201023ZU00210,2010,23ZU00,210,1,1,2,eneheuvel,26-09-11
201023ZU00211,2010,23ZU00,211,2,1,3,eneheuvel,26-09-11
201023ZU00214,2010,23ZU00,214,0,1,1,eneheuvel,26-09-11
201023ZU00215,2010,23ZU00,215,0,2,2,eneheuvel,26-09-11
201023ZU00216,2010,23ZU00,216,3,1,4,eneheuvel,26-09-11
201023ZU00303,2010,23ZU00,303,0,2,2,eneheuvel,26-09-11
201023ZU00305,2010,23ZU00,305,1,0,1,eneheuvel,26-09-11
201023ZU00306,2010,23ZU00,306,1,2,3,eneheuvel,26-09-11
201023ZU00308,2010,23ZU00,308,0,1,1,eneheuvel,26-09-11
201023ZU00309,2010,23ZU00,309,0,2,2,eneheuvel,26-09-11
201023ZU00311,2010,23ZU00,311,1,1,2,eneheuvel,26-09-11
201023ZU00502,2010,23ZU00,502,2,2,4,eneheuvel,26-09-11
201023ZU009999,2010,23ZU00,9999,3,0,3,eneheuvel,26-09-11
201023ZV00107,2010,23ZV00,107,0,1,1,eneheuvel,26-09-11
201023ZV00201,2010,23ZV00,201,2,2,4,eneheuvel,26-09-11
201023ZV00202,2010,23ZV00,202,23,37,60,eneheuvel,26-09-11
201023ZV00203,2010,23ZV00,203,5,4,9,eneheuvel,26-09-11
201023ZV00204,2010,23ZV00,204,18,28,46,eneheuvel,26-09-11
201023ZV00205,2010,23ZV00,205,26,47,73,eneheuvel,26-09-11
201023ZV00207,2010,23ZV00,207,10,10,20,eneheuvel,26-09-11
201023ZV00208,2010,23ZV00,208,2,10,12,eneheuvel,26-09-11
201023ZV00210,2010,23ZV00,210,1,3,4,eneheuvel,26-09-11
201023ZV00211,2010,23ZV00,211,3,1,4,eneheuvel,26-09-11
201023ZV00212,2010,23ZV00,212,1,2,3,eneheuvel,26-09-11
201023ZV00302,2010,23ZV00,302,1,0,1,eneheuvel,26-09-11
201023ZV00308,2010,23ZV00,308,1,1,2,eneheuvel,26-09-11
201023ZV00309,2010,23ZV00,309,1,0,1,eneheuvel,26-09-11
201023ZV00311,2010,23ZV00,311,1,0,1,eneheuvel,26-09-11
201023ZV00312,2010,23ZV00,312,1,2,3,eneheuvel,26-09-11
201023ZV009999,2010,23ZV00,9999,0,1,1,eneheuvel,26-09-11
201023ZW00201,2010,23ZW00,201,1,1,2,eneheuvel,26-09-11
201023ZW00206,2010,23ZW00,206,1,1,2,eneheuvel,26-09-11
201023ZW00208,2010,23ZW00,208,3,4,7,eneheuvel,26-09-11
201023ZW00211,2010,23ZW00,211,0,1,1,eneheuvel,26-09-11
201023ZW00301,2010,23ZW00,301,2,0,2,eneheuvel,26-09-11
201023ZW00302,2010,23ZW00,302,6,3,9,eneheuvel,26-09-11
201023ZW00303,2010,23ZW00,303,4,3,7,eneheuvel,26-09-11
201023ZW00304,2010,23ZW00,304,2,1,3,eneheuvel,26-09-11
201023ZW00305,2010,23ZW00,305,1,4,5,eneheuvel,26-09-11
201023ZW00306,2010,23ZW00,306,20,32,52,eneheuvel,26-09-11
201023ZW00307,2010,23ZW00,307,57,80,137,eneheuvel,26-09-11
201023ZW00308,2010,23ZW00,308,89,84,173,eneheuvel,26-09-11
201023ZW00309,2010,23ZW00,309,3,10,13,eneheuvel,26-09-11
201023ZW00310,2010,23ZW00,310,1,2,3,eneheuvel,26-09-11
201023ZW00311,2010,23ZW00,311,2,0,2,eneheuvel,26-09-11
201023ZW00312,2010,23ZW00,312,4,5,9,eneheuvel,26-09-11
201023ZW00401,2010,23ZW00,401,1,0,1,eneheuvel,26-09-11
201023ZW00403,2010,23ZW00,403,0,1,1,eneheuvel,26-09-11
201023ZW00502,2010,23ZW00,502,3,1,4,eneheuvel,26-09-11
201023ZW009999,2010,23ZW00,9999,1,3,4,eneheuvel,26-09-11
201023ZX00104,2010,23ZX00,104,0,1,1,eneheuvel,26-09-11
201023ZX00201,2010,23ZX00,201,11,4,15,eneheuvel,26-09-11
201023ZX00202,2010,23ZX00,202,99,136,235,eneheuvel,26-09-11
201023ZX00203,2010,23ZX00,203,6,3,9,eneheuvel,26-09-11
201023ZX00204,2010,23ZX00,204,2,6,8,eneheuvel,26-09-11
201023ZX00205,2010,23ZX00,205,4,9,13,eneheuvel,26-09-11
201023ZX00207,2010,23ZX00,207,4,8,12,eneheuvel,26-09-11
201023ZX00208,2010,23ZX00,208,5,8,13,eneheuvel,26-09-11
201023ZX00209,2010,23ZX00,209,2,2,4,eneheuvel,26-09-11
201023ZX00210,2010,23ZX00,210,0,1,1,eneheuvel,26-09-11
201023ZX00211,2010,23ZX00,211,3,2,5,eneheuvel,26-09-11
201023ZX00308,2010,23ZX00,308,1,0,1,eneheuvel,26-09-11
201023ZX00311,2010,23ZX00,311,0,1,1,eneheuvel,26-09-11
201023ZX009999,2010,23ZX00,9999,1,0,1,eneheuvel,26-09-11
201023ZY00107,2010,23ZY00,107,1,0,1,eneheuvel,26-09-11
201023ZY00204,2010,23ZY00,204,2,0,2,eneheuvel,26-09-11
201023ZY00206,2010,23ZY00,206,0,3,3,eneheuvel,26-09-11
201023ZY00210,2010,23ZY00,210,4,1,5,eneheuvel,26-09-11
201023ZY00211,2010,23ZY00,211,1,3,4,eneheuvel,26-09-11
201023ZY00212,2010,23ZY00,212,144,190,334,eneheuvel,26-09-11
201023ZY00213,2010,23ZY00,213,3,1,4,eneheuvel,26-09-11
201023ZY00214,2010,23ZY00,214,1,1,2,eneheuvel,26-09-11
201023ZY00215,2010,23ZY00,215,1,0,1,eneheuvel,26-09-11
201023ZY00216,2010,23ZY00,216,0,1,1,eneheuvel,26-09-11
201023ZY00302,2010,23ZY00,302,1,0,1,eneheuvel,26-09-11
201023ZY00305,2010,23ZY00,305,0,1,1,eneheuvel,26-09-11
201023ZY00401,2010,23ZY00,401,1,1,2,eneheuvel,26-09-11
201023ZY009999,2010,23ZY00,9999,4,1,5,eneheuvel,26-09-11
201024EJ00102,2010,24EJ00,102,3,1,4,eneheuvel,26-09-11
201024EJ00106,2010,24EJ00,106,0,1,1,eneheuvel,26-09-11
201024EJ00108,2010,24EJ00,108,3,1,4,eneheuvel,26-09-11
201024EJ00202,2010,24EJ00,202,4,4,8,eneheuvel,26-09-11
201024EJ00203,2010,24EJ00,203,2,0,2,eneheuvel,26-09-11
201024EJ00204,2010,24EJ00,204,4,4,8,eneheuvel,26-09-11
201024EJ00206,2010,24EJ00,206,2,1,3,eneheuvel,26-09-11
201024EJ00207,2010,24EJ00,207,2,1,3,eneheuvel,26-09-11
201024EJ00208,2010,24EJ00,208,1,2,3,eneheuvel,26-09-11
201024EJ00209,2010,24EJ00,209,18,6,24,eneheuvel,26-09-11
201024EJ00210,2010,24EJ00,210,17,19,36,eneheuvel,26-09-11
201024EJ00211,2010,24EJ00,211,38,36,74,eneheuvel,26-09-11
201024EJ00212,2010,24EJ00,212,7,7,14,eneheuvel,26-09-11
201024EJ00213,2010,24EJ00,213,4,5,9,eneheuvel,26-09-11
201024EJ00214,2010,24EJ00,214,5,0,5,eneheuvel,26-09-11
201024EJ00305,2010,24EJ00,305,3,0,3,eneheuvel,26-09-11
201024EJ00308,2010,24EJ00,308,1,0,1,eneheuvel,26-09-11
201024EJ00309,2010,24EJ00,309,1,3,4,eneheuvel,26-09-11
201024EJ009999,2010,24EJ00,9999,2,5,7,eneheuvel,26-09-11
201024FT00102,2010,24FT00,102,1,6,7,eneheuvel,26-09-11
201024FT00103,2010,24FT00,103,1,3,4,eneheuvel,26-09-11
201024FT00104,2010,24FT00,104,1,0,1,eneheuvel,26-09-11
201024FT00105,2010,24FT00,105,1,1,2,eneheuvel,26-09-11
201024FT00106,2010,24FT00,106,0,2,2,eneheuvel,26-09-11
201024FT00107,2010,24FT00,107,1,1,2,eneheuvel,26-09-11
201024FT00108,2010,24FT00,108,0,2,2,eneheuvel,26-09-11
201024FT00109,2010,24FT00,109,1,0,1,eneheuvel,26-09-11
201024FT00202,2010,24FT00,202,0,2,2,eneheuvel,26-09-11
201024FT00203,2010,24FT00,203,2,3,5,eneheuvel,26-09-11
201024FT00204,2010,24FT00,204,0,2,2,eneheuvel,26-09-11
201024FT00205,2010,24FT00,205,0,3,3,eneheuvel,26-09-11
201024FT00206,2010,24FT00,206,0,3,3,eneheuvel,26-09-11
201024FT00207,2010,24FT00,207,2,0,2,eneheuvel,26-09-11
201024FT00208,2010,24FT00,208,2,7,9,eneheuvel,26-09-11
201024FT00209,2010,24FT00,209,0,1,1,eneheuvel,26-09-11
201024FT00210,2010,24FT00,210,5,6,11,eneheuvel,26-09-11
201024FT00211,2010,24FT00,211,6,13,19,eneheuvel,26-09-11
201024FT00212,2010,24FT00,212,2,19,21,eneheuvel,26-09-11
201024FT00213,2010,24FT00,213,2,10,12,eneheuvel,26-09-11
201024FT00214,2010,24FT00,214,2,18,20,eneheuvel,26-09-11
201024FT00216,2010,24FT00,216,0,4,4,eneheuvel,26-09-11
201024FT00301,2010,24FT00,301,1,1,2,eneheuvel,26-09-11
201024FT00302,2010,24FT00,302,0,16,16,eneheuvel,26-09-11
201024FT00303,2010,24FT00,303,2,21,23,eneheuvel,26-09-11
201024FT00304,2010,24FT00,304,1,3,4,eneheuvel,26-09-11
201024FT00305,2010,24FT00,305,0,4,4,eneheuvel,26-09-11
201024FT00306,2010,24FT00,306,0,6,6,eneheuvel,26-09-11
201024FT00307,2010,24FT00,307,0,10,10,eneheuvel,26-09-11
201024FT00308,2010,24FT00,308,0,11,11,eneheuvel,26-09-11
201024FT00309,2010,24FT00,309,0,7,7,eneheuvel,26-09-11
201024FT00311,2010,24FT00,311,1,9,10,eneheuvel,26-09-11
201024FT00312,2010,24FT00,312,2,16,18,eneheuvel,26-09-11
201024FT00313,2010,24FT00,313,0,1,1,eneheuvel,26-09-11
201024FT00401,2010,24FT00,401,0,1,1,eneheuvel,26-09-11
201024FT00402,2010,24FT00,402,2,0,2,eneheuvel,26-09-11
201024FT00403,2010,24FT00,403,0,1,1,eneheuvel,26-09-11
201024FT00502,2010,24FT00,502,0,1,1,eneheuvel,26-09-11
201024MR00101,2010,24MR00,101,1,1,2,eneheuvel,26-09-11
201024MR00201,2010,24MR00,201,0,2,2,eneheuvel,26-09-11
201024MR00208,2010,24MR00,208,2,0,2,eneheuvel,26-09-11
201024MR00212,2010,24MR00,212,1,1,2,eneheuvel,26-09-11
201024MR00216,2010,24MR00,216,0,1,1,eneheuvel,26-09-11
201024MR00301,2010,24MR00,301,0,2,2,eneheuvel,26-09-11
201024MR00302,2010,24MR00,302,1,0,1,eneheuvel,26-09-11
201024MR00305,2010,24MR00,305,1,1,2,eneheuvel,26-09-11
201024MR00306,2010,24MR00,306,10,18,28,eneheuvel,26-09-11
201024MR00307,2010,24MR00,307,88,118,206,eneheuvel,26-09-11
201024MR00308,2010,24MR00,308,6,7,13,eneheuvel,26-09-11
201024MR00309,2010,24MR00,309,2,0,2,eneheuvel,26-09-11
201024MR00311,2010,24MR00,311,2,1,3,eneheuvel,26-09-11
201024MR00502,2010,24MR00,502,0,1,1,eneheuvel,26-09-11
201024MR009999,2010,24MR00,9999,2,2,4,eneheuvel,26-09-11
201024RK00201,2010,24RK00,201,0,1,1,eneheuvel,26-09-11
201024RK00202,2010,24RK00,202,11,18,29,eneheuvel,26-09-11
201024RK00203,2010,24RK00,203,10,10,20,eneheuvel,26-09-11
201024RK00204,2010,24RK00,204,10,8,18,eneheuvel,26-09-11
201024RK00205,2010,24RK00,205,5,6,11,eneheuvel,26-09-11
201024RK00206,2010,24RK00,206,2,2,4,eneheuvel,26-09-11
201024RK00207,2010,24RK00,207,3,5,8,eneheuvel,26-09-11
201024RK00208,2010,24RK00,208,6,3,9,eneheuvel,26-09-11
201024RK00211,2010,24RK00,211,2,0,2,eneheuvel,26-09-11
201024RK00213,2010,24RK00,213,1,2,3,eneheuvel,26-09-11
201024RK00214,2010,24RK00,214,2,1,3,eneheuvel,26-09-11
201024RK00216,2010,24RK00,216,1,2,3,eneheuvel,26-09-11
201024RK00301,2010,24RK00,301,2,1,3,eneheuvel,26-09-11
201024RK00302,2010,24RK00,302,5,3,8,eneheuvel,26-09-11
201024RK00303,2010,24RK00,303,1,4,5,eneheuvel,26-09-11
201024RK00304,2010,24RK00,304,1,1,2,eneheuvel,26-09-11
201024RK00305,2010,24RK00,305,1,1,2,eneheuvel,26-09-11
201024RK00306,2010,24RK00,306,5,3,8,eneheuvel,26-09-11
201024RK00307,2010,24RK00,307,5,5,10,eneheuvel,26-09-11
201024RK00308,2010,24RK00,308,6,2,8,eneheuvel,26-09-11
201024RK00309,2010,24RK00,309,1,3,4,eneheuvel,26-09-11
201024RK00311,2010,24RK00,311,1,0,1,eneheuvel,26-09-11
201024RK00312,2010,24RK00,312,2,0,2,eneheuvel,26-09-11
201024RK00502,2010,24RK00,502,1,2,3,eneheuvel,26-09-11
201024UN00201,2010,24UN00,201,0,1,1,eneheuvel,26-09-11
201024UN00202,2010,24UN00,202,2,2,4,eneheuvel,26-09-11
201024UN00302,2010,24UN00,302,0,1,1,eneheuvel,26-09-11
201024UN00303,2010,24UN00,303,3,0,3,eneheuvel,26-09-11
201024UN00305,2010,24UN00,305,0,1,1,eneheuvel,26-09-11
201024UN00306,2010,24UN00,306,15,29,44,eneheuvel,26-09-11
201024UN00307,2010,24UN00,307,35,45,80,eneheuvel,26-09-11
201024UN00308,2010,24UN00,308,50,47,97,eneheuvel,26-09-11
201024UN00309,2010,24UN00,309,11,14,25,eneheuvel,26-09-11
201024UN00311,2010,24UN00,311,0,1,1,eneheuvel,26-09-11
201024UN00313,2010,24UN00,313,0,1,1,eneheuvel,26-09-11
201024UN009999,2010,24UN00,9999,1,1,2,eneheuvel,26-09-11
201025CF00103,2010,25CF00,103,1,0,1,eneheuvel,26-09-11
201025CF00201,2010,25CF00,201,1,1,2,eneheuvel,26-09-11
201025CF00202,2010,25CF00,202,4,6,10,eneheuvel,26-09-11
201025CF00203,2010,25CF00,203,1,7,8,eneheuvel,26-09-11
201025CF00204,2010,25CF00,204,50,71,121,eneheuvel,26-09-11
201025CF00205,2010,25CF00,205,11,29,40,eneheuvel,26-09-11
201025CF00207,2010,25CF00,207,0,6,6,eneheuvel,26-09-11
201025CF00208,2010,25CF00,208,1,0,1,eneheuvel,26-09-11
201025CF00212,2010,25CF00,212,2,0,2,eneheuvel,26-09-11
201025CF00307,2010,25CF00,307,1,2,3,eneheuvel,26-09-11
201025CF009999,2010,25CF00,9999,2,2,4,eneheuvel,26-09-11
201025KT00101,2010,25KT00,101,1,1,2,eneheuvel,26-09-11
201025KT00105,2010,25KT00,105,1,0,1,eneheuvel,26-09-11
201025KT00109,2010,25KT00,109,1,0,1,eneheuvel,26-09-11
201025KT00202,2010,25KT00,202,35,42,77,eneheuvel,26-09-11
201025KT00203,2010,25KT00,203,94,86,180,eneheuvel,26-09-11
201025KT00204,2010,25KT00,204,61,76,137,eneheuvel,26-09-11
201025KT00205,2010,25KT00,205,1,7,8,eneheuvel,26-09-11
201025KT00207,2010,25KT00,207,17,8,25,eneheuvel,26-09-11
201025KT00208,2010,25KT00,208,26,37,63,eneheuvel,26-09-11
201025KT00210,2010,25KT00,210,0,1,1,eneheuvel,26-09-11
201025KT00214,2010,25KT00,214,3,0,3,eneheuvel,26-09-11
201025KT00302,2010,25KT00,302,0,1,1,eneheuvel,26-09-11
201025KT00304,2010,25KT00,304,1,0,1,eneheuvel,26-09-11
201025KT00306,2010,25KT00,306,1,1,2,eneheuvel,26-09-11
201025KT00308,2010,25KT00,308,0,1,1,eneheuvel,26-09-11
201025KT00309,2010,25KT00,309,0,2,2,eneheuvel,26-09-11
201025KT00502,2010,25KT00,502,3,8,11,eneheuvel,26-09-11
201025KT009999,2010,25KT00,9999,1,1,2,eneheuvel,26-09-11
201025KU00110,2010,25KU00,110,0,3,3,eneheuvel,26-09-11
201025KU00202,2010,25KU00,202,21,27,48,eneheuvel,26-09-11
201025KU00203,2010,25KU00,203,71,54,125,eneheuvel,26-09-11
201025KU00204,2010,25KU00,204,48,74,122,eneheuvel,26-09-11
201025KU00205,2010,25KU00,205,1,4,5,eneheuvel,26-09-11
201025KU00207,2010,25KU00,207,5,9,14,eneheuvel,26-09-11
201025KU00208,2010,25KU00,208,23,24,47,eneheuvel,26-09-11
201025KU00211,2010,25KU00,211,1,1,2,eneheuvel,26-09-11
201025KU00212,2010,25KU00,212,0,2,2,eneheuvel,26-09-11
201025KU00216,2010,25KU00,216,0,2,2,eneheuvel,26-09-11
201025KU00309,2010,25KU00,309,0,1,1,eneheuvel,26-09-11
201025KU00312,2010,25KU00,312,1,0,1,eneheuvel,26-09-11
201025KU00313,2010,25KU00,313,0,1,1,eneheuvel,26-09-11
201025KU00402,2010,25KU00,402,1,1,2,eneheuvel,26-09-11
201025KU00403,2010,25KU00,403,0,1,1,eneheuvel,26-09-11
201025KU00502,2010,25KU00,502,1,7,8,eneheuvel,26-09-11
201025KU009999,2010,25KU00,9999,1,3,4,eneheuvel,26-09-11
201025KV00104,2010,25KV00,104,0,1,1,eneheuvel,26-09-11
201025KV00108,2010,25KV00,108,2,0,2,eneheuvel,26-09-11
201025KV00201,2010,25KV00,201,0,1,1,eneheuvel,26-09-11
201025KV00202,2010,25KV00,202,3,3,6,eneheuvel,26-09-11
201025KV00203,2010,25KV00,203,129,187,316,eneheuvel,26-09-11
201025KV00204,2010,25KV00,204,2,6,8,eneheuvel,26-09-11
201025KV00205,2010,25KV00,205,0,2,2,eneheuvel,26-09-11
201025KV00208,2010,25KV00,208,2,6,8,eneheuvel,26-09-11
201025KV00209,2010,25KV00,209,0,1,1,eneheuvel,26-09-11
201025KV00210,2010,25KV00,210,0,2,2,eneheuvel,26-09-11
201025KV00211,2010,25KV00,211,0,1,1,eneheuvel,26-09-11
201025KV00307,2010,25KV00,307,0,1,1,eneheuvel,26-09-11
201025KV00312,2010,25KV00,312,1,1,2,eneheuvel,26-09-11
201025KV009999,2010,25KV00,9999,0,1,1,eneheuvel,26-09-11
201026AB00101,2010,26AB00,101,0,1,1,eneheuvel,26-09-11
201026AB00201,2010,26AB00,201,0,2,2,eneheuvel,26-09-11
201026AB00202,2010,26AB00,202,1,0,1,eneheuvel,26-09-11
201026AB00205,2010,26AB00,205,1,0,1,eneheuvel,26-09-11
201026AB00212,2010,26AB00,212,1,0,1,eneheuvel,26-09-11
201026AB00215,2010,26AB00,215,0,1,1,eneheuvel,26-09-11
201026AB00301,2010,26AB00,301,2,1,3,eneheuvel,26-09-11
201026AB00302,2010,26AB00,302,18,23,41,eneheuvel,26-09-11
201026AB00303,2010,26AB00,303,145,168,313,eneheuvel,26-09-11
201026AB00304,2010,26AB00,304,1,6,7,eneheuvel,26-09-11
201026AB00306,2010,26AB00,306,0,3,3,eneheuvel,26-09-11
201026AB00308,2010,26AB00,308,1,0,1,eneheuvel,26-09-11
201026AB00309,2010,26AB00,309,6,3,9,eneheuvel,26-09-11
201026AB00310,2010,26AB00,310,3,0,3,eneheuvel,26-09-11
201026AB00311,2010,26AB00,311,1,5,6,eneheuvel,26-09-11
201026AB00312,2010,26AB00,312,0,4,4,eneheuvel,26-09-11
201026AB00313,2010,26AB00,313,2,4,6,eneheuvel,26-09-11
201026AB009999,2010,26AB00,9999,1,0,1,eneheuvel,26-09-11
201026AC00107,2010,26AC00,107,0,3,3,eneheuvel,26-09-11
201026AC00109,2010,26AC00,109,21,16,37,eneheuvel,26-09-11
201026AC00202,2010,26AC00,202,0,1,1,eneheuvel,26-09-11
201026AC00203,2010,26AC00,203,3,2,5,eneheuvel,26-09-11
201026AC00204,2010,26AC00,204,2,0,2,eneheuvel,26-09-11
201026AC00205,2010,26AC00,205,1,0,1,eneheuvel,26-09-11
201026AC00207,2010,26AC00,207,0,2,2,eneheuvel,26-09-11
201026AC00209,2010,26AC00,209,2,0,2,eneheuvel,26-09-11
201026AC00210,2010,26AC00,210,1,3,4,eneheuvel,26-09-11
201026AC00211,2010,26AC00,211,11,11,22,eneheuvel,26-09-11
201026AC00212,2010,26AC00,212,5,10,15,eneheuvel,26-09-11
201026AC00213,2010,26AC00,213,8,16,24,eneheuvel,26-09-11
201026AC00214,2010,26AC00,214,392,428,820,eneheuvel,26-09-11
201026AC00215,2010,26AC00,215,1,1,2,eneheuvel,26-09-11
201026AC00301,2010,26AC00,301,0,1,1,eneheuvel,26-09-11
201026AC00303,2010,26AC00,303,1,0,1,eneheuvel,26-09-11
201026AC00308,2010,26AC00,308,1,0,1,eneheuvel,26-09-11
201026AC00309,2010,26AC00,309,1,0,1,eneheuvel,26-09-11
201026AC00311,2010,26AC00,311,0,1,1,eneheuvel,26-09-11
201026AC00312,2010,26AC00,312,2,1,3,eneheuvel,26-09-11
201026AC00402,2010,26AC00,402,0,3,3,eneheuvel,26-09-11
201026AC009999,2010,26AC00,9999,1,1,2,eneheuvel,26-09-11
201026AD00101,2010,26AD00,101,1,1,2,eneheuvel,26-09-11
201026AD00201,2010,26AD00,201,2,0,2,eneheuvel,26-09-11
201026AD00207,2010,26AD00,207,1,0,1,eneheuvel,26-09-11
201026AD00208,2010,26AD00,208,2,1,3,eneheuvel,26-09-11
201026AD00212,2010,26AD00,212,0,1,1,eneheuvel,26-09-11
201026AD00214,2010,26AD00,214,1,1,2,eneheuvel,26-09-11
201026AD00216,2010,26AD00,216,0,1,1,eneheuvel,26-09-11
201026AD00301,2010,26AD00,301,4,0,4,eneheuvel,26-09-11
201026AD00302,2010,26AD00,302,87,66,153,eneheuvel,26-09-11
201026AD00303,2010,26AD00,303,37,28,65,eneheuvel,26-09-11
201026AD00304,2010,26AD00,304,4,1,5,eneheuvel,26-09-11
201026AD00305,2010,26AD00,305,3,3,6,eneheuvel,26-09-11
201026AD00306,2010,26AD00,306,3,1,4,eneheuvel,26-09-11
201026AD00307,2010,26AD00,307,2,2,4,eneheuvel,26-09-11
201026AD00308,2010,26AD00,308,2,1,3,eneheuvel,26-09-11
201026AD00309,2010,26AD00,309,53,58,111,eneheuvel,26-09-11
201026AD00310,2010,26AD00,310,23,12,35,eneheuvel,26-09-11
201026AD00311,2010,26AD00,311,36,35,71,eneheuvel,26-09-11
201026AD00312,2010,26AD00,312,12,7,19,eneheuvel,26-09-11
201026AD00313,2010,26AD00,313,6,4,10,eneheuvel,26-09-11
201026AD00403,2010,26AD00,403,2,0,2,eneheuvel,26-09-11
201026AD00502,2010,26AD00,502,0,1,1,eneheuvel,26-09-11
201026AD009999,2010,26AD00,9999,1,1,2,eneheuvel,26-09-11
201026PD00104,2010,26PD00,104,0,1,1,eneheuvel,26-09-11
201026PD00108,2010,26PD00,108,1,0,1,eneheuvel,26-09-11
201026PD00202,2010,26PD00,202,0,1,1,eneheuvel,26-09-11
201026PD00205,2010,26PD00,205,5,4,9,eneheuvel,26-09-11
201026PD00206,2010,26PD00,206,1,0,1,eneheuvel,26-09-11
201026PD00207,2010,26PD00,207,106,118,224,eneheuvel,26-09-11
201026PD00208,2010,26PD00,208,20,22,42,eneheuvel,26-09-11
201026PD00211,2010,26PD00,211,0,1,1,eneheuvel,26-09-11
201026PD00212,2010,26PD00,212,0,1,1,eneheuvel,26-09-11
201026PD00216,2010,26PD00,216,0,1,1,eneheuvel,26-09-11
201026PD00308,2010,26PD00,308,1,0,1,eneheuvel,26-09-11
201026PD00311,2010,26PD00,311,1,0,1,eneheuvel,26-09-11
201026PD00403,2010,26PD00,403,1,0,1,eneheuvel,26-09-11
201026PD00502,2010,26PD00,502,1,2,3,eneheuvel,26-09-11
201026PD009999,2010,26PD00,9999,3,5,8,eneheuvel,26-09-11
201026PE00201,2010,26PE00,201,0,2,2,eneheuvel,26-09-11
201026PE00202,2010,26PE00,202,2,0,2,eneheuvel,26-09-11
201026PE00203,2010,26PE00,203,1,1,2,eneheuvel,26-09-11
201026PE00204,2010,26PE00,204,1,0,1,eneheuvel,26-09-11
201026PE00208,2010,26PE00,208,1,1,2,eneheuvel,26-09-11
201026PE00301,2010,26PE00,301,3,1,4,eneheuvel,26-09-11
201026PE00302,2010,26PE00,302,232,248,480,eneheuvel,26-09-11
201026PE00303,2010,26PE00,303,30,15,45,eneheuvel,26-09-11
201026PE00306,2010,26PE00,306,1,0,1,eneheuvel,26-09-11
201026PE00307,2010,26PE00,307,2,0,2,eneheuvel,26-09-11
201026PE00308,2010,26PE00,308,1,0,1,eneheuvel,26-09-11
201026PE00309,2010,26PE00,309,1,2,3,eneheuvel,26-09-11
201026PE00311,2010,26PE00,311,5,7,12,eneheuvel,26-09-11
201026PE00312,2010,26PE00,312,6,5,11,eneheuvel,26-09-11
201026PE00313,2010,26PE00,313,3,6,9,eneheuvel,26-09-11
201026PE009999,2010,26PE00,9999,2,1,3,eneheuvel,26-09-11
201026PF00103,2010,26PF00,103,1,0,1,eneheuvel,26-09-11
201026PF00106,2010,26PF00,106,1,0,1,eneheuvel,26-09-11
201026PF00107,2010,26PF00,107,0,1,1,eneheuvel,26-09-11
201026PF00201,2010,26PF00,201,4,3,7,eneheuvel,26-09-11
201026PF00202,2010,26PF00,202,3,0,3,eneheuvel,26-09-11
201026PF00203,2010,26PF00,203,2,0,2,eneheuvel,26-09-11
201026PF00206,2010,26PF00,206,0,3,3,eneheuvel,26-09-11
201026PF00207,2010,26PF00,207,3,0,3,eneheuvel,26-09-11
201026PF00208,2010,26PF00,208,1,0,1,eneheuvel,26-09-11
201026PF00209,2010,26PF00,209,3,2,5,eneheuvel,26-09-11
201026PF00210,2010,26PF00,210,1,1,2,eneheuvel,26-09-11
201026PF00211,2010,26PF00,211,5,11,16,eneheuvel,26-09-11
201026PF00212,2010,26PF00,212,16,6,22,eneheuvel,26-09-11
201026PF00213,2010,26PF00,213,7,5,12,eneheuvel,26-09-11
201026PF00214,2010,26PF00,214,159,203,362,eneheuvel,26-09-11
201026PF00216,2010,26PF00,216,1,1,2,eneheuvel,26-09-11
201026PF00302,2010,26PF00,302,2,2,4,eneheuvel,26-09-11
201026PF00303,2010,26PF00,303,1,0,1,eneheuvel,26-09-11
201026PF00307,2010,26PF00,307,1,0,1,eneheuvel,26-09-11
201026PF00309,2010,26PF00,309,1,1,2,eneheuvel,26-09-11
201026PF00311,2010,26PF00,311,2,0,2,eneheuvel,26-09-11
201026PF00401,2010,26PF00,401,1,1,2,eneheuvel,26-09-11
201026PF00402,2010,26PF00,402,1,0,1,eneheuvel,26-09-11
201026PF00403,2010,26PF00,403,0,3,3,eneheuvel,26-09-11
201026PF009999,2010,26PF00,9999,8,8,16,eneheuvel,26-09-11
201026PG00207,2010,26PG00,207,2,0,2,eneheuvel,26-09-11
201026PG00209,2010,26PG00,209,1,1,2,eneheuvel,26-09-11
201026PG00210,2010,26PG00,210,1,1,2,eneheuvel,26-09-11
201026PG00211,2010,26PG00,211,2,1,3,eneheuvel,26-09-11
201026PG00212,2010,26PG00,212,1,1,2,eneheuvel,26-09-11
201026PG00213,2010,26PG00,213,1,1,2,eneheuvel,26-09-11
201026PG00214,2010,26PG00,214,52,60,112,eneheuvel,26-09-11
201026PG00216,2010,26PG00,216,0,1,1,eneheuvel,26-09-11
201026PG009999,2010,26PG00,9999,0,3,3,eneheuvel,26-09-11
201026PH00102,2010,26PH00,102,1,1,2,eneheuvel,26-09-11
201026PH00201,2010,26PH00,201,1,1,2,eneheuvel,26-09-11
201026PH00202,2010,26PH00,202,1,1,2,eneheuvel,26-09-11
201026PH00210,2010,26PH00,210,1,0,1,eneheuvel,26-09-11
201026PH00211,2010,26PH00,211,1,0,1,eneheuvel,26-09-11
201026PH00214,2010,26PH00,214,2,0,2,eneheuvel,26-09-11
201026PH00216,2010,26PH00,216,1,2,3,eneheuvel,26-09-11
201026PH00302,2010,26PH00,302,25,27,52,eneheuvel,26-09-11
201026PH00303,2010,26PH00,303,5,10,15,eneheuvel,26-09-11
201026PH00304,2010,26PH00,304,2,3,5,eneheuvel,26-09-11
201026PH00305,2010,26PH00,305,1,2,3,eneheuvel,26-09-11
201026PH00306,2010,26PH00,306,2,3,5,eneheuvel,26-09-11
201026PH00307,2010,26PH00,307,0,2,2,eneheuvel,26-09-11
201026PH00308,2010,26PH00,308,8,2,10,eneheuvel,26-09-11
201026PH00309,2010,26PH00,309,39,38,77,eneheuvel,26-09-11
201026PH00310,2010,26PH00,310,3,0,3,eneheuvel,26-09-11
201026PH00311,2010,26PH00,311,207,215,422,eneheuvel,26-09-11
201026PH00312,2010,26PH00,312,14,17,31,eneheuvel,26-09-11
201026PH00313,2010,26PH00,313,5,5,10,eneheuvel,26-09-11
201026PH00403,2010,26PH00,403,1,1,2,eneheuvel,26-09-11
201026PH009999,2010,26PH00,9999,2,1,3,eneheuvel,26-09-11
201026PW00108,2010,26PW00,108,0,1,1,eneheuvel,26-09-11
201026PW00110,2010,26PW00,110,2,1,3,eneheuvel,26-09-11
201026PW00207,2010,26PW00,207,1,0,1,eneheuvel,26-09-11
201026PW00212,2010,26PW00,212,1,0,1,eneheuvel,26-09-11
201026PW00302,2010,26PW00,302,21,30,51,eneheuvel,26-09-11
201026PW00303,2010,26PW00,303,29,30,59,eneheuvel,26-09-11
201026PW00308,2010,26PW00,308,2,1,3,eneheuvel,26-09-11
201026PW00309,2010,26PW00,309,36,35,71,eneheuvel,26-09-11
201026PW00310,2010,26PW00,310,10,7,17,eneheuvel,26-09-11
201026PW00311,2010,26PW00,311,14,24,38,eneheuvel,26-09-11
201026PW00312,2010,26PW00,312,2,6,8,eneheuvel,26-09-11
201026PW00313,2010,26PW00,313,0,4,4,eneheuvel,26-09-11
201026PW009999,2010,26PW00,9999,1,0,1,eneheuvel,26-09-11
201026ZZ00103,2010,26ZZ00,103,1,0,1,eneheuvel,26-09-11
201026ZZ00201,2010,26ZZ00,201,2,0,2,eneheuvel,26-09-11
201026ZZ00202,2010,26ZZ00,202,184,214,398,eneheuvel,26-09-11
201026ZZ00203,2010,26ZZ00,203,11,11,22,eneheuvel,26-09-11
201026ZZ00204,2010,26ZZ00,204,3,2,5,eneheuvel,26-09-11
201026ZZ00205,2010,26ZZ00,205,0,1,1,eneheuvel,26-09-11
201026ZZ00207,2010,26ZZ00,207,0,1,1,eneheuvel,26-09-11
201026ZZ00208,2010,26ZZ00,208,3,2,5,eneheuvel,26-09-11
201026ZZ00210,2010,26ZZ00,210,1,1,2,eneheuvel,26-09-11
201026ZZ00211,2010,26ZZ00,211,1,0,1,eneheuvel,26-09-11
201026ZZ00214,2010,26ZZ00,214,0,1,1,eneheuvel,26-09-11
201026ZZ00216,2010,26ZZ00,216,1,1,2,eneheuvel,26-09-11
201026ZZ00302,2010,26ZZ00,302,1,0,1,eneheuvel,26-09-11
201026ZZ00309,2010,26ZZ00,309,0,1,1,eneheuvel,26-09-11
201026ZZ00313,2010,26ZZ00,313,1,1,2,eneheuvel,26-09-11
201026ZZ00502,2010,26ZZ00,502,2,5,7,eneheuvel,26-09-11
201026ZZ009999,2010,26ZZ00,9999,1,3,4,eneheuvel,26-09-11
201027AA00102,2010,27AA00,102,1,0,1,eneheuvel,26-09-11
201027AA00106,2010,27AA00,106,1,2,3,eneheuvel,26-09-11
201027AA00201,2010,27AA00,201,1,1,2,eneheuvel,26-09-11
201027AA00202,2010,27AA00,202,4,1,5,eneheuvel,26-09-11
201027AA00203,2010,27AA00,203,6,8,14,eneheuvel,26-09-11
201027AA00204,2010,27AA00,204,4,10,14,eneheuvel,26-09-11
201027AA00205,2010,27AA00,205,2,2,4,eneheuvel,26-09-11
201027AA00206,2010,27AA00,206,0,1,1,eneheuvel,26-09-11
201027AA00207,2010,27AA00,207,97,66,163,eneheuvel,26-09-11
201027AA00208,2010,27AA00,208,174,146,320,eneheuvel,26-09-11
201027AA00210,2010,27AA00,210,1,0,1,eneheuvel,26-09-11
201027AA00214,2010,27AA00,214,1,1,2,eneheuvel,26-09-11
201027AA00216,2010,27AA00,216,1,0,1,eneheuvel,26-09-11
201027AA00302,2010,27AA00,302,0,1,1,eneheuvel,26-09-11
201027AA00303,2010,27AA00,303,3,2,5,eneheuvel,26-09-11
201027AA00304,2010,27AA00,304,0,1,1,eneheuvel,26-09-11
201027AA00306,2010,27AA00,306,1,1,2,eneheuvel,26-09-11
201027AA00307,2010,27AA00,307,2,5,7,eneheuvel,26-09-11
201027AA00308,2010,27AA00,308,2,2,4,eneheuvel,26-09-11
201027AA00309,2010,27AA00,309,1,0,1,eneheuvel,26-09-11
201027AA00312,2010,27AA00,312,1,0,1,eneheuvel,26-09-11
201027AA00401,2010,27AA00,401,1,2,3,eneheuvel,26-09-11
201027AA00502,2010,27AA00,502,2,0,2,eneheuvel,26-09-11
201027AA009999,2010,27AA00,9999,0,1,1,eneheuvel,26-09-11
201027NU00103,2010,27NU00,103,1,0,1,eneheuvel,26-09-11
201027NU00104,2010,27NU00,104,1,0,1,eneheuvel,26-09-11
201027NU00108,2010,27NU00,108,0,1,1,eneheuvel,26-09-11
201027NU00201,2010,27NU00,201,0,1,1,eneheuvel,26-09-11
201027NU00202,2010,27NU00,202,1,0,1,eneheuvel,26-09-11
201027NU00203,2010,27NU00,203,5,8,13,eneheuvel,26-09-11
201027NU00204,2010,27NU00,204,9,6,15,eneheuvel,26-09-11
201027NU00205,2010,27NU00,205,2,1,3,eneheuvel,26-09-11
201027NU00206,2010,27NU00,206,0,1,1,eneheuvel,26-09-11
201027NU00207,2010,27NU00,207,39,23,62,eneheuvel,26-09-11
201027NU00208,2010,27NU00,208,164,161,325,eneheuvel,26-09-11
201027NU00210,2010,27NU00,210,1,1,2,eneheuvel,26-09-11
201027NU00211,2010,27NU00,211,1,0,1,eneheuvel,26-09-11
201027NU00301,2010,27NU00,301,1,1,2,eneheuvel,26-09-11
201027NU00304,2010,27NU00,304,3,0,3,eneheuvel,26-09-11
201027NU00305,2010,27NU00,305,1,0,1,eneheuvel,26-09-11
201027NU00306,2010,27NU00,306,1,0,1,eneheuvel,26-09-11
201027NU00502,2010,27NU00,502,1,2,3,eneheuvel,26-09-11
201027NU009999,2010,27NU00,9999,2,1,3,eneheuvel,26-09-11
201027UB00104,2010,27UB00,104,1,0,1,eneheuvel,26-09-11
201027UB00105,2010,27UB00,105,0,1,1,eneheuvel,26-09-11
201027UB00201,2010,27UB00,201,1,0,1,eneheuvel,26-09-11
201027UB00202,2010,27UB00,202,2,3,5,eneheuvel,26-09-11
201027UB00203,2010,27UB00,203,8,4,12,eneheuvel,26-09-11
201027UB00204,2010,27UB00,204,2,1,3,eneheuvel,26-09-11
201027UB00205,2010,27UB00,205,0,1,1,eneheuvel,26-09-11
201027UB00207,2010,27UB00,207,11,9,20,eneheuvel,26-09-11
201027UB00208,2010,27UB00,208,190,133,323,eneheuvel,26-09-11
201027UB00209,2010,27UB00,209,1,0,1,eneheuvel,26-09-11
201027UB00210,2010,27UB00,210,0,2,2,eneheuvel,26-09-11
201027UB00212,2010,27UB00,212,1,0,1,eneheuvel,26-09-11
201027UB00216,2010,27UB00,216,1,1,2,eneheuvel,26-09-11
201027UB00302,2010,27UB00,302,0,1,1,eneheuvel,26-09-11
201027UB00305,2010,27UB00,305,1,1,2,eneheuvel,26-09-11
201027UB00306,2010,27UB00,306,0,1,1,eneheuvel,26-09-11
201027UB00307,2010,27UB00,307,2,0,2,eneheuvel,26-09-11
201027UB00308,2010,27UB00,308,1,1,2,eneheuvel,26-09-11
201027UB00309,2010,27UB00,309,1,2,3,eneheuvel,26-09-11
201027UB00311,2010,27UB00,311,1,1,2,eneheuvel,26-09-11
201027UB00401,2010,27UB00,401,1,0,1,eneheuvel,26-09-11
201027UB00502,2010,27UB00,502,4,2,6,eneheuvel,26-09-11
201027UB009999,2010,27UB00,9999,2,0,2,eneheuvel,26-09-11
201027XH00201,2010,27XH00,201,1,0,1,eneheuvel,26-09-11
201027XH00202,2010,27XH00,202,0,1,1,eneheuvel,26-09-11
201027XH00203,2010,27XH00,203,1,0,1,eneheuvel,26-09-11
201027XH00209,2010,27XH00,209,3,2,5,eneheuvel,26-09-11
201027XH00210,2010,27XH00,210,6,6,12,eneheuvel,26-09-11
201027XH00212,2010,27XH00,212,0,2,2,eneheuvel,26-09-11
201027XH00214,2010,27XH00,214,4,1,5,eneheuvel,26-09-11
201027XH00215,2010,27XH00,215,14,18,32,eneheuvel,26-09-11
201027XH00216,2010,27XH00,216,132,90,222,eneheuvel,26-09-11
201027XH00304,2010,27XH00,304,1,1,2,eneheuvel,26-09-11
201027XH00311,2010,27XH00,311,1,0,1,eneheuvel,26-09-11
201027XH00403,2010,27XH00,403,0,1,1,eneheuvel,26-09-11
201027XJ00201,2010,27XJ00,201,0,1,1,eneheuvel,26-09-11
201027XJ00204,2010,27XJ00,204,1,1,2,eneheuvel,26-09-11
201027XJ00207,2010,27XJ00,207,1,0,1,eneheuvel,26-09-11
201027XJ00211,2010,27XJ00,211,0,2,2,eneheuvel,26-09-11
201027XJ00213,2010,27XJ00,213,0,1,1,eneheuvel,26-09-11
201027XJ00302,2010,27XJ00,302,19,8,27,eneheuvel,26-09-11
201027XJ00303,2010,27XJ00,303,4,5,9,eneheuvel,26-09-11
201027XJ00306,2010,27XJ00,306,3,1,4,eneheuvel,26-09-11
201027XJ00307,2010,27XJ00,307,0,1,1,eneheuvel,26-09-11
201027XJ00308,2010,27XJ00,308,2,0,2,eneheuvel,26-09-11
201027XJ00309,2010,27XJ00,309,7,2,9,eneheuvel,26-09-11
201027XJ00311,2010,27XJ00,311,28,16,44,eneheuvel,26-09-11
201027XJ00312,2010,27XJ00,312,177,95,272,eneheuvel,26-09-11
201027XJ00313,2010,27XJ00,313,49,17,66,eneheuvel,26-09-11
201027XJ009999,2010,27XJ00,9999,2,1,3,eneheuvel,26-09-11
201027YN00109,2010,27YN00,109,2,2,4,eneheuvel,26-09-11
201027YN00110,2010,27YN00,110,0,3,3,eneheuvel,26-09-11
201027YN00201,2010,27YN00,201,1,1,2,eneheuvel,26-09-11
201027YN00202,2010,27YN00,202,1,1,2,eneheuvel,26-09-11
201027YN00203,2010,27YN00,203,0,1,1,eneheuvel,26-09-11
201027YN00204,2010,27YN00,204,0,1,1,eneheuvel,26-09-11
201027YN00206,2010,27YN00,206,1,0,1,eneheuvel,26-09-11
201027YN00207,2010,27YN00,207,0,1,1,eneheuvel,26-09-11
201027YN00208,2010,27YN00,208,2,1,3,eneheuvel,26-09-11
201027YN00210,2010,27YN00,210,13,13,26,eneheuvel,26-09-11
201027YN00211,2010,27YN00,211,2,4,6,eneheuvel,26-09-11
201027YN00212,2010,27YN00,212,7,5,12,eneheuvel,26-09-11
201027YN00213,2010,27YN00,213,2,0,2,eneheuvel,26-09-11
201027YN00214,2010,27YN00,214,3,0,3,eneheuvel,26-09-11
201027YN00215,2010,27YN00,215,6,5,11,eneheuvel,26-09-11
201027YN00216,2010,27YN00,216,155,99,254,eneheuvel,26-09-11
201027YN00302,2010,27YN00,302,1,2,3,eneheuvel,26-09-11
201027YN00303,2010,27YN00,303,1,2,3,eneheuvel,26-09-11
201027YN00305,2010,27YN00,305,0,1,1,eneheuvel,26-09-11
201027YN00308,2010,27YN00,308,0,1,1,eneheuvel,26-09-11
201027YN00311,2010,27YN00,311,1,0,1,eneheuvel,26-09-11
201027YN00312,2010,27YN00,312,1,0,1,eneheuvel,26-09-11
201027YN00403,2010,27YN00,403,0,2,2,eneheuvel,26-09-11
201027YN009999,2010,27YN00,9999,2,1,3,eneheuvel,26-09-11
201028AM00102,2010,28AM00,102,1,1,2,eneheuvel,26-09-11
201028AM00207,2010,28AM00,207,2,1,3,eneheuvel,26-09-11
201028AM00208,2010,28AM00,208,1,1,2,eneheuvel,26-09-11
201028AM00211,2010,28AM00,211,1,1,2,eneheuvel,26-09-11
201028AM00214,2010,28AM00,214,0,1,1,eneheuvel,26-09-11
201028AM00302,2010,28AM00,302,8,2,10,eneheuvel,26-09-11
201028AM00305,2010,28AM00,305,1,0,1,eneheuvel,26-09-11
201028AM00307,2010,28AM00,307,1,0,1,eneheuvel,26-09-11
201028AM00309,2010,28AM00,309,5,2,7,eneheuvel,26-09-11
201028AM00310,2010,28AM00,310,1,0,1,eneheuvel,26-09-11
201028AM00311,2010,28AM00,311,34,8,42,eneheuvel,26-09-11
201028AM00312,2010,28AM00,312,191,152,343,eneheuvel,26-09-11
201028AM00313,2010,28AM00,313,8,5,13,eneheuvel,26-09-11
201028DJ00106,2010,28DJ00,106,2,1,3,eneheuvel,26-09-11
201028DJ00107,2010,28DJ00,107,3,2,5,eneheuvel,26-09-11
201028DJ00108,2010,28DJ00,108,1,0,1,eneheuvel,26-09-11
201028DJ00201,2010,28DJ00,201,1,0,1,eneheuvel,26-09-11
201028DJ00202,2010,28DJ00,202,3,0,3,eneheuvel,26-09-11
201028DJ00203,2010,28DJ00,203,2,5,7,eneheuvel,26-09-11
201028DJ00204,2010,28DJ00,204,0,1,1,eneheuvel,26-09-11
201028DJ00205,2010,28DJ00,205,5,3,8,eneheuvel,26-09-11
201028DJ00206,2010,28DJ00,206,2,2,4,eneheuvel,26-09-11
201028DJ00207,2010,28DJ00,207,11,8,19,eneheuvel,26-09-11
201028DJ00208,2010,28DJ00,208,9,10,19,eneheuvel,26-09-11
201028DJ00209,2010,28DJ00,209,1,0,1,eneheuvel,26-09-11
201028DJ00210,2010,28DJ00,210,1,1,2,eneheuvel,26-09-11
201028DJ00211,2010,28DJ00,211,4,3,7,eneheuvel,26-09-11
201028DJ00212,2010,28DJ00,212,1,2,3,eneheuvel,26-09-11
201028DJ00213,2010,28DJ00,213,3,2,5,eneheuvel,26-09-11
201028DJ00214,2010,28DJ00,214,1,1,2,eneheuvel,26-09-11
201028DJ00215,2010,28DJ00,215,0,1,1,eneheuvel,26-09-11
201028DJ00216,2010,28DJ00,216,3,0,3,eneheuvel,26-09-11
201028DJ00302,2010,28DJ00,302,9,2,11,eneheuvel,26-09-11
201028DJ00303,2010,28DJ00,303,1,3,4,eneheuvel,26-09-11
201028DJ00304,2010,28DJ00,304,2,0,2,eneheuvel,26-09-11
201028DJ00305,2010,28DJ00,305,2,4,6,eneheuvel,26-09-11
201028DJ00306,2010,28DJ00,306,4,3,7,eneheuvel,26-09-11
201028DJ00307,2010,28DJ00,307,1,6,7,eneheuvel,26-09-11
201028DJ00308,2010,28DJ00,308,3,3,6,eneheuvel,26-09-11
201028DJ00309,2010,28DJ00,309,3,0,3,eneheuvel,26-09-11
201028DJ00311,2010,28DJ00,311,1,0,1,eneheuvel,26-09-11
201028DJ00312,2010,28DJ00,312,1,0,1,eneheuvel,26-09-11
201029UB00108,2010,29UB00,108,1,0,1,eneheuvel,26-09-11
201029UB00109,2010,29UB00,109,1,0,1,eneheuvel,26-09-11
201029UB00202,2010,29UB00,202,1,0,1,eneheuvel,26-09-11
201029UB00203,2010,29UB00,203,1,0,1,eneheuvel,26-09-11
201029UB00207,2010,29UB00,207,0,1,1,eneheuvel,26-09-11
201029UB00208,2010,29UB00,208,3,2,5,eneheuvel,26-09-11
201029UB00210,2010,29UB00,210,1,3,4,eneheuvel,26-09-11
201029UB00211,2010,29UB00,211,0,1,1,eneheuvel,26-09-11
201029UB00212,2010,29UB00,212,4,12,16,eneheuvel,26-09-11
201029UB00213,2010,29UB00,213,1,1,2,eneheuvel,26-09-11
201029UB00214,2010,29UB00,214,22,30,52,eneheuvel,26-09-11
201029UB00216,2010,29UB00,216,2,1,3,eneheuvel,26-09-11
201029UB00306,2010,29UB00,306,1,0,1,eneheuvel,26-09-11
201029UB00307,2010,29UB00,307,1,1,2,eneheuvel,26-09-11
201029UB00401,2010,29UB00,401,11,12,23,eneheuvel,26-09-11
201029UB00402,2010,29UB00,402,56,32,88,eneheuvel,26-09-11
201029UB00403,2010,29UB00,403,38,24,62,eneheuvel,26-09-11
201029UB009999,2010,29UB00,9999,3,1,4,eneheuvel,26-09-11
201029UN00207,2010,29UN00,207,1,3,4,eneheuvel,26-09-11
201029UN00209,2010,29UN00,209,1,0,1,eneheuvel,26-09-11
201029UN00301,2010,29UN00,301,2,0,2,eneheuvel,26-09-11
201029UN00302,2010,29UN00,302,3,1,4,eneheuvel,26-09-11
201029UN00303,2010,29UN00,303,1,0,1,eneheuvel,26-09-11
201029UN00304,2010,29UN00,304,5,1,6,eneheuvel,26-09-11
201029UN00305,2010,29UN00,305,11,9,20,eneheuvel,26-09-11
201029UN00306,2010,29UN00,306,6,6,12,eneheuvel,26-09-11
201029UN00307,2010,29UN00,307,2,1,3,eneheuvel,26-09-11
201029UN00308,2010,29UN00,308,2,1,3,eneheuvel,26-09-11
201029UN00309,2010,29UN00,309,4,1,5,eneheuvel,26-09-11
201029UN00310,2010,29UN00,310,1,0,1,eneheuvel,26-09-11
201029UN00311,2010,29UN00,311,3,2,5,eneheuvel,26-09-11
201029UN00312,2010,29UN00,312,1,2,3,eneheuvel,26-09-11
201029XC00107,2010,29XC00,107,4,4,8,eneheuvel,26-09-11
201029XC00202,2010,29XC00,202,0,1,1,eneheuvel,26-09-11
201029XC00208,2010,29XC00,208,1,1,2,eneheuvel,26-09-11
201029XC00213,2010,29XC00,213,0,2,2,eneheuvel,26-09-11
201029XC00307,2010,29XC00,307,0,2,2,eneheuvel,26-09-11
201029XC00401,2010,29XC00,401,2,1,3,eneheuvel,26-09-11
201029XC00402,2010,29XC00,402,2,3,5,eneheuvel,26-09-11
201029XC00403,2010,29XC00,403,1,1,2,eneheuvel,26-09-11
201029XT00202,2010,29XT00,202,1,0,1,eneheuvel,26-09-11
201029XT00203,2010,29XT00,203,2,1,3,eneheuvel,26-09-11
201029XT00208,2010,29XT00,208,0,1,1,eneheuvel,26-09-11
201029XT00211,2010,29XT00,211,1,0,1,eneheuvel,26-09-11
201029XT00212,2010,29XT00,212,0,1,1,eneheuvel,26-09-11
201029XT00214,2010,29XT00,214,9,3,12,eneheuvel,26-09-11
201029XT00302,2010,29XT00,302,1,1,2,eneheuvel,26-09-11
201029XT00304,2010,29XT00,304,2,2,4,eneheuvel,26-09-11
201029XT00307,2010,29XT00,307,1,0,1,eneheuvel,26-09-11
201029XT00311,2010,29XT00,311,2,0,2,eneheuvel,26-09-11
201029XT00313,2010,29XT00,313,2,0,2,eneheuvel,26-09-11
201029XT00401,2010,29XT00,401,23,10,33,eneheuvel,26-09-11
201029XT00402,2010,29XT00,402,5,8,13,eneheuvel,26-09-11
201029XT00403,2010,29XT00,403,10,2,12,eneheuvel,26-09-11
201029XT009999,2010,29XT00,9999,3,1,4,eneheuvel,26-09-11
201029XU00105,2010,29XU00,105,0,1,1,eneheuvel,26-09-11
201029XU00204,2010,29XU00,204,1,0,1,eneheuvel,26-09-11
201029XU00206,2010,29XU00,206,0,1,1,eneheuvel,26-09-11
201029XU00211,2010,29XU00,211,0,1,1,eneheuvel,26-09-11
201029XU00214,2010,29XU00,214,1,0,1,eneheuvel,26-09-11
201029XU00302,2010,29XU00,302,1,1,2,eneheuvel,26-09-11
201029XU00303,2010,29XU00,303,2,0,2,eneheuvel,26-09-11
201029XU00401,2010,29XU00,401,18,8,26,eneheuvel,26-09-11
201029XU00402,2010,29XU00,402,4,3,7,eneheuvel,26-09-11
201029XU00403,2010,29XU00,403,2,3,5,eneheuvel,26-09-11
201029XU009999,2010,29XU00,9999,1,2,3,eneheuvel,26-09-11
201029XX00103,2010,29XX00,103,1,0,1,eneheuvel,26-09-11
201029XX00109,2010,29XX00,109,2,0,2,eneheuvel,26-09-11
201029XX00202,2010,29XX00,202,1,1,2,eneheuvel,26-09-11
201029XX00203,2010,29XX00,203,0,3,3,eneheuvel,26-09-11
201029XX00204,2010,29XX00,204,2,0,2,eneheuvel,26-09-11
201029XX00205,2010,29XX00,205,0,1,1,eneheuvel,26-09-11
201029XX00207,2010,29XX00,207,2,3,5,eneheuvel,26-09-11
201029XX00208,2010,29XX00,208,3,7,10,eneheuvel,26-09-11
201029XX00209,2010,29XX00,209,2,2,4,eneheuvel,26-09-11
201029XX00210,2010,29XX00,210,1,2,3,eneheuvel,26-09-11
201029XX00211,2010,29XX00,211,1,1,2,eneheuvel,26-09-11
201029XX00212,2010,29XX00,212,4,5,9,eneheuvel,26-09-11
201029XX00213,2010,29XX00,213,1,1,2,eneheuvel,26-09-11
201029XX00214,2010,29XX00,214,7,10,17,eneheuvel,26-09-11
201029XX00216,2010,29XX00,216,0,2,2,eneheuvel,26-09-11
201029XX00302,2010,29XX00,302,4,3,7,eneheuvel,26-09-11
201029XX00303,2010,29XX00,303,1,2,3,eneheuvel,26-09-11
201029XX00305,2010,29XX00,305,2,0,2,eneheuvel,26-09-11
201029XX00306,2010,29XX00,306,1,0,1,eneheuvel,26-09-11
201029XX00307,2010,29XX00,307,1,1,2,eneheuvel,26-09-11
201029XX00309,2010,29XX00,309,1,0,1,eneheuvel,26-09-11
201029XX00311,2010,29XX00,311,4,2,6,eneheuvel,26-09-11
201029XX00312,2010,29XX00,312,2,2,4,eneheuvel,26-09-11
201029XX00313,2010,29XX00,313,1,2,3,eneheuvel,26-09-11
201029XX00502,2010,29XX00,502,0,2,2,eneheuvel,26-09-11
201029XX009999,2010,29XX00,9999,0,2,2,eneheuvel,26-09-11
201030AJ00109,2010,30AJ00,109,1,0,1,eneheuvel,26-09-11
201030AJ00202,2010,30AJ00,202,2,1,3,eneheuvel,26-09-11
201030AJ00203,2010,30AJ00,203,0,1,1,eneheuvel,26-09-11
201030AJ00207,2010,30AJ00,207,2,5,7,eneheuvel,26-09-11
201030AJ00208,2010,30AJ00,208,5,1,6,eneheuvel,26-09-11
201030AJ00211,2010,30AJ00,211,0,1,1,eneheuvel,26-09-11
201030AJ00212,2010,30AJ00,212,1,0,1,eneheuvel,26-09-11
201030AJ00213,2010,30AJ00,213,0,1,1,eneheuvel,26-09-11
201030AJ00214,2010,30AJ00,214,3,3,6,eneheuvel,26-09-11
201030AJ00215,2010,30AJ00,215,0,2,2,eneheuvel,26-09-11
201030AJ00216,2010,30AJ00,216,1,1,2,eneheuvel,26-09-11
201030AJ00304,2010,30AJ00,304,0,1,1,eneheuvel,26-09-11
201030AJ00305,2010,30AJ00,305,0,1,1,eneheuvel,26-09-11
201030AJ00308,2010,30AJ00,308,1,0,1,eneheuvel,26-09-11
201030AJ00311,2010,30AJ00,311,0,2,2,eneheuvel,26-09-11
201030AJ00312,2010,30AJ00,312,0,1,1,eneheuvel,26-09-11
201030AJ00401,2010,30AJ00,401,2,1,3,eneheuvel,26-09-11
201030AJ00402,2010,30AJ00,402,33,25,58,eneheuvel,26-09-11
201030AJ00403,2010,30AJ00,403,13,19,32,eneheuvel,26-09-11
201030AJ00502,2010,30AJ00,502,1,0,1,eneheuvel,26-09-11
201030AJ009999,2010,30AJ00,9999,2,2,4,eneheuvel,26-09-11
201106RM00102,2011,06RM00,102,2,1,3,eneheuvel,20-03-12
201106RM00103,2011,06RM00,103,1,4,5,eneheuvel,20-03-12
201106RM00104,2011,06RM00,104,0,2,2,eneheuvel,20-03-12
201106RM00105,2011,06RM00,105,0,1,1,eneheuvel,20-03-12
201106RM00106,2011,06RM00,106,0,1,1,eneheuvel,20-03-12
201106RM00107,2011,06RM00,107,2,2,4,eneheuvel,20-03-12
201106RM00108,2011,06RM00,108,1,1,2,eneheuvel,20-03-12
201106RM00201,2011,06RM00,201,0,1,1,eneheuvel,20-03-12
201106RM00202,2011,06RM00,202,6,5,11,eneheuvel,20-03-12
201106RM00204,2011,06RM00,204,1,3,4,eneheuvel,20-03-12
201106RM00206,2011,06RM00,206,3,0,3,eneheuvel,20-03-12
201106RM00207,2011,06RM00,207,3,3,6,eneheuvel,20-03-12
201106RM00208,2011,06RM00,208,4,1,5,eneheuvel,20-03-12
201106RM00209,2011,06RM00,209,2,0,2,eneheuvel,20-03-12
201106RM00210,2011,06RM00,210,5,10,15,eneheuvel,20-03-12
201106RM00211,2011,06RM00,211,1,7,8,eneheuvel,20-03-12
201106RM00212,2011,06RM00,212,16,22,38,eneheuvel,20-03-12
201106RM00213,2011,06RM00,213,4,8,12,eneheuvel,20-03-12
201106RM00214,2011,06RM00,214,7,11,18,eneheuvel,20-03-12
201106RM00215,2011,06RM00,215,0,2,2,eneheuvel,20-03-12
201106RM00216,2011,06RM00,216,8,5,13,eneheuvel,20-03-12
201106RM00301,2011,06RM00,301,1,0,1,eneheuvel,20-03-12
201106RM00302,2011,06RM00,302,2,4,6,eneheuvel,20-03-12
201106RM00303,2011,06RM00,303,2,3,5,eneheuvel,20-03-12
201106RM00304,2011,06RM00,304,1,1,2,eneheuvel,20-03-12
201106RM00305,2011,06RM00,305,0,1,1,eneheuvel,20-03-12
201106RM00306,2011,06RM00,306,2,0,2,eneheuvel,20-03-12
201106RM00308,2011,06RM00,308,2,0,2,eneheuvel,20-03-12
201106RM00309,2011,06RM00,309,1,0,1,eneheuvel,20-03-12
201106RM00310,2011,06RM00,310,0,1,1,eneheuvel,20-03-12
201106RM00311,2011,06RM00,311,2,2,4,eneheuvel,20-03-12
201106RM00312,2011,06RM00,312,2,4,6,eneheuvel,20-03-12
201106RM00403,2011,06RM00,403,1,0,1,eneheuvel,20-03-12
201106RM00502,2011,06RM00,502,2,4,6,eneheuvel,20-03-12
201106RM009999,2011,06RM00,9999,3,4,7,eneheuvel,20-03-12
201112HU00103,2011,12HU00,103,0,2,2,eneheuvel,20-03-12
201112HU00201,2011,12HU00,201,2,5,7,eneheuvel,20-03-12
201112HU00202,2011,12HU00,202,1,2,3,eneheuvel,20-03-12
201112HU00203,2011,12HU00,203,0,1,1,eneheuvel,20-03-12
201112HU00209,2011,12HU00,209,5,3,8,eneheuvel,20-03-12
201112HU00210,2011,12HU00,210,0,2,2,eneheuvel,20-03-12
201112HU00211,2011,12HU00,211,30,33,63,eneheuvel,20-03-12
201112HU00212,2011,12HU00,212,1,0,1,eneheuvel,20-03-12
201112HU00213,2011,12HU00,213,1,0,1,eneheuvel,20-03-12
201112HU00401,2011,12HU00,401,0,1,1,eneheuvel,20-03-12
201112PM00101,2011,12PM00,101,2,7,9,eneheuvel,20-03-12
201112PM00102,2011,12PM00,102,15,13,28,eneheuvel,20-03-12
201112PM00103,2011,12PM00,103,34,28,62,eneheuvel,20-03-12
201112PM00104,2011,12PM00,104,2,3,5,eneheuvel,20-03-12
201112PM00105,2011,12PM00,105,0,2,2,eneheuvel,20-03-12
201112PM00106,2011,12PM00,106,3,5,8,eneheuvel,20-03-12
201112PM00107,2011,12PM00,107,10,17,27,eneheuvel,20-03-12
201112PM00108,2011,12PM00,108,20,15,35,eneheuvel,20-03-12
201112PM00109,2011,12PM00,109,3,7,10,eneheuvel,20-03-12
201112PM00211,2011,12PM00,211,1,0,1,eneheuvel,20-03-12
201112PM00303,2011,12PM00,303,1,1,2,eneheuvel,20-03-12
201112PM009999,2011,12PM00,9999,0,1,1,eneheuvel,20-03-12
201112QK00102,2011,12QK00,102,1,0,1,eneheuvel,20-03-12
201112QK00202,2011,12QK00,202,1,0,1,eneheuvel,20-03-12
201112QK00203,2011,12QK00,203,0,1,1,eneheuvel,20-03-12
201112QK00204,2011,12QK00,204,1,1,2,eneheuvel,20-03-12
201112QK00206,2011,12QK00,206,103,101,204,eneheuvel,20-03-12
201112QK00207,2011,12QK00,207,1,1,2,eneheuvel,20-03-12
201112QK00208,2011,12QK00,208,1,1,2,eneheuvel,20-03-12
201112QK00209,2011,12QK00,209,1,6,7,eneheuvel,20-03-12
201112QK00210,2011,12QK00,210,7,8,15,eneheuvel,20-03-12
201112QK00214,2011,12QK00,214,1,1,2,eneheuvel,20-03-12
201112QK00215,2011,12QK00,215,0,2,2,eneheuvel,20-03-12
201112QK00302,2011,12QK00,302,0,2,2,eneheuvel,20-03-12
201112QK00303,2011,12QK00,303,2,1,3,eneheuvel,20-03-12
201112QK00306,2011,12QK00,306,1,1,2,eneheuvel,20-03-12
201112QK00309,2011,12QK00,309,1,0,1,eneheuvel,20-03-12
201112QK009999,2011,12QK00,9999,1,0,1,eneheuvel,20-03-12
201112XA00201,2011,12XA00,201,0,1,1,eneheuvel,20-03-12
201112XA00211,2011,12XA00,211,41,50,91,eneheuvel,20-03-12
201112XA00212,2011,12XA00,212,1,0,1,eneheuvel,20-03-12
201112XA00213,2011,12XA00,213,0,1,1,eneheuvel,20-03-12
201112XA00303,2011,12XA00,303,2,1,3,eneheuvel,20-03-12
201113CW00106,2011,13CW00,106,1,0,1,eneheuvel,20-03-12
201113CW00201,2011,13CW00,201,2,0,2,eneheuvel,20-03-12
201113CW00202,2011,13CW00,202,1,0,1,eneheuvel,20-03-12
201113CW00203,2011,13CW00,203,0,1,1,eneheuvel,20-03-12
201113CW00205,2011,13CW00,205,0,2,2,eneheuvel,20-03-12
201113CW00206,2011,13CW00,206,45,62,107,eneheuvel,20-03-12
201113CW00207,2011,13CW00,207,1,2,3,eneheuvel,20-03-12
201113CW00208,2011,13CW00,208,1,1,2,eneheuvel,20-03-12
201113CW00209,2011,13CW00,209,10,13,23,eneheuvel,20-03-12
201113CW00210,2011,13CW00,210,8,8,16,eneheuvel,20-03-12
201113CW00211,2011,13CW00,211,3,1,4,eneheuvel,20-03-12
201113CW00212,2011,13CW00,212,2,1,3,eneheuvel,20-03-12
201113CW00215,2011,13CW00,215,0,1,1,eneheuvel,20-03-12
201113CW00216,2011,13CW00,216,1,1,2,eneheuvel,20-03-12
201113CW00304,2011,13CW00,304,0,1,1,eneheuvel,20-03-12
201113CW00308,2011,13CW00,308,0,2,2,eneheuvel,20-03-12
201113CW009999,2011,13CW00,9999,0,1,1,eneheuvel,20-03-12
201113IF00208,2011,13IF00,208,2,1,3,eneheuvel,20-03-12
201113IF00211,2011,13IF00,211,0,1,1,eneheuvel,20-03-12
201113IF00301,2011,13IF00,301,6,8,14,eneheuvel,20-03-12
201113IF00302,2011,13IF00,302,2,3,5,eneheuvel,20-03-12
201113IF00303,2011,13IF00,303,4,8,12,eneheuvel,20-03-12
201113IF00304,2011,13IF00,304,32,39,71,eneheuvel,20-03-12
201113IF00305,2011,13IF00,305,6,5,11,eneheuvel,20-03-12
201113IF00306,2011,13IF00,306,8,9,17,eneheuvel,20-03-12
201113IF00307,2011,13IF00,307,1,4,5,eneheuvel,20-03-12
201113IF00308,2011,13IF00,308,1,3,4,eneheuvel,20-03-12
201113IF00309,2011,13IF00,309,1,0,1,eneheuvel,20-03-12
201113IF00310,2011,13IF00,310,1,1,2,eneheuvel,20-03-12
201113IF00311,2011,13IF00,311,0,1,1,eneheuvel,20-03-12
201113IF00312,2011,13IF00,312,1,3,4,eneheuvel,20-03-12
201113IU00101,2011,13IU00,101,1,0,1,eneheuvel,20-03-12
201113IU00102,2011,13IU00,102,3,9,12,eneheuvel,20-03-12
201113IU00103,2011,13IU00,103,3,7,10,eneheuvel,20-03-12
201113IU00104,2011,13IU00,104,1,3,4,eneheuvel,20-03-12
201113IU00105,2011,13IU00,105,3,5,8,eneheuvel,20-03-12
201113IU00106,2011,13IU00,106,45,38,83,eneheuvel,20-03-12
201113IU00107,2011,13IU00,107,5,5,10,eneheuvel,20-03-12
201113IU00108,2011,13IU00,108,1,3,4,eneheuvel,20-03-12
201113IU00109,2011,13IU00,109,1,3,4,eneheuvel,20-03-12
201113IU00110,2011,13IU00,110,1,2,3,eneheuvel,20-03-12
201113IU00202,2011,13IU00,202,2,0,2,eneheuvel,20-03-12
201113IU00211,2011,13IU00,211,0,1,1,eneheuvel,20-03-12
201113IU00216,2011,13IU00,216,0,1,1,eneheuvel,20-03-12
201113IU00311,2011,13IU00,311,1,1,2,eneheuvel,20-03-12
201113IU009999,2011,13IU00,9999,1,0,1,eneheuvel,20-03-12
201113NH00101,2011,13NH00,101,2,4,6,eneheuvel,20-03-12
201113NH00102,2011,13NH00,102,14,7,21,eneheuvel,20-03-12
201113NH00103,2011,13NH00,103,1,3,4,eneheuvel,20-03-12
201113NH00104,2011,13NH00,104,36,17,53,eneheuvel,20-03-12
201113NH00105,2011,13NH00,105,56,63,119,eneheuvel,20-03-12
201113NH00106,2011,13NH00,106,22,18,40,eneheuvel,20-03-12
201113NH00107,2011,13NH00,107,2,1,3,eneheuvel,20-03-12
201113NH00108,2011,13NH00,108,1,0,1,eneheuvel,20-03-12
201113NH00109,2011,13NH00,109,1,0,1,eneheuvel,20-03-12
201113NH00110,2011,13NH00,110,13,23,36,eneheuvel,20-03-12
201113NH00203,2011,13NH00,203,2,0,2,eneheuvel,20-03-12
201113NH00204,2011,13NH00,204,1,0,1,eneheuvel,20-03-12
201113NH00206,2011,13NH00,206,0,1,1,eneheuvel,20-03-12
201113NH00208,2011,13NH00,208,2,1,3,eneheuvel,20-03-12
201113NH00211,2011,13NH00,211,0,1,1,eneheuvel,20-03-12
201113NH00216,2011,13NH00,216,0,1,1,eneheuvel,20-03-12
201113NH00311,2011,13NH00,311,1,0,1,eneheuvel,20-03-12
201113NH00312,2011,13NH00,312,1,0,1,eneheuvel,20-03-12
201113NH00502,2011,13NH00,502,2,2,4,eneheuvel,20-03-12
201113NH009999,2011,13NH00,9999,1,1,2,eneheuvel,20-03-12
201113NU00201,2011,13NU00,201,0,2,2,eneheuvel,20-03-12
201113NU00204,2011,13NU00,204,2,0,2,eneheuvel,20-03-12
201113NU00205,2011,13NU00,205,0,2,2,eneheuvel,20-03-12
201113NU00211,2011,13NU00,211,1,0,1,eneheuvel,20-03-12
201113NU00301,2011,13NU00,301,10,11,21,eneheuvel,20-03-12
201113NU00302,2011,13NU00,302,4,3,7,eneheuvel,20-03-12
201113NU00303,2011,13NU00,303,15,25,40,eneheuvel,20-03-12
201113NU00304,2011,13NU00,304,59,53,112,eneheuvel,20-03-12
201113NU00305,2011,13NU00,305,18,11,29,eneheuvel,20-03-12
201113NU00306,2011,13NU00,306,10,20,30,eneheuvel,20-03-12
201113NU00307,2011,13NU00,307,2,2,4,eneheuvel,20-03-12
201113NU00308,2011,13NU00,308,2,3,5,eneheuvel,20-03-12
201113NU00312,2011,13NU00,312,1,0,1,eneheuvel,20-03-12
201114QC00102,2011,14QC00,102,1,0,1,eneheuvel,20-03-12
201114QC00106,2011,14QC00,106,0,1,1,eneheuvel,20-03-12
201114QC00108,2011,14QC00,108,1,1,2,eneheuvel,20-03-12
201114QC00109,2011,14QC00,109,2,1,3,eneheuvel,20-03-12
201114QC00110,2011,14QC00,110,4,0,4,eneheuvel,20-03-12
201114QC00201,2011,14QC00,201,4,0,4,eneheuvel,20-03-12
201114QC00202,2011,14QC00,202,58,38,96,eneheuvel,20-03-12
201114QC00203,2011,14QC00,203,26,34,60,eneheuvel,20-03-12
201114QC00204,2011,14QC00,204,20,21,41,eneheuvel,20-03-12
201114QC00205,2011,14QC00,205,13,19,32,eneheuvel,20-03-12
201114QC00206,2011,14QC00,206,45,19,64,eneheuvel,20-03-12
201114QC00207,2011,14QC00,207,17,11,28,eneheuvel,20-03-12
201114QC00208,2011,14QC00,208,31,24,55,eneheuvel,20-03-12
201114QC00209,2011,14QC00,209,8,1,9,eneheuvel,20-03-12
201114QC00210,2011,14QC00,210,13,2,15,eneheuvel,20-03-12
201114QC00211,2011,14QC00,211,4,7,11,eneheuvel,20-03-12
201114QC00212,2011,14QC00,212,2,1,3,eneheuvel,20-03-12
201114QC00213,2011,14QC00,213,0,2,2,eneheuvel,20-03-12
201114QC00214,2011,14QC00,214,2,0,2,eneheuvel,20-03-12
201114QC00215,2011,14QC00,215,1,4,5,eneheuvel,20-03-12
201114QC00216,2011,14QC00,216,1,1,2,eneheuvel,20-03-12
201114QC00301,2011,14QC00,301,1,0,1,eneheuvel,20-03-12
201114QC00302,2011,14QC00,302,2,4,6,eneheuvel,20-03-12
201114QC00303,2011,14QC00,303,18,13,31,eneheuvel,20-03-12
201114QC00304,2011,14QC00,304,0,1,1,eneheuvel,20-03-12
201114QC00306,2011,14QC00,306,1,1,2,eneheuvel,20-03-12
201114QC00307,2011,14QC00,307,3,2,5,eneheuvel,20-03-12
201114QC00308,2011,14QC00,308,1,0,1,eneheuvel,20-03-12
201114QC00309,2011,14QC00,309,1,2,3,eneheuvel,20-03-12
201114QC00310,2011,14QC00,310,1,0,1,eneheuvel,20-03-12
201114QC00311,2011,14QC00,311,6,12,18,eneheuvel,20-03-12
201114QC00312,2011,14QC00,312,6,5,11,eneheuvel,20-03-12
201114QC00313,2011,14QC00,313,1,2,3,eneheuvel,20-03-12
201114QC00401,2011,14QC00,401,0,1,1,eneheuvel,20-03-12
201114QC00402,2011,14QC00,402,1,0,1,eneheuvel,20-03-12
201114QC00403,2011,14QC00,403,2,1,3,eneheuvel,20-03-12
201114QC00502,2011,14QC00,502,11,11,22,eneheuvel,20-03-12
201114QC009999,2011,14QC00,9999,2,1,3,eneheuvel,20-03-12
201114QC02103,2011,14QC02,103,1,0,1,eneheuvel,20-03-12
201114QC02109,2011,14QC02,109,0,1,1,eneheuvel,20-03-12
201114QC02203,2011,14QC02,203,1,0,1,eneheuvel,20-03-12
201114QC02209,2011,14QC02,209,1,1,2,eneheuvel,20-03-12
201114QC02210,2011,14QC02,210,0,2,2,eneheuvel,20-03-12
201114QC02211,2011,14QC02,211,9,2,11,eneheuvel,20-03-12
201114QC02212,2011,14QC02,212,29,17,46,eneheuvel,20-03-12
201114QC02213,2011,14QC02,213,4,5,9,eneheuvel,20-03-12
201114QC02214,2011,14QC02,214,4,5,9,eneheuvel,20-03-12
201114QC02216,2011,14QC02,216,1,1,2,eneheuvel,20-03-12
201114QC02304,2011,14QC02,304,1,0,1,eneheuvel,20-03-12
201114QC02403,2011,14QC02,403,1,0,1,eneheuvel,20-03-12
201115SJ00101,2011,15SJ00,101,0,2,2,eneheuvel,20-03-12
201115SJ00102,2011,15SJ00,102,2,7,9,eneheuvel,20-03-12
201115SJ00103,2011,15SJ00,103,3,6,9,eneheuvel,20-03-12
201115SJ00104,2011,15SJ00,104,0,3,3,eneheuvel,20-03-12
201115SJ00105,2011,15SJ00,105,0,2,2,eneheuvel,20-03-12
201115SJ00106,2011,15SJ00,106,1,3,4,eneheuvel,20-03-12
201115SJ00108,2011,15SJ00,108,0,6,6,eneheuvel,20-03-12
201115SJ00109,2011,15SJ00,109,0,1,1,eneheuvel,20-03-12
201115SJ00201,2011,15SJ00,201,1,2,3,eneheuvel,20-03-12
201115SJ00202,2011,15SJ00,202,1,7,8,eneheuvel,20-03-12
201115SJ00203,2011,15SJ00,203,0,6,6,eneheuvel,20-03-12
201115SJ00204,2011,15SJ00,204,1,4,5,eneheuvel,20-03-12
201115SJ00205,2011,15SJ00,205,1,1,2,eneheuvel,20-03-12
201115SJ00206,2011,15SJ00,206,3,19,22,eneheuvel,20-03-12
201115SJ00207,2011,15SJ00,207,3,14,17,eneheuvel,20-03-12
201115SJ00208,2011,15SJ00,208,0,11,11,eneheuvel,20-03-12
201115SJ00209,2011,15SJ00,209,2,9,11,eneheuvel,20-03-12
201115SJ00210,2011,15SJ00,210,3,20,23,eneheuvel,20-03-12
201115SJ00211,2011,15SJ00,211,1,24,25,eneheuvel,20-03-12
201115SJ00212,2011,15SJ00,212,1,11,12,eneheuvel,20-03-12
201115SJ00213,2011,15SJ00,213,1,4,5,eneheuvel,20-03-12
201115SJ00214,2011,15SJ00,214,1,8,9,eneheuvel,20-03-12
201115SJ00216,2011,15SJ00,216,0,7,7,eneheuvel,20-03-12
201115SJ00301,2011,15SJ00,301,0,2,2,eneheuvel,20-03-12
201115SJ00302,2011,15SJ00,302,1,7,8,eneheuvel,20-03-12
201115SJ00303,2011,15SJ00,303,1,3,4,eneheuvel,20-03-12
201115SJ00304,2011,15SJ00,304,0,9,9,eneheuvel,20-03-12
201115SJ00305,2011,15SJ00,305,0,11,11,eneheuvel,20-03-12
201115SJ00306,2011,15SJ00,306,0,6,6,eneheuvel,20-03-12
201115SJ00307,2011,15SJ00,307,0,3,3,eneheuvel,20-03-12
201115SJ00308,2011,15SJ00,308,1,7,8,eneheuvel,20-03-12
201115SJ00309,2011,15SJ00,309,1,8,9,eneheuvel,20-03-12
201115SJ00311,2011,15SJ00,311,4,6,10,eneheuvel,20-03-12
201115SJ00312,2011,15SJ00,312,0,2,2,eneheuvel,20-03-12
201115SJ00401,2011,15SJ00,401,0,2,2,eneheuvel,20-03-12
201115SJ00402,2011,15SJ00,402,0,2,2,eneheuvel,20-03-12
201115SJ00403,2011,15SJ00,403,0,3,3,eneheuvel,20-03-12
201115SJ009999,2011,15SJ00,9999,0,3,3,eneheuvel,20-03-12
201116CK00203,2011,16CK00,203,1,0,1,eneheuvel,20-03-12
201116CK00206,2011,16CK00,206,0,1,1,eneheuvel,20-03-12
201116CK00213,2011,16CK00,213,1,0,1,eneheuvel,20-03-12
201116CK00305,2011,16CK00,305,1,0,1,eneheuvel,20-03-12
201116KK00101,2011,16KK00,101,18,13,31,eneheuvel,20-03-12
201116KK00102,2011,16KK00,102,24,31,55,eneheuvel,20-03-12
201116KK00103,2011,16KK00,103,52,61,113,eneheuvel,20-03-12
201116KK00104,2011,16KK00,104,5,0,5,eneheuvel,20-03-12
201116KK00105,2011,16KK00,105,4,2,6,eneheuvel,20-03-12
201116KK00106,2011,16KK00,106,4,3,7,eneheuvel,20-03-12
201116KK00107,2011,16KK00,107,3,14,17,eneheuvel,20-03-12
201116KK00108,2011,16KK00,108,19,28,47,eneheuvel,20-03-12
201116KK00109,2011,16KK00,109,12,8,20,eneheuvel,20-03-12
201116KK00110,2011,16KK00,110,1,0,1,eneheuvel,20-03-12
201116KK00202,2011,16KK00,202,0,2,2,eneheuvel,20-03-12
201116KK00206,2011,16KK00,206,3,1,4,eneheuvel,20-03-12
201116KK00207,2011,16KK00,207,1,3,4,eneheuvel,20-03-12
201116KK00208,2011,16KK00,208,1,1,2,eneheuvel,20-03-12
201116KK00210,2011,16KK00,210,0,1,1,eneheuvel,20-03-12
201116KK00211,2011,16KK00,211,2,4,6,eneheuvel,20-03-12
201116KK00213,2011,16KK00,213,1,0,1,eneheuvel,20-03-12
201116KK00308,2011,16KK00,308,2,0,2,eneheuvel,20-03-12
201116KK00313,2011,16KK00,313,1,0,1,eneheuvel,20-03-12
201116KK00402,2011,16KK00,402,1,0,1,eneheuvel,20-03-12
201116KK00403,2011,16KK00,403,0,1,1,eneheuvel,20-03-12
201116KK00502,2011,16KK00,502,2,1,3,eneheuvel,20-03-12
201116KK009999,2011,16KK00,9999,2,1,3,eneheuvel,20-03-12
201116LJ00101,2011,16LJ00,101,2,1,3,eneheuvel,20-03-12
201116LJ00102,2011,16LJ00,102,7,6,13,eneheuvel,20-03-12
201116LJ00103,2011,16LJ00,103,3,0,3,eneheuvel,20-03-12
201116LJ00104,2011,16LJ00,104,0,2,2,eneheuvel,20-03-12
201116LJ00105,2011,16LJ00,105,1,0,1,eneheuvel,20-03-12
201116LJ00106,2011,16LJ00,106,29,43,72,eneheuvel,20-03-12
201116LJ00107,2011,16LJ00,107,1,2,3,eneheuvel,20-03-12
201116LJ00108,2011,16LJ00,108,2,1,3,eneheuvel,20-03-12
201116LJ00203,2011,16LJ00,203,1,2,3,eneheuvel,20-03-12
201116LJ00208,2011,16LJ00,208,1,1,2,eneheuvel,20-03-12
201116LJ00209,2011,16LJ00,209,0,1,1,eneheuvel,20-03-12
201116LJ00211,2011,16LJ00,211,1,0,1,eneheuvel,20-03-12
201116LJ00307,2011,16LJ00,307,1,0,1,eneheuvel,20-03-12
201116ML00101,2011,16ML00,101,2,2,4,eneheuvel,20-03-12
201116ML00102,2011,16ML00,102,24,37,61,eneheuvel,20-03-12
201116ML00103,2011,16ML00,103,4,3,7,eneheuvel,20-03-12
201116ML00104,2011,16ML00,104,51,48,99,eneheuvel,20-03-12
201116ML00105,2011,16ML00,105,25,22,47,eneheuvel,20-03-12
201116ML00106,2011,16ML00,106,4,4,8,eneheuvel,20-03-12
201116ML00107,2011,16ML00,107,1,4,5,eneheuvel,20-03-12
201116ML00108,2011,16ML00,108,2,2,4,eneheuvel,20-03-12
201116ML00109,2011,16ML00,109,0,1,1,eneheuvel,20-03-12
201116ML00110,2011,16ML00,110,1,1,2,eneheuvel,20-03-12
201116ML00201,2011,16ML00,201,0,1,1,eneheuvel,20-03-12
201116ML00202,2011,16ML00,202,0,1,1,eneheuvel,20-03-12
201116ML00203,2011,16ML00,203,0,2,2,eneheuvel,20-03-12
201116ML00210,2011,16ML00,210,0,1,1,eneheuvel,20-03-12
201116ML00211,2011,16ML00,211,0,1,1,eneheuvel,20-03-12
201116ML00311,2011,16ML00,311,0,1,1,eneheuvel,20-03-12
201116ML00403,2011,16ML00,403,1,0,1,eneheuvel,20-03-12
201116ML00502,2011,16ML00,502,4,2,6,eneheuvel,20-03-12
201116ML009999,2011,16ML00,9999,1,1,2,eneheuvel,20-03-12
201116OC00101,2011,16OC00,101,4,2,6,eneheuvel,20-03-12
201116OC00102,2011,16OC00,102,5,3,8,eneheuvel,20-03-12
201116OC00103,2011,16OC00,103,11,12,23,eneheuvel,20-03-12
201116OC00104,2011,16OC00,104,1,1,2,eneheuvel,20-03-12
201116OC00105,2011,16OC00,105,1,2,3,eneheuvel,20-03-12
201116OC00106,2011,16OC00,106,7,5,12,eneheuvel,20-03-12
201116OC00107,2011,16OC00,107,72,60,132,eneheuvel,20-03-12
201116OC00108,2011,16OC00,108,30,13,43,eneheuvel,20-03-12
201116OC00109,2011,16OC00,109,44,57,101,eneheuvel,20-03-12
201116OC00202,2011,16OC00,202,1,0,1,eneheuvel,20-03-12
201116OC00207,2011,16OC00,207,1,0,1,eneheuvel,20-03-12
201116OC00208,2011,16OC00,208,1,0,1,eneheuvel,20-03-12
201116OC00211,2011,16OC00,211,1,0,1,eneheuvel,20-03-12
201116OC00213,2011,16OC00,213,0,2,2,eneheuvel,20-03-12
201116OC00214,2011,16OC00,214,1,1,2,eneheuvel,20-03-12
201116OC00216,2011,16OC00,216,1,1,2,eneheuvel,20-03-12
201116OC00304,2011,16OC00,304,0,1,1,eneheuvel,20-03-12
201116OC00309,2011,16OC00,309,0,1,1,eneheuvel,20-03-12
201116OC00502,2011,16OC00,502,2,0,2,eneheuvel,20-03-12
201116OC009999,2011,16OC00,9999,2,1,3,eneheuvel,20-03-12
201116UK00101,2011,16UK00,101,0,2,2,eneheuvel,20-03-12
201116UK00103,2011,16UK00,103,7,7,14,eneheuvel,20-03-12
201116UK00107,2011,16UK00,107,1,0,1,eneheuvel,20-03-12
201116UK00108,2011,16UK00,108,69,68,137,eneheuvel,20-03-12
201116UK00109,2011,16UK00,109,0,1,1,eneheuvel,20-03-12
201116UK00214,2011,16UK00,214,1,0,1,eneheuvel,20-03-12
201116WV00101,2011,16WV00,101,1,1,2,eneheuvel,20-03-12
201116WV00108,2011,16WV00,108,1,0,1,eneheuvel,20-03-12
201116WV00201,2011,16WV00,201,10,5,15,eneheuvel,20-03-12
201116WV00202,2011,16WV00,202,0,1,1,eneheuvel,20-03-12
201116WV00204,2011,16WV00,204,1,1,2,eneheuvel,20-03-12
201116WV00209,2011,16WV00,209,8,13,21,eneheuvel,20-03-12
201116WV00211,2011,16WV00,211,50,58,108,eneheuvel,20-03-12
201116WV00213,2011,16WV00,213,1,1,2,eneheuvel,20-03-12
201116WV00214,2011,16WV00,214,1,0,1,eneheuvel,20-03-12
201116WV009999,2011,16WV00,9999,0,1,1,eneheuvel,20-03-12
201116YS00201,2011,16YS00,201,4,7,11,eneheuvel,20-03-12
201116YS00202,2011,16YS00,202,0,2,2,eneheuvel,20-03-12
201116YS00206,2011,16YS00,206,1,0,1,eneheuvel,20-03-12
201116YS00207,2011,16YS00,207,2,0,2,eneheuvel,20-03-12
201116YS00209,2011,16YS00,209,2,1,3,eneheuvel,20-03-12
201116YS00210,2011,16YS00,210,1,0,1,eneheuvel,20-03-12
201116YS00211,2011,16YS00,211,74,72,146,eneheuvel,20-03-12
201116YS00212,2011,16YS00,212,0,3,3,eneheuvel,20-03-12
201116YS00213,2011,16YS00,213,1,3,4,eneheuvel,20-03-12
201116YS00305,2011,16YS00,305,1,0,1,eneheuvel,20-03-12
201116YS00308,2011,16YS00,308,0,1,1,eneheuvel,20-03-12
201116YS00309,2011,16YS00,309,2,0,2,eneheuvel,20-03-12
201116ZG00201,2011,16ZG00,201,1,0,1,eneheuvel,20-03-12
201116ZG00208,2011,16ZG00,208,1,0,1,eneheuvel,20-03-12
201116ZG00211,2011,16ZG00,211,68,63,131,eneheuvel,20-03-12
201116ZG00301,2011,16ZG00,301,1,0,1,eneheuvel,20-03-12
201116ZG00303,2011,16ZG00,303,1,0,1,eneheuvel,20-03-12
201116ZG009999,2011,16ZG00,9999,1,0,1,eneheuvel,20-03-12
201116ZX00201,2011,16ZX00,201,0,1,1,eneheuvel,20-03-12
201116ZX00203,2011,16ZX00,203,0,1,1,eneheuvel,20-03-12
201116ZX00206,2011,16ZX00,206,9,13,22,eneheuvel,20-03-12
201116ZX00209,2011,16ZX00,209,26,34,60,eneheuvel,20-03-12
201116ZX00210,2011,16ZX00,210,0,1,1,eneheuvel,20-03-12
201116ZX00212,2011,16ZX00,212,0,1,1,eneheuvel,20-03-12
201116ZX00214,2011,16ZX00,214,1,1,2,eneheuvel,20-03-12
201116ZX00304,2011,16ZX00,304,1,0,1,eneheuvel,20-03-12
201116ZX00312,2011,16ZX00,312,1,1,2,eneheuvel,20-03-12
201116ZX009999,2011,16ZX00,9999,0,1,1,eneheuvel,20-03-12
201117AK00103,2011,17AK00,103,1,0,1,eneheuvel,20-03-12
201117AK00205,2011,17AK00,205,0,1,1,eneheuvel,20-03-12
201117AK00206,2011,17AK00,206,39,59,98,eneheuvel,20-03-12
201117AK00207,2011,17AK00,207,1,3,4,eneheuvel,20-03-12
201117AK00209,2011,17AK00,209,2,4,6,eneheuvel,20-03-12
201117AK00210,2011,17AK00,210,2,5,7,eneheuvel,20-03-12
201117AK00216,2011,17AK00,216,1,0,1,eneheuvel,20-03-12
201117AK00301,2011,17AK00,301,0,1,1,eneheuvel,20-03-12
201117AK00303,2011,17AK00,303,1,0,1,eneheuvel,20-03-12
201117AK00304,2011,17AK00,304,0,1,1,eneheuvel,20-03-12
201117AK00306,2011,17AK00,306,2,1,3,eneheuvel,20-03-12
201117AK00307,2011,17AK00,307,0,1,1,eneheuvel,20-03-12
201117AK00309,2011,17AK00,309,0,2,2,eneheuvel,20-03-12
201117AK00312,2011,17AK00,312,2,0,2,eneheuvel,20-03-12
201117AV00102,2011,17AV00,102,0,2,2,eneheuvel,20-03-12
201117AV00205,2011,17AV00,205,3,1,4,eneheuvel,20-03-12
201117AV00206,2011,17AV00,206,59,63,122,eneheuvel,20-03-12
201117AV00207,2011,17AV00,207,1,2,3,eneheuvel,20-03-12
201117AV00209,2011,17AV00,209,1,2,3,eneheuvel,20-03-12
201117AV00304,2011,17AV00,304,2,0,2,eneheuvel,20-03-12
201117AV009999,2011,17AV00,9999,0,2,2,eneheuvel,20-03-12
201117BP00103,2011,17BP00,103,1,0,1,eneheuvel,20-03-12
201117BP00201,2011,17BP00,201,1,0,1,eneheuvel,20-03-12
201117BP00209,2011,17BP00,209,3,1,4,eneheuvel,20-03-12
201117BP00210,2011,17BP00,210,3,4,7,eneheuvel,20-03-12
201117BP00211,2011,17BP00,211,54,68,122,eneheuvel,20-03-12
201117BP00212,2011,17BP00,212,2,4,6,eneheuvel,20-03-12
201117BP00213,2011,17BP00,213,46,66,112,eneheuvel,20-03-12
201117BP00214,2011,17BP00,214,1,3,4,eneheuvel,20-03-12
201117BP00403,2011,17BP00,403,0,2,2,eneheuvel,20-03-12
201117BP00502,2011,17BP00,502,0,2,2,eneheuvel,20-03-12
201117DA00209,2011,17DA00,209,10,11,21,eneheuvel,20-03-12
201117DA00210,2011,17DA00,210,62,64,126,eneheuvel,20-03-12
201117DA00211,2011,17DA00,211,1,3,4,eneheuvel,20-03-12
201117DA00212,2011,17DA00,212,1,1,2,eneheuvel,20-03-12
201117DA03108,2011,17DA03,108,1,0,1,eneheuvel,20-03-12
201117DA03201,2011,17DA03,201,1,0,1,eneheuvel,20-03-12
201117DA03206,2011,17DA03,206,1,0,1,eneheuvel,20-03-12
201117DA03207,2011,17DA03,207,0,1,1,eneheuvel,20-03-12
201117DA03209,2011,17DA03,209,6,6,12,eneheuvel,20-03-12
201117DA03210,2011,17DA03,210,76,61,137,eneheuvel,20-03-12
201117DA03211,2011,17DA03,211,3,1,4,eneheuvel,20-03-12
201117DA03212,2011,17DA03,212,1,2,3,eneheuvel,20-03-12
201117DA03216,2011,17DA03,216,0,2,2,eneheuvel,20-03-12
201117DA03307,2011,17DA03,307,0,1,1,eneheuvel,20-03-12
201117DK00202,2011,17DK00,202,0,1,1,eneheuvel,20-03-12
201117DK00203,2011,17DK00,203,0,1,1,eneheuvel,20-03-12
201117DK00206,2011,17DK00,206,1,1,2,eneheuvel,20-03-12
201117DK00207,2011,17DK00,207,0,2,2,eneheuvel,20-03-12
201117DK00208,2011,17DK00,208,3,2,5,eneheuvel,20-03-12
201117DK00301,2011,17DK00,301,7,7,14,eneheuvel,20-03-12
201117DK00302,2011,17DK00,302,1,0,1,eneheuvel,20-03-12
201117DK00303,2011,17DK00,303,2,4,6,eneheuvel,20-03-12
201117DK00304,2011,17DK00,304,53,43,96,eneheuvel,20-03-12
201117DK00305,2011,17DK00,305,12,7,19,eneheuvel,20-03-12
201117DK00306,2011,17DK00,306,1,3,4,eneheuvel,20-03-12
201117DK00308,2011,17DK00,308,0,2,2,eneheuvel,20-03-12
201117DK00309,2011,17DK00,309,2,3,5,eneheuvel,20-03-12
201117DK00311,2011,17DK00,311,1,1,2,eneheuvel,20-03-12
201117DV00101,2011,17DV00,101,0,1,1,eneheuvel,20-03-12
201117DV00201,2011,17DV00,201,6,0,6,eneheuvel,20-03-12
201117DV00202,2011,17DV00,202,1,0,1,eneheuvel,20-03-12
201117DV00203,2011,17DV00,203,1,2,3,eneheuvel,20-03-12
201117DV00205,2011,17DV00,205,1,1,2,eneheuvel,20-03-12
201117DV00207,2011,17DV00,207,3,6,9,eneheuvel,20-03-12
201117DV00208,2011,17DV00,208,3,0,3,eneheuvel,20-03-12
201117DV00211,2011,17DV00,211,1,2,3,eneheuvel,20-03-12
201117DV00213,2011,17DV00,213,0,1,1,eneheuvel,20-03-12
201117DV00216,2011,17DV00,216,1,1,2,eneheuvel,20-03-12
201117DV00301,2011,17DV00,301,11,7,18,eneheuvel,20-03-12
201117DV00302,2011,17DV00,302,8,5,13,eneheuvel,20-03-12
201117DV00303,2011,17DV00,303,26,30,56,eneheuvel,20-03-12
201117DV00304,2011,17DV00,304,33,35,68,eneheuvel,20-03-12
201117DV00305,2011,17DV00,305,11,8,19,eneheuvel,20-03-12
201117DV00306,2011,17DV00,306,8,9,17,eneheuvel,20-03-12
201117DV00307,2011,17DV00,307,6,7,13,eneheuvel,20-03-12
201117DV00308,2011,17DV00,308,16,12,28,eneheuvel,20-03-12
201117DV00309,2011,17DV00,309,29,15,44,eneheuvel,20-03-12
201117DV00310,2011,17DV00,310,0,2,2,eneheuvel,20-03-12
201117DV00311,2011,17DV00,311,4,10,14,eneheuvel,20-03-12
201117DV00312,2011,17DV00,312,4,2,6,eneheuvel,20-03-12
201117DV00502,2011,17DV00,502,0,1,1,eneheuvel,20-03-12
201117DV009999,2011,17DV00,9999,1,1,2,eneheuvel,20-03-12
201117FI00101,2011,17FI00,101,0,1,1,eneheuvel,20-03-12
201117FI00102,2011,17FI00,102,0,7,7,eneheuvel,20-03-12
201117FI00103,2011,17FI00,103,1,2,3,eneheuvel,20-03-12
201117FI00106,2011,17FI00,106,0,1,1,eneheuvel,20-03-12
201117FI00108,2011,17FI00,108,0,6,6,eneheuvel,20-03-12
201117FI00110,2011,17FI00,110,0,1,1,eneheuvel,20-03-12
201117FI00201,2011,17FI00,201,0,1,1,eneheuvel,20-03-12
201117FI00202,2011,17FI00,202,4,21,25,eneheuvel,20-03-12
201117FI00203,2011,17FI00,203,2,12,14,eneheuvel,20-03-12
201117FI00204,2011,17FI00,204,1,13,14,eneheuvel,20-03-12
201117FI00205,2011,17FI00,205,0,3,3,eneheuvel,20-03-12
201117FI00206,2011,17FI00,206,2,8,10,eneheuvel,20-03-12
201117FI00207,2011,17FI00,207,2,4,6,eneheuvel,20-03-12
201117FI00208,2011,17FI00,208,1,10,11,eneheuvel,20-03-12
201117FI00209,2011,17FI00,209,0,4,4,eneheuvel,20-03-12
201117FI00210,2011,17FI00,210,0,9,9,eneheuvel,20-03-12
201117FI00211,2011,17FI00,211,1,11,12,eneheuvel,20-03-12
201117FI00212,2011,17FI00,212,2,5,7,eneheuvel,20-03-12
201117FI00213,2011,17FI00,213,2,6,8,eneheuvel,20-03-12
201117FI00214,2011,17FI00,214,1,8,9,eneheuvel,20-03-12
201117FI00216,2011,17FI00,216,1,2,3,eneheuvel,20-03-12
201117FI00302,2011,17FI00,302,1,4,5,eneheuvel,20-03-12
201117FI00303,2011,17FI00,303,0,5,5,eneheuvel,20-03-12
201117FI00304,2011,17FI00,304,0,4,4,eneheuvel,20-03-12
201117FI00305,2011,17FI00,305,1,5,6,eneheuvel,20-03-12
201117FI00306,2011,17FI00,306,1,4,5,eneheuvel,20-03-12
201117FI00307,2011,17FI00,307,1,8,9,eneheuvel,20-03-12
201117FI00308,2011,17FI00,308,0,4,4,eneheuvel,20-03-12
201117FI00309,2011,17FI00,309,1,4,5,eneheuvel,20-03-12
201117FI00310,2011,17FI00,310,0,1,1,eneheuvel,20-03-12
201117FI00311,2011,17FI00,311,1,4,5,eneheuvel,20-03-12
201117FI00312,2011,17FI00,312,1,1,2,eneheuvel,20-03-12
201117FI00313,2011,17FI00,313,0,1,1,eneheuvel,20-03-12
201117FI00402,2011,17FI00,402,0,1,1,eneheuvel,20-03-12
201117FI00403,2011,17FI00,403,0,2,2,eneheuvel,20-03-12
201117FI00502,2011,17FI00,502,0,1,1,eneheuvel,20-03-12
201117FI009999,2011,17FI00,9999,0,2,2,eneheuvel,20-03-12
201117LP00205,2011,17LP00,205,1,0,1,eneheuvel,20-03-12
201117LP00207,2011,17LP00,207,1,0,1,eneheuvel,20-03-12
201117LP00303,2011,17LP00,303,1,0,1,eneheuvel,20-03-12
201117LP00304,2011,17LP00,304,1,0,1,eneheuvel,20-03-12
201117LP00305,2011,17LP00,305,56,53,109,eneheuvel,20-03-12
201117LP00306,2011,17LP00,306,4,5,9,eneheuvel,20-03-12
201117LP00309,2011,17LP00,309,1,0,1,eneheuvel,20-03-12
201117LP00311,2011,17LP00,311,1,0,1,eneheuvel,20-03-12
201117LP00312,2011,17LP00,312,1,0,1,eneheuvel,20-03-12
201117MH00202,2011,17MH00,202,0,2,2,eneheuvel,20-03-12
201117MH00203,2011,17MH00,203,0,2,2,eneheuvel,20-03-12
201117MH00207,2011,17MH00,207,0,2,2,eneheuvel,20-03-12
201117MH00209,2011,17MH00,209,2,0,2,eneheuvel,20-03-12
201117MH00211,2011,17MH00,211,1,2,3,eneheuvel,20-03-12
201117MH00212,2011,17MH00,212,0,1,1,eneheuvel,20-03-12
201117MH00216,2011,17MH00,216,0,1,1,eneheuvel,20-03-12
201117MH00302,2011,17MH00,302,1,1,2,eneheuvel,20-03-12
201117MH00303,2011,17MH00,303,1,1,2,eneheuvel,20-03-12
201117MH00304,2011,17MH00,304,1,2,3,eneheuvel,20-03-12
201117MH00305,2011,17MH00,305,83,106,189,eneheuvel,20-03-12
201117MH00306,2011,17MH00,306,9,8,17,eneheuvel,20-03-12
201117MH00307,2011,17MH00,307,1,2,3,eneheuvel,20-03-12
201117MH00308,2011,17MH00,308,2,2,4,eneheuvel,20-03-12
201117MH00309,2011,17MH00,309,4,5,9,eneheuvel,20-03-12
201117MH00311,2011,17MH00,311,2,2,4,eneheuvel,20-03-12
201117MH00312,2011,17MH00,312,0,1,1,eneheuvel,20-03-12
201117MH009999,2011,17MH00,9999,1,0,1,eneheuvel,20-03-12
201121KO00201,2011,21KO00,201,1,0,1,eneheuvel,20-03-12
201121KO00202,2011,21KO00,202,0,1,1,eneheuvel,20-03-12
201121KO00205,2011,21KO00,205,0,1,1,eneheuvel,20-03-12
201121KO00208,2011,21KO00,208,1,0,1,eneheuvel,20-03-12
201121KO00209,2011,21KO00,209,7,3,10,eneheuvel,20-03-12
201121KO00210,2011,21KO00,210,110,119,229,eneheuvel,20-03-12
201121KO00211,2011,21KO00,211,3,1,4,eneheuvel,20-03-12
201121KO00212,2011,21KO00,212,0,3,3,eneheuvel,20-03-12
201121KO00307,2011,21KO00,307,0,1,1,eneheuvel,20-03-12
201121KO009999,2011,21KO00,9999,0,1,1,eneheuvel,20-03-12
201121NC00103,2011,21NC00,103,0,1,1,eneheuvel,20-03-12
201121NC00207,2011,21NC00,207,0,1,1,eneheuvel,20-03-12
201121NC00209,2011,21NC00,209,1,0,1,eneheuvel,20-03-12
201121NC00211,2011,21NC00,211,2,5,7,eneheuvel,20-03-12
201121NC00212,2011,21NC00,212,3,7,10,eneheuvel,20-03-12
201121NC00213,2011,21NC00,213,44,53,97,eneheuvel,20-03-12
201121NC00214,2011,21NC00,214,8,11,19,eneheuvel,20-03-12
201121NC00216,2011,21NC00,216,1,0,1,eneheuvel,20-03-12
201121NC00312,2011,21NC00,312,3,1,4,eneheuvel,20-03-12
201121NC00401,2011,21NC00,401,0,1,1,eneheuvel,20-03-12
201121NC00402,2011,21NC00,402,0,1,1,eneheuvel,20-03-12
201121NC009999,2011,21NC00,9999,2,1,3,eneheuvel,20-03-12
201121ND00102,2011,21ND00,102,0,1,1,eneheuvel,20-03-12
201121ND00202,2011,21ND00,202,1,0,1,eneheuvel,20-03-12
201121ND00206,2011,21ND00,206,1,0,1,eneheuvel,20-03-12
201121ND00211,2011,21ND00,211,14,20,34,eneheuvel,20-03-12
201121ND00212,2011,21ND00,212,8,4,12,eneheuvel,20-03-12
201121ND00213,2011,21ND00,213,53,73,126,eneheuvel,20-03-12
201121ND00214,2011,21ND00,214,1,3,4,eneheuvel,20-03-12
201121ND00216,2011,21ND00,216,0,1,1,eneheuvel,20-03-12
201121ND00303,2011,21ND00,303,1,1,2,eneheuvel,20-03-12
201121ND00402,2011,21ND00,402,1,0,1,eneheuvel,20-03-12
201121ND00403,2011,21ND00,403,2,1,3,eneheuvel,20-03-12
201122KP00102,2011,22KP00,102,0,1,1,eneheuvel,20-03-12
201122KP00108,2011,22KP00,108,1,1,2,eneheuvel,20-03-12
201122KP00202,2011,22KP00,202,1,1,2,eneheuvel,20-03-12
201122KP00203,2011,22KP00,203,0,1,1,eneheuvel,20-03-12
201122KP00204,2011,22KP00,204,1,1,2,eneheuvel,20-03-12
201122KP00205,2011,22KP00,205,1,1,2,eneheuvel,20-03-12
201122KP00207,2011,22KP00,207,0,2,2,eneheuvel,20-03-12
201122KP00208,2011,22KP00,208,3,3,6,eneheuvel,20-03-12
201122KP00210,2011,22KP00,210,1,1,2,eneheuvel,20-03-12
201122KP00211,2011,22KP00,211,1,0,1,eneheuvel,20-03-12
201122KP00214,2011,22KP00,214,1,0,1,eneheuvel,20-03-12
201122KP00301,2011,22KP00,301,2,1,3,eneheuvel,20-03-12
201122KP00302,2011,22KP00,302,4,10,14,eneheuvel,20-03-12
201122KP00303,2011,22KP00,303,1,10,11,eneheuvel,20-03-12
201122KP00304,2011,22KP00,304,0,1,1,eneheuvel,20-03-12
201122KP00305,2011,22KP00,305,1,1,2,eneheuvel,20-03-12
201122KP00306,2011,22KP00,306,1,3,4,eneheuvel,20-03-12
201122KP00307,2011,22KP00,307,3,2,5,eneheuvel,20-03-12
201122KP00308,2011,22KP00,308,2,8,10,eneheuvel,20-03-12
201122KP00309,2011,22KP00,309,127,131,258,eneheuvel,20-03-12
201122KP00310,2011,22KP00,310,11,3,14,eneheuvel,20-03-12
201122KP00311,2011,22KP00,311,17,18,35,eneheuvel,20-03-12
201122KP00312,2011,22KP00,312,1,7,8,eneheuvel,20-03-12
201122KP009999,2011,22KP00,9999,2,0,2,eneheuvel,20-03-12
201123ER00211,2011,23ER00,211,1,0,1,eneheuvel,20-03-12
201123ER00212,2011,23ER00,212,45,62,107,eneheuvel,20-03-12
201123ER00213,2011,23ER00,213,2,0,2,eneheuvel,20-03-12
201123ER00214,2011,23ER00,214,0,1,1,eneheuvel,20-03-12
201123ER00216,2011,23ER00,216,0,1,1,eneheuvel,20-03-12
201123ER00303,2011,23ER00,303,0,1,1,eneheuvel,20-03-12
201123ET00108,2011,23ET00,108,0,1,1,eneheuvel,20-03-12
201123ET00201,2011,23ET00,201,1,1,2,eneheuvel,20-03-12
201123ET00202,2011,23ET00,202,1,1,2,eneheuvel,20-03-12
201123ET00203,2011,23ET00,203,0,1,1,eneheuvel,20-03-12
201123ET00204,2011,23ET00,204,0,1,1,eneheuvel,20-03-12
201123ET00206,2011,23ET00,206,1,0,1,eneheuvel,20-03-12
201123ET00207,2011,23ET00,207,0,2,2,eneheuvel,20-03-12
201123ET00208,2011,23ET00,208,1,1,2,eneheuvel,20-03-12
201123ET00210,2011,23ET00,210,1,0,1,eneheuvel,20-03-12
201123ET00214,2011,23ET00,214,0,1,1,eneheuvel,20-03-12
201123ET00302,2011,23ET00,302,1,1,2,eneheuvel,20-03-12
201123ET00303,2011,23ET00,303,1,0,1,eneheuvel,20-03-12
201123ET00304,2011,23ET00,304,0,3,3,eneheuvel,20-03-12
201123ET00305,2011,23ET00,305,2,0,2,eneheuvel,20-03-12
201123ET00306,2011,23ET00,306,1,3,4,eneheuvel,20-03-12
201123ET00307,2011,23ET00,307,2,5,7,eneheuvel,20-03-12
201123ET00308,2011,23ET00,308,56,67,123,eneheuvel,20-03-12
201123ET00309,2011,23ET00,309,2,9,11,eneheuvel,20-03-12
201123ET00311,2011,23ET00,311,1,1,2,eneheuvel,20-03-12
201123ET00312,2011,23ET00,312,2,6,8,eneheuvel,20-03-12
201123EU00207,2011,23EU00,207,1,2,3,eneheuvel,20-03-12
201123EU00301,2011,23EU00,301,0,1,1,eneheuvel,20-03-12
201123EU00303,2011,23EU00,303,2,2,4,eneheuvel,20-03-12
201123EU00305,2011,23EU00,305,3,4,7,eneheuvel,20-03-12
201123EU00306,2011,23EU00,306,69,104,173,eneheuvel,20-03-12
201123EU00307,2011,23EU00,307,6,5,11,eneheuvel,20-03-12
201123EU00309,2011,23EU00,309,0,1,1,eneheuvel,20-03-12
201123EU00311,2011,23EU00,311,1,1,2,eneheuvel,20-03-12
201123EU00313,2011,23EU00,313,0,1,1,eneheuvel,20-03-12
201123EV00102,2011,23EV00,102,1,0,1,eneheuvel,20-03-12
201123EV00201,2011,23EV00,201,1,1,2,eneheuvel,20-03-12
201123EV00203,2011,23EV00,203,0,1,1,eneheuvel,20-03-12
201123EV00208,2011,23EV00,208,0,1,1,eneheuvel,20-03-12
201123EV00210,2011,23EV00,210,10,12,22,eneheuvel,20-03-12
201123EV00211,2011,23EV00,211,4,10,14,eneheuvel,20-03-12
201123EV00212,2011,23EV00,212,65,100,165,eneheuvel,20-03-12
201123EV00213,2011,23EV00,213,30,22,52,eneheuvel,20-03-12
201123EV00214,2011,23EV00,214,3,2,5,eneheuvel,20-03-12
201123EV00216,2011,23EV00,216,1,1,2,eneheuvel,20-03-12
201123EV00305,2011,23EV00,305,1,0,1,eneheuvel,20-03-12
201123EV00403,2011,23EV00,403,0,1,1,eneheuvel,20-03-12
201123EV009999,2011,23EV00,9999,1,1,2,eneheuvel,20-03-12
201123EY00103,2011,23EY00,103,1,1,2,eneheuvel,20-03-12
201123EY00107,2011,23EY00,107,1,0,1,eneheuvel,20-03-12
201123EY00201,2011,23EY00,201,0,1,1,eneheuvel,20-03-12
201123EY00202,2011,23EY00,202,1,0,1,eneheuvel,20-03-12
201123EY00205,2011,23EY00,205,1,0,1,eneheuvel,20-03-12
201123EY00206,2011,23EY00,206,0,1,1,eneheuvel,20-03-12
201123EY00208,2011,23EY00,208,1,2,3,eneheuvel,20-03-12
201123EY00209,2011,23EY00,209,1,1,2,eneheuvel,20-03-12
201123EY00210,2011,23EY00,210,12,10,22,eneheuvel,20-03-12
201123EY00211,2011,23EY00,211,6,14,20,eneheuvel,20-03-12
201123EY00212,2011,23EY00,212,95,109,204,eneheuvel,20-03-12
201123EY00213,2011,23EY00,213,19,27,46,eneheuvel,20-03-12
201123EY00214,2011,23EY00,214,3,3,6,eneheuvel,20-03-12
201123EY00215,2011,23EY00,215,0,2,2,eneheuvel,20-03-12
201123EY00216,2011,23EY00,216,0,2,2,eneheuvel,20-03-12
201123EY00304,2011,23EY00,304,1,1,2,eneheuvel,20-03-12
201123EY00307,2011,23EY00,307,0,1,1,eneheuvel,20-03-12
201123EY00308,2011,23EY00,308,1,0,1,eneheuvel,20-03-12
201123EY00311,2011,23EY00,311,1,0,1,eneheuvel,20-03-12
201123EY00312,2011,23EY00,312,0,1,1,eneheuvel,20-03-12
201123EY00401,2011,23EY00,401,0,1,1,eneheuvel,20-03-12
201123EY009999,2011,23EY00,9999,1,1,2,eneheuvel,20-03-12
201123ZU00110,2011,23ZU00,110,3,1,4,eneheuvel,20-03-12
201123ZU00201,2011,23ZU00,201,4,2,6,eneheuvel,20-03-12
201123ZU00202,2011,23ZU00,202,71,83,154,eneheuvel,20-03-12
201123ZU00203,2011,23ZU00,203,16,7,23,eneheuvel,20-03-12
201123ZU00204,2011,23ZU00,204,55,51,106,eneheuvel,20-03-12
201123ZU00205,2011,23ZU00,205,71,105,176,eneheuvel,20-03-12
201123ZU00206,2011,23ZU00,206,3,2,5,eneheuvel,20-03-12
201123ZU00207,2011,23ZU00,207,35,25,60,eneheuvel,20-03-12
201123ZU00208,2011,23ZU00,208,23,20,43,eneheuvel,20-03-12
201123ZU00209,2011,23ZU00,209,3,1,4,eneheuvel,20-03-12
201123ZU00210,2011,23ZU00,210,1,1,2,eneheuvel,20-03-12
201123ZU00211,2011,23ZU00,211,0,1,1,eneheuvel,20-03-12
201123ZU00214,2011,23ZU00,214,0,1,1,eneheuvel,20-03-12
201123ZU00215,2011,23ZU00,215,0,1,1,eneheuvel,20-03-12
201123ZU00303,2011,23ZU00,303,0,1,1,eneheuvel,20-03-12
201123ZU00304,2011,23ZU00,304,1,0,1,eneheuvel,20-03-12
201123ZU00305,2011,23ZU00,305,1,0,1,eneheuvel,20-03-12
201123ZU00306,2011,23ZU00,306,1,1,2,eneheuvel,20-03-12
201123ZU00309,2011,23ZU00,309,0,2,2,eneheuvel,20-03-12
201123ZU00311,2011,23ZU00,311,2,1,3,eneheuvel,20-03-12
201123ZU00312,2011,23ZU00,312,1,0,1,eneheuvel,20-03-12
201123ZU00401,2011,23ZU00,401,1,0,1,eneheuvel,20-03-12
201123ZU00502,2011,23ZU00,502,3,3,6,eneheuvel,20-03-12
201123ZU009999,2011,23ZU00,9999,1,0,1,eneheuvel,20-03-12
201123ZV00104,2011,23ZV00,104,1,0,1,eneheuvel,20-03-12
201123ZV00201,2011,23ZV00,201,6,2,8,eneheuvel,20-03-12
201123ZV00202,2011,23ZV00,202,26,35,61,eneheuvel,20-03-12
201123ZV00203,2011,23ZV00,203,3,2,5,eneheuvel,20-03-12
201123ZV00204,2011,23ZV00,204,13,21,34,eneheuvel,20-03-12
201123ZV00205,2011,23ZV00,205,23,40,63,eneheuvel,20-03-12
201123ZV00207,2011,23ZV00,207,6,11,17,eneheuvel,20-03-12
201123ZV00208,2011,23ZV00,208,2,6,8,eneheuvel,20-03-12
201123ZV00210,2011,23ZV00,210,2,1,3,eneheuvel,20-03-12
201123ZV00211,2011,23ZV00,211,5,1,6,eneheuvel,20-03-12
201123ZV00214,2011,23ZV00,214,1,0,1,eneheuvel,20-03-12
201123ZV00302,2011,23ZV00,302,1,0,1,eneheuvel,20-03-12
201123ZV00307,2011,23ZV00,307,0,1,1,eneheuvel,20-03-12
201123ZV00308,2011,23ZV00,308,0,2,2,eneheuvel,20-03-12
201123ZV00309,2011,23ZV00,309,1,0,1,eneheuvel,20-03-12
201123ZV00311,2011,23ZV00,311,1,0,1,eneheuvel,20-03-12
201123ZV009999,2011,23ZV00,9999,0,1,1,eneheuvel,20-03-12
201123ZW00201,2011,23ZW00,201,0,1,1,eneheuvel,20-03-12
201123ZW00205,2011,23ZW00,205,1,0,1,eneheuvel,20-03-12
201123ZW00208,2011,23ZW00,208,4,1,5,eneheuvel,20-03-12
201123ZW00209,2011,23ZW00,209,0,1,1,eneheuvel,20-03-12
201123ZW00214,2011,23ZW00,214,0,1,1,eneheuvel,20-03-12
201123ZW00301,2011,23ZW00,301,1,1,2,eneheuvel,20-03-12
201123ZW00302,2011,23ZW00,302,5,6,11,eneheuvel,20-03-12
201123ZW00303,2011,23ZW00,303,5,4,9,eneheuvel,20-03-12
201123ZW00304,2011,23ZW00,304,0,2,2,eneheuvel,20-03-12
201123ZW00305,2011,23ZW00,305,1,3,4,eneheuvel,20-03-12
201123ZW00306,2011,23ZW00,306,21,25,46,eneheuvel,20-03-12
201123ZW00307,2011,23ZW00,307,53,78,131,eneheuvel,20-03-12
201123ZW00308,2011,23ZW00,308,96,88,184,eneheuvel,20-03-12
201123ZW00309,2011,23ZW00,309,6,7,13,eneheuvel,20-03-12
201123ZW00310,2011,23ZW00,310,1,1,2,eneheuvel,20-03-12
201123ZW00311,2011,23ZW00,311,2,1,3,eneheuvel,20-03-12
201123ZW00312,2011,23ZW00,312,3,4,7,eneheuvel,20-03-12
201123ZW00502,2011,23ZW00,502,2,3,5,eneheuvel,20-03-12
201123ZW009999,2011,23ZW00,9999,0,2,2,eneheuvel,20-03-12
201123ZX00201,2011,23ZX00,201,13,8,21,eneheuvel,20-03-12
201123ZX00202,2011,23ZX00,202,94,122,216,eneheuvel,20-03-12
201123ZX00203,2011,23ZX00,203,5,5,10,eneheuvel,20-03-12
201123ZX00204,2011,23ZX00,204,3,6,9,eneheuvel,20-03-12
201123ZX00205,2011,23ZX00,205,0,5,5,eneheuvel,20-03-12
201123ZX00206,2011,23ZX00,206,1,0,1,eneheuvel,20-03-12
201123ZX00207,2011,23ZX00,207,4,4,8,eneheuvel,20-03-12
201123ZX00208,2011,23ZX00,208,3,9,12,eneheuvel,20-03-12
201123ZX00209,2011,23ZX00,209,3,2,5,eneheuvel,20-03-12
201123ZX00211,2011,23ZX00,211,3,0,3,eneheuvel,20-03-12
201123ZX00308,2011,23ZX00,308,1,0,1,eneheuvel,20-03-12
201123ZX00311,2011,23ZX00,311,0,1,1,eneheuvel,20-03-12
201123ZY00107,2011,23ZY00,107,2,1,3,eneheuvel,20-03-12
201123ZY00204,2011,23ZY00,204,1,0,1,eneheuvel,20-03-12
201123ZY00206,2011,23ZY00,206,0,2,2,eneheuvel,20-03-12
201123ZY00210,2011,23ZY00,210,6,1,7,eneheuvel,20-03-12
201123ZY00211,2011,23ZY00,211,1,3,4,eneheuvel,20-03-12
201123ZY00212,2011,23ZY00,212,132,177,309,eneheuvel,20-03-12
201123ZY00213,2011,23ZY00,213,2,4,6,eneheuvel,20-03-12
201123ZY00214,2011,23ZY00,214,1,1,2,eneheuvel,20-03-12
201123ZY00215,2011,23ZY00,215,1,0,1,eneheuvel,20-03-12
201123ZY00216,2011,23ZY00,216,2,1,3,eneheuvel,20-03-12
201123ZY00312,2011,23ZY00,312,0,1,1,eneheuvel,20-03-12
201123ZY00401,2011,23ZY00,401,1,1,2,eneheuvel,20-03-12
201123ZY009999,2011,23ZY00,9999,1,1,2,eneheuvel,20-03-12
201124EJ00102,2011,24EJ00,102,1,0,1,eneheuvel,20-03-12
201124EJ00108,2011,24EJ00,108,2,2,4,eneheuvel,20-03-12
201124EJ00202,2011,24EJ00,202,3,3,6,eneheuvel,20-03-12
201124EJ00203,2011,24EJ00,203,2,0,2,eneheuvel,20-03-12
201124EJ00204,2011,24EJ00,204,8,4,12,eneheuvel,20-03-12
201124EJ00206,2011,24EJ00,206,1,1,2,eneheuvel,20-03-12
201124EJ00207,2011,24EJ00,207,2,1,3,eneheuvel,20-03-12
201124EJ00208,2011,24EJ00,208,0,1,1,eneheuvel,20-03-12
201124EJ00209,2011,24EJ00,209,11,6,17,eneheuvel,20-03-12
201124EJ00210,2011,24EJ00,210,14,17,31,eneheuvel,20-03-12
201124EJ00211,2011,24EJ00,211,40,27,67,eneheuvel,20-03-12
201124EJ00212,2011,24EJ00,212,8,7,15,eneheuvel,20-03-12
201124EJ00213,2011,24EJ00,213,5,5,10,eneheuvel,20-03-12
201124EJ00214,2011,24EJ00,214,4,1,5,eneheuvel,20-03-12
201124EJ00216,2011,24EJ00,216,1,2,3,eneheuvel,20-03-12
201124EJ00301,2011,24EJ00,301,2,1,3,eneheuvel,20-03-12
201124EJ00302,2011,24EJ00,302,2,0,2,eneheuvel,20-03-12
201124EJ00303,2011,24EJ00,303,0,1,1,eneheuvel,20-03-12
201124EJ00304,2011,24EJ00,304,2,0,2,eneheuvel,20-03-12
201124EJ00309,2011,24EJ00,309,0,3,3,eneheuvel,20-03-12
201124EJ009999,2011,24EJ00,9999,0,1,1,eneheuvel,20-03-12
201124FT00101,2011,24FT00,101,0,2,2,eneheuvel,20-03-12
201124FT00102,2011,24FT00,102,1,4,5,eneheuvel,20-03-12
201124FT00103,2011,24FT00,103,1,1,2,eneheuvel,20-03-12
201124FT00104,2011,24FT00,104,1,0,1,eneheuvel,20-03-12
201124FT00105,2011,24FT00,105,4,0,4,eneheuvel,20-03-12
201124FT00106,2011,24FT00,106,2,1,3,eneheuvel,20-03-12
201124FT00107,2011,24FT00,107,1,2,3,eneheuvel,20-03-12
201124FT00108,2011,24FT00,108,1,1,2,eneheuvel,20-03-12
201124FT00109,2011,24FT00,109,0,1,1,eneheuvel,20-03-12
201124FT00201,2011,24FT00,201,1,0,1,eneheuvel,20-03-12
201124FT00202,2011,24FT00,202,2,3,5,eneheuvel,20-03-12
201124FT00203,2011,24FT00,203,2,5,7,eneheuvel,20-03-12
201124FT00204,2011,24FT00,204,1,2,3,eneheuvel,20-03-12
201124FT00205,2011,24FT00,205,0,2,2,eneheuvel,20-03-12
201124FT00206,2011,24FT00,206,0,2,2,eneheuvel,20-03-12
201124FT00207,2011,24FT00,207,2,4,6,eneheuvel,20-03-12
201124FT00208,2011,24FT00,208,0,5,5,eneheuvel,20-03-12
201124FT00210,2011,24FT00,210,3,5,8,eneheuvel,20-03-12
201124FT00211,2011,24FT00,211,8,16,24,eneheuvel,20-03-12
201124FT00212,2011,24FT00,212,4,14,18,eneheuvel,20-03-12
201124FT00213,2011,24FT00,213,3,9,12,eneheuvel,20-03-12
201124FT00214,2011,24FT00,214,4,12,16,eneheuvel,20-03-12
201124FT00216,2011,24FT00,216,0,5,5,eneheuvel,20-03-12
201124FT00301,2011,24FT00,301,1,1,2,eneheuvel,20-03-12
201124FT00302,2011,24FT00,302,2,16,18,eneheuvel,20-03-12
201124FT00303,2011,24FT00,303,3,15,18,eneheuvel,20-03-12
201124FT00304,2011,24FT00,304,2,5,7,eneheuvel,20-03-12
201124FT00305,2011,24FT00,305,2,5,7,eneheuvel,20-03-12
201124FT00306,2011,24FT00,306,0,6,6,eneheuvel,20-03-12
201124FT00307,2011,24FT00,307,1,9,10,eneheuvel,20-03-12
201124FT00308,2011,24FT00,308,1,7,8,eneheuvel,20-03-12
201124FT00309,2011,24FT00,309,1,14,15,eneheuvel,20-03-12
201124FT00311,2011,24FT00,311,5,15,20,eneheuvel,20-03-12
201124FT00312,2011,24FT00,312,3,18,21,eneheuvel,20-03-12
201124FT00313,2011,24FT00,313,0,2,2,eneheuvel,20-03-12
201124FT00401,2011,24FT00,401,0,2,2,eneheuvel,20-03-12
201124FT00402,2011,24FT00,402,0,2,2,eneheuvel,20-03-12
201124FT00403,2011,24FT00,403,0,2,2,eneheuvel,20-03-12
201124MR00201,2011,24MR00,201,1,1,2,eneheuvel,20-03-12
201124MR00207,2011,24MR00,207,0,1,1,eneheuvel,20-03-12
201124MR00208,2011,24MR00,208,2,0,2,eneheuvel,20-03-12
201124MR00216,2011,24MR00,216,1,1,2,eneheuvel,20-03-12
201124MR00301,2011,24MR00,301,0,1,1,eneheuvel,20-03-12
201124MR00302,2011,24MR00,302,2,0,2,eneheuvel,20-03-12
201124MR00304,2011,24MR00,304,0,2,2,eneheuvel,20-03-12
201124MR00305,2011,24MR00,305,1,1,2,eneheuvel,20-03-12
201124MR00306,2011,24MR00,306,15,15,30,eneheuvel,20-03-12
201124MR00307,2011,24MR00,307,96,127,223,eneheuvel,20-03-12
201124MR00308,2011,24MR00,308,13,5,18,eneheuvel,20-03-12
201124MR00309,2011,24MR00,309,2,0,2,eneheuvel,20-03-12
201124MR00311,2011,24MR00,311,1,1,2,eneheuvel,20-03-12
201124MR009999,2011,24MR00,9999,1,1,2,eneheuvel,20-03-12
201124RK00106,2011,24RK00,106,0,1,1,eneheuvel,20-03-12
201124RK00107,2011,24RK00,107,0,2,2,eneheuvel,20-03-12
201124RK00202,2011,24RK00,202,17,20,37,eneheuvel,20-03-12
201124RK00203,2011,24RK00,203,14,16,30,eneheuvel,20-03-12
201124RK00204,2011,24RK00,204,13,9,22,eneheuvel,20-03-12
201124RK00205,2011,24RK00,205,14,9,23,eneheuvel,20-03-12
201124RK00206,2011,24RK00,206,3,6,9,eneheuvel,20-03-12
201124RK00207,2011,24RK00,207,18,14,32,eneheuvel,20-03-12
201124RK00208,2011,24RK00,208,11,13,24,eneheuvel,20-03-12
201124RK00209,2011,24RK00,209,1,0,1,eneheuvel,20-03-12
201124RK00210,2011,24RK00,210,1,1,2,eneheuvel,20-03-12
201124RK00211,2011,24RK00,211,5,4,9,eneheuvel,20-03-12
201124RK00212,2011,24RK00,212,3,2,5,eneheuvel,20-03-12
201124RK00213,2011,24RK00,213,3,2,5,eneheuvel,20-03-12
201124RK00214,2011,24RK00,214,1,2,3,eneheuvel,20-03-12
201124RK00215,2011,24RK00,215,0,1,1,eneheuvel,20-03-12
201124RK00216,2011,24RK00,216,4,2,6,eneheuvel,20-03-12
201124RK00301,2011,24RK00,301,1,0,1,eneheuvel,20-03-12
201124RK00302,2011,24RK00,302,12,8,20,eneheuvel,20-03-12
201124RK00303,2011,24RK00,303,7,7,14,eneheuvel,20-03-12
201124RK00304,2011,24RK00,304,1,2,3,eneheuvel,20-03-12
201124RK00305,2011,24RK00,305,4,4,8,eneheuvel,20-03-12
201124RK00306,2011,24RK00,306,5,8,13,eneheuvel,20-03-12
201124RK00307,2011,24RK00,307,4,10,14,eneheuvel,20-03-12
201124RK00308,2011,24RK00,308,5,7,12,eneheuvel,20-03-12
201124RK00309,2011,24RK00,309,5,3,8,eneheuvel,20-03-12
201124RK00311,2011,24RK00,311,2,0,2,eneheuvel,20-03-12
201124RK00312,2011,24RK00,312,4,0,4,eneheuvel,20-03-12
201124RK00502,2011,24RK00,502,2,1,3,eneheuvel,20-03-12
201124RK009999,2011,24RK00,9999,0,1,1,eneheuvel,20-03-12
201124UN00201,2011,24UN00,201,0,1,1,eneheuvel,20-03-12
201124UN00202,2011,24UN00,202,1,0,1,eneheuvel,20-03-12
201124UN00301,2011,24UN00,301,1,0,1,eneheuvel,20-03-12
201124UN00303,2011,24UN00,303,2,1,3,eneheuvel,20-03-12
201124UN00305,2011,24UN00,305,0,1,1,eneheuvel,20-03-12
201124UN00306,2011,24UN00,306,13,25,38,eneheuvel,20-03-12
201124UN00307,2011,24UN00,307,29,45,74,eneheuvel,20-03-12
201124UN00308,2011,24UN00,308,51,44,95,eneheuvel,20-03-12
201124UN00309,2011,24UN00,309,6,11,17,eneheuvel,20-03-12
201124UN00310,2011,24UN00,310,1,0,1,eneheuvel,20-03-12
201124UN00313,2011,24UN00,313,0,1,1,eneheuvel,20-03-12
201124UN009999,2011,24UN00,9999,1,0,1,eneheuvel,20-03-12
201125CF00201,2011,25CF00,201,1,1,2,eneheuvel,20-03-12
201125CF00202,2011,25CF00,202,2,7,9,eneheuvel,20-03-12
201125CF00203,2011,25CF00,203,1,6,7,eneheuvel,20-03-12
201125CF00204,2011,25CF00,204,44,60,104,eneheuvel,20-03-12
201125CF00205,2011,25CF00,205,14,22,36,eneheuvel,20-03-12
201125CF00207,2011,25CF00,207,1,4,5,eneheuvel,20-03-12
201125CF00208,2011,25CF00,208,2,0,2,eneheuvel,20-03-12
201125CF00212,2011,25CF00,212,1,0,1,eneheuvel,20-03-12
201125CF00307,2011,25CF00,307,0,2,2,eneheuvel,20-03-12
201125KT00101,2011,25KT00,101,1,0,1,eneheuvel,20-03-12
201125KT00105,2011,25KT00,105,1,0,1,eneheuvel,20-03-12
201125KT00109,2011,25KT00,109,1,1,2,eneheuvel,20-03-12
201125KT00202,2011,25KT00,202,31,39,70,eneheuvel,20-03-12
201125KT00203,2011,25KT00,203,83,98,181,eneheuvel,20-03-12
201125KT00204,2011,25KT00,204,48,73,121,eneheuvel,20-03-12
201125KT00205,2011,25KT00,205,1,3,4,eneheuvel,20-03-12
201125KT00207,2011,25KT00,207,10,12,22,eneheuvel,20-03-12
201125KT00208,2011,25KT00,208,21,35,56,eneheuvel,20-03-12
201125KT00210,2011,25KT00,210,0,1,1,eneheuvel,20-03-12
201125KT00214,2011,25KT00,214,1,0,1,eneheuvel,20-03-12
201125KT00301,2011,25KT00,301,1,1,2,eneheuvel,20-03-12
201125KT00302,2011,25KT00,302,0,1,1,eneheuvel,20-03-12
201125KT00304,2011,25KT00,304,1,0,1,eneheuvel,20-03-12
201125KT00306,2011,25KT00,306,0,2,2,eneheuvel,20-03-12
201125KT00307,2011,25KT00,307,0,1,1,eneheuvel,20-03-12
201125KT00309,2011,25KT00,309,0,3,3,eneheuvel,20-03-12
201125KT00311,2011,25KT00,311,1,0,1,eneheuvel,20-03-12
201125KT00502,2011,25KT00,502,3,7,10,eneheuvel,20-03-12
201125KT009999,2011,25KT00,9999,1,0,1,eneheuvel,20-03-12
201125KU00110,2011,25KU00,110,0,1,1,eneheuvel,20-03-12
201125KU00201,2011,25KU00,201,0,1,1,eneheuvel,20-03-12
201125KU00202,2011,25KU00,202,23,26,49,eneheuvel,20-03-12
201125KU00203,2011,25KU00,203,76,62,138,eneheuvel,20-03-12
201125KU00204,2011,25KU00,204,46,71,117,eneheuvel,20-03-12
201125KU00205,2011,25KU00,205,2,3,5,eneheuvel,20-03-12
201125KU00207,2011,25KU00,207,6,8,14,eneheuvel,20-03-12
201125KU00208,2011,25KU00,208,23,20,43,eneheuvel,20-03-12
201125KU00211,2011,25KU00,211,1,1,2,eneheuvel,20-03-12
201125KU00212,2011,25KU00,212,0,1,1,eneheuvel,20-03-12
201125KU00215,2011,25KU00,215,0,1,1,eneheuvel,20-03-12
201125KU00216,2011,25KU00,216,0,2,2,eneheuvel,20-03-12
201125KU00312,2011,25KU00,312,1,0,1,eneheuvel,20-03-12
201125KU00313,2011,25KU00,313,0,1,1,eneheuvel,20-03-12
201125KU00402,2011,25KU00,402,0,1,1,eneheuvel,20-03-12
201125KU00403,2011,25KU00,403,0,1,1,eneheuvel,20-03-12
201125KU00502,2011,25KU00,502,1,4,5,eneheuvel,20-03-12
201125KU009999,2011,25KU00,9999,1,0,1,eneheuvel,20-03-12
201125KV00104,2011,25KV00,104,0,1,1,eneheuvel,20-03-12
201125KV00202,2011,25KV00,202,6,3,9,eneheuvel,20-03-12
201125KV00203,2011,25KV00,203,114,190,304,eneheuvel,20-03-12
201125KV00204,2011,25KV00,204,0,6,6,eneheuvel,20-03-12
201125KV00205,2011,25KV00,205,0,1,1,eneheuvel,20-03-12
201125KV00208,2011,25KV00,208,2,3,5,eneheuvel,20-03-12
201125KV00307,2011,25KV00,307,0,1,1,eneheuvel,20-03-12
201125KV00308,2011,25KV00,308,1,0,1,eneheuvel,20-03-12
201125KV00309,2011,25KV00,309,0,1,1,eneheuvel,20-03-12
201125KV00402,2011,25KV00,402,0,2,2,eneheuvel,20-03-12
201126AB00101,2011,26AB00,101,0,1,1,eneheuvel,20-03-12
201126AB00201,2011,26AB00,201,0,1,1,eneheuvel,20-03-12
201126AB00202,2011,26AB00,202,1,0,1,eneheuvel,20-03-12
201126AB00205,2011,26AB00,205,1,1,2,eneheuvel,20-03-12
201126AB00212,2011,26AB00,212,1,0,1,eneheuvel,20-03-12
201126AB00302,2011,26AB00,302,16,16,32,eneheuvel,20-03-12
201126AB00303,2011,26AB00,303,117,173,290,eneheuvel,20-03-12
201126AB00304,2011,26AB00,304,3,3,6,eneheuvel,20-03-12
201126AB00305,2011,26AB00,305,1,0,1,eneheuvel,20-03-12
201126AB00306,2011,26AB00,306,0,3,3,eneheuvel,20-03-12
201126AB00308,2011,26AB00,308,3,0,3,eneheuvel,20-03-12
201126AB00309,2011,26AB00,309,1,4,5,eneheuvel,20-03-12
201126AB00310,2011,26AB00,310,0,1,1,eneheuvel,20-03-12
201126AB00311,2011,26AB00,311,0,5,5,eneheuvel,20-03-12
201126AB00312,2011,26AB00,312,0,4,4,eneheuvel,20-03-12
201126AB00313,2011,26AB00,313,0,4,4,eneheuvel,20-03-12
201126AB009999,2011,26AB00,9999,0,1,1,eneheuvel,20-03-12
201126AC00102,2011,26AC00,102,0,1,1,eneheuvel,20-03-12
201126AC00107,2011,26AC00,107,0,3,3,eneheuvel,20-03-12
201126AC00108,2011,26AC00,108,1,0,1,eneheuvel,20-03-12
201126AC00109,2011,26AC00,109,21,12,33,eneheuvel,20-03-12
201126AC00201,2011,26AC00,201,1,0,1,eneheuvel,20-03-12
201126AC00202,2011,26AC00,202,2,2,4,eneheuvel,20-03-12
201126AC00203,2011,26AC00,203,2,3,5,eneheuvel,20-03-12
201126AC00204,2011,26AC00,204,2,2,4,eneheuvel,20-03-12
201126AC00205,2011,26AC00,205,1,0,1,eneheuvel,20-03-12
201126AC00207,2011,26AC00,207,0,1,1,eneheuvel,20-03-12
201126AC00209,2011,26AC00,209,2,0,2,eneheuvel,20-03-12
201126AC00210,2011,26AC00,210,1,2,3,eneheuvel,20-03-12
201126AC00211,2011,26AC00,211,11,11,22,eneheuvel,20-03-12
201126AC00212,2011,26AC00,212,6,9,15,eneheuvel,20-03-12
201126AC00213,2011,26AC00,213,10,16,26,eneheuvel,20-03-12
201126AC00214,2011,26AC00,214,349,410,759,eneheuvel,20-03-12
201126AC00215,2011,26AC00,215,1,1,2,eneheuvel,20-03-12
201126AC00301,2011,26AC00,301,0,1,1,eneheuvel,20-03-12
201126AC00302,2011,26AC00,302,1,1,2,eneheuvel,20-03-12
201126AC00303,2011,26AC00,303,1,0,1,eneheuvel,20-03-12
201126AC00307,2011,26AC00,307,0,1,1,eneheuvel,20-03-12
201126AC00308,2011,26AC00,308,1,0,1,eneheuvel,20-03-12
201126AC00311,2011,26AC00,311,0,1,1,eneheuvel,20-03-12
201126AC00312,2011,26AC00,312,1,1,2,eneheuvel,20-03-12
201126AC00402,2011,26AC00,402,0,1,1,eneheuvel,20-03-12
201126AC00403,2011,26AC00,403,3,4,7,eneheuvel,20-03-12
201126AC009999,2011,26AC00,9999,1,2,3,eneheuvel,20-03-12
201126AD00101,2011,26AD00,101,0,1,1,eneheuvel,20-03-12
201126AD00204,2011,26AD00,204,1,0,1,eneheuvel,20-03-12
201126AD00206,2011,26AD00,206,0,1,1,eneheuvel,20-03-12
201126AD00207,2011,26AD00,207,1,0,1,eneheuvel,20-03-12
201126AD00208,2011,26AD00,208,2,2,4,eneheuvel,20-03-12
201126AD00209,2011,26AD00,209,1,1,2,eneheuvel,20-03-12
201126AD00210,2011,26AD00,210,0,1,1,eneheuvel,20-03-12
201126AD00214,2011,26AD00,214,0,2,2,eneheuvel,20-03-12
201126AD00301,2011,26AD00,301,4,0,4,eneheuvel,20-03-12
201126AD00302,2011,26AD00,302,86,69,155,eneheuvel,20-03-12
201126AD00303,2011,26AD00,303,38,33,71,eneheuvel,20-03-12
201126AD00304,2011,26AD00,304,3,3,6,eneheuvel,20-03-12
201126AD00305,2011,26AD00,305,2,4,6,eneheuvel,20-03-12
201126AD00306,2011,26AD00,306,3,2,5,eneheuvel,20-03-12
201126AD00307,2011,26AD00,307,3,2,5,eneheuvel,20-03-12
201126AD00308,2011,26AD00,308,1,2,3,eneheuvel,20-03-12
201126AD00309,2011,26AD00,309,51,59,110,eneheuvel,20-03-12
201126AD00310,2011,26AD00,310,31,11,42,eneheuvel,20-03-12
201126AD00311,2011,26AD00,311,38,40,78,eneheuvel,20-03-12
201126AD00312,2011,26AD00,312,9,8,17,eneheuvel,20-03-12
201126AD00313,2011,26AD00,313,5,5,10,eneheuvel,20-03-12
201126AD00401,2011,26AD00,401,1,0,1,eneheuvel,20-03-12
201126AD00502,2011,26AD00,502,0,1,1,eneheuvel,20-03-12
201126AD009999,2011,26AD00,9999,1,1,2,eneheuvel,20-03-12
201126PD00104,2011,26PD00,104,0,1,1,eneheuvel,20-03-12
201126PD00108,2011,26PD00,108,1,1,2,eneheuvel,20-03-12
201126PD00202,2011,26PD00,202,1,0,1,eneheuvel,20-03-12
201126PD00203,2011,26PD00,203,0,2,2,eneheuvel,20-03-12
201126PD00205,2011,26PD00,205,4,4,8,eneheuvel,20-03-12
201126PD00206,2011,26PD00,206,1,0,1,eneheuvel,20-03-12
201126PD00207,2011,26PD00,207,101,127,228,eneheuvel,20-03-12
201126PD00208,2011,26PD00,208,14,21,35,eneheuvel,20-03-12
201126PD00303,2011,26PD00,303,1,0,1,eneheuvel,20-03-12
201126PD00304,2011,26PD00,304,0,1,1,eneheuvel,20-03-12
201126PD00307,2011,26PD00,307,1,0,1,eneheuvel,20-03-12
201126PD00309,2011,26PD00,309,1,0,1,eneheuvel,20-03-12
201126PD00502,2011,26PD00,502,0,2,2,eneheuvel,20-03-12
201126PD009999,2011,26PD00,9999,2,3,5,eneheuvel,20-03-12
201126PE00201,2011,26PE00,201,0,2,2,eneheuvel,20-03-12
201126PE00202,2011,26PE00,202,1,1,2,eneheuvel,20-03-12
201126PE00301,2011,26PE00,301,2,2,4,eneheuvel,20-03-12
201126PE00302,2011,26PE00,302,201,245,446,eneheuvel,20-03-12
201126PE00303,2011,26PE00,303,35,11,46,eneheuvel,20-03-12
201126PE00306,2011,26PE00,306,1,0,1,eneheuvel,20-03-12
201126PE00308,2011,26PE00,308,1,0,1,eneheuvel,20-03-12
201126PE00309,2011,26PE00,309,0,5,5,eneheuvel,20-03-12
201126PE00311,2011,26PE00,311,3,6,9,eneheuvel,20-03-12
201126PE00312,2011,26PE00,312,3,5,8,eneheuvel,20-03-12
201126PE00313,2011,26PE00,313,1,7,8,eneheuvel,20-03-12
201126PE009999,2011,26PE00,9999,2,1,3,eneheuvel,20-03-12
201126PF00103,2011,26PF00,103,0,1,1,eneheuvel,20-03-12
201126PF00106,2011,26PF00,106,1,0,1,eneheuvel,20-03-12
201126PF00107,2011,26PF00,107,1,0,1,eneheuvel,20-03-12
201126PF00201,2011,26PF00,201,7,2,9,eneheuvel,20-03-12
201126PF00202,2011,26PF00,202,2,0,2,eneheuvel,20-03-12
201126PF00203,2011,26PF00,203,3,0,3,eneheuvel,20-03-12
201126PF00204,2011,26PF00,204,0,2,2,eneheuvel,20-03-12
201126PF00206,2011,26PF00,206,2,3,5,eneheuvel,20-03-12
201126PF00207,2011,26PF00,207,2,1,3,eneheuvel,20-03-12
201126PF00208,2011,26PF00,208,2,0,2,eneheuvel,20-03-12
201126PF00209,2011,26PF00,209,2,1,3,eneheuvel,20-03-12
201126PF00210,2011,26PF00,210,0,1,1,eneheuvel,20-03-12
201126PF00211,2011,26PF00,211,7,10,17,eneheuvel,20-03-12
201126PF00212,2011,26PF00,212,15,13,28,eneheuvel,20-03-12
201126PF00213,2011,26PF00,213,7,6,13,eneheuvel,20-03-12
201126PF00214,2011,26PF00,214,162,188,350,eneheuvel,20-03-12
201126PF00216,2011,26PF00,216,3,3,6,eneheuvel,20-03-12
201126PF00302,2011,26PF00,302,2,2,4,eneheuvel,20-03-12
201126PF00303,2011,26PF00,303,1,0,1,eneheuvel,20-03-12
201126PF00305,2011,26PF00,305,1,0,1,eneheuvel,20-03-12
201126PF00307,2011,26PF00,307,1,0,1,eneheuvel,20-03-12
201126PF00308,2011,26PF00,308,0,1,1,eneheuvel,20-03-12
201126PF00309,2011,26PF00,309,0,2,2,eneheuvel,20-03-12
201126PF00311,2011,26PF00,311,0,1,1,eneheuvel,20-03-12
201126PF00401,2011,26PF00,401,2,1,3,eneheuvel,20-03-12
201126PF00402,2011,26PF00,402,1,0,1,eneheuvel,20-03-12
201126PF00403,2011,26PF00,403,1,3,4,eneheuvel,20-03-12
201126PF009999,2011,26PF00,9999,7,5,12,eneheuvel,20-03-12
201126PG00104,2011,26PG00,104,0,1,1,eneheuvel,20-03-12
201126PG00209,2011,26PG00,209,0,1,1,eneheuvel,20-03-12
201126PG00211,2011,26PG00,211,0,1,1,eneheuvel,20-03-12
201126PG00212,2011,26PG00,212,2,1,3,eneheuvel,20-03-12
201126PG00213,2011,26PG00,213,0,3,3,eneheuvel,20-03-12
201126PG00214,2011,26PG00,214,47,57,104,eneheuvel,20-03-12
201126PG00216,2011,26PG00,216,0,1,1,eneheuvel,20-03-12
201126PG00303,2011,26PG00,303,0,1,1,eneheuvel,20-03-12
201126PG009999,2011,26PG00,9999,1,1,2,eneheuvel,20-03-12
201126PH00102,2011,26PH00,102,1,0,1,eneheuvel,20-03-12
201126PH00201,2011,26PH00,201,2,0,2,eneheuvel,20-03-12
201126PH00202,2011,26PH00,202,1,0,1,eneheuvel,20-03-12
201126PH00208,2011,26PH00,208,1,1,2,eneheuvel,20-03-12
201126PH00210,2011,26PH00,210,1,0,1,eneheuvel,20-03-12
201126PH00216,2011,26PH00,216,1,0,1,eneheuvel,20-03-12
201126PH00302,2011,26PH00,302,21,36,57,eneheuvel,20-03-12
201126PH00303,2011,26PH00,303,3,8,11,eneheuvel,20-03-12
201126PH00304,2011,26PH00,304,2,3,5,eneheuvel,20-03-12
201126PH00305,2011,26PH00,305,1,2,3,eneheuvel,20-03-12
201126PH00306,2011,26PH00,306,2,2,4,eneheuvel,20-03-12
201126PH00307,2011,26PH00,307,1,4,5,eneheuvel,20-03-12
201126PH00308,2011,26PH00,308,5,3,8,eneheuvel,20-03-12
201126PH00309,2011,26PH00,309,38,35,73,eneheuvel,20-03-12
201126PH00310,2011,26PH00,310,5,2,7,eneheuvel,20-03-12
201126PH00311,2011,26PH00,311,224,211,435,eneheuvel,20-03-12
201126PH00312,2011,26PH00,312,15,21,36,eneheuvel,20-03-12
201126PH00313,2011,26PH00,313,3,4,7,eneheuvel,20-03-12
201126PH00403,2011,26PH00,403,1,0,1,eneheuvel,20-03-12
201126PH009999,2011,26PH00,9999,3,2,5,eneheuvel,20-03-12
201126PW00110,2011,26PW00,110,1,2,3,eneheuvel,20-03-12
201126PW00201,2011,26PW00,201,1,0,1,eneheuvel,20-03-12
201126PW00208,2011,26PW00,208,1,0,1,eneheuvel,20-03-12
201126PW00301,2011,26PW00,301,1,0,1,eneheuvel,20-03-12
201126PW00302,2011,26PW00,302,22,21,43,eneheuvel,20-03-12
201126PW00303,2011,26PW00,303,30,35,65,eneheuvel,20-03-12
201126PW00308,2011,26PW00,308,2,1,3,eneheuvel,20-03-12
201126PW00309,2011,26PW00,309,23,46,69,eneheuvel,20-03-12
201126PW00310,2011,26PW00,310,9,7,16,eneheuvel,20-03-12
201126PW00311,2011,26PW00,311,19,22,41,eneheuvel,20-03-12
201126PW00312,2011,26PW00,312,1,6,7,eneheuvel,20-03-12
201126PW00313,2011,26PW00,313,1,3,4,eneheuvel,20-03-12
201126PW009999,2011,26PW00,9999,1,0,1,eneheuvel,20-03-12
201126ZZ00201,2011,26ZZ00,201,4,0,4,eneheuvel,20-03-12
201126ZZ00202,2011,26ZZ00,202,163,222,385,eneheuvel,20-03-12
201126ZZ00203,2011,26ZZ00,203,12,8,20,eneheuvel,20-03-12
201126ZZ00204,2011,26ZZ00,204,2,1,3,eneheuvel,20-03-12
201126ZZ00205,2011,26ZZ00,205,0,1,1,eneheuvel,20-03-12
201126ZZ00208,2011,26ZZ00,208,5,2,7,eneheuvel,20-03-12
201126ZZ00209,2011,26ZZ00,209,1,0,1,eneheuvel,20-03-12
201126ZZ00210,2011,26ZZ00,210,1,1,2,eneheuvel,20-03-12
201126ZZ00211,2011,26ZZ00,211,0,1,1,eneheuvel,20-03-12
201126ZZ00216,2011,26ZZ00,216,1,1,2,eneheuvel,20-03-12
201126ZZ00302,2011,26ZZ00,302,1,1,2,eneheuvel,20-03-12
201126ZZ00305,2011,26ZZ00,305,1,0,1,eneheuvel,20-03-12
201126ZZ00307,2011,26ZZ00,307,0,1,1,eneheuvel,20-03-12
201126ZZ00309,2011,26ZZ00,309,1,2,3,eneheuvel,20-03-12
201126ZZ00313,2011,26ZZ00,313,1,1,2,eneheuvel,20-03-12
201126ZZ00502,2011,26ZZ00,502,1,5,6,eneheuvel,20-03-12
201126ZZ009999,2011,26ZZ00,9999,1,0,1,eneheuvel,20-03-12
201127AA00106,2011,27AA00,106,1,1,2,eneheuvel,20-03-12
201127AA00201,2011,27AA00,201,1,1,2,eneheuvel,20-03-12
201127AA00202,2011,27AA00,202,5,2,7,eneheuvel,20-03-12
201127AA00203,2011,27AA00,203,4,6,10,eneheuvel,20-03-12
201127AA00204,2011,27AA00,204,2,10,12,eneheuvel,20-03-12
201127AA00205,2011,27AA00,205,3,2,5,eneheuvel,20-03-12
201127AA00206,2011,27AA00,206,0,1,1,eneheuvel,20-03-12
201127AA00207,2011,27AA00,207,93,71,164,eneheuvel,20-03-12
201127AA00208,2011,27AA00,208,152,161,313,eneheuvel,20-03-12
201127AA00210,2011,27AA00,210,0,1,1,eneheuvel,20-03-12
201127AA00211,2011,27AA00,211,3,1,4,eneheuvel,20-03-12
201127AA00214,2011,27AA00,214,0,1,1,eneheuvel,20-03-12
201127AA00303,2011,27AA00,303,0,2,2,eneheuvel,20-03-12
201127AA00306,2011,27AA00,306,2,0,2,eneheuvel,20-03-12
201127AA00307,2011,27AA00,307,1,2,3,eneheuvel,20-03-12
201127AA00308,2011,27AA00,308,0,2,2,eneheuvel,20-03-12
201127AA00312,2011,27AA00,312,0,1,1,eneheuvel,20-03-12
201127AA00502,2011,27AA00,502,1,1,2,eneheuvel,20-03-12
201127AA009999,2011,27AA00,9999,0,1,1,eneheuvel,20-03-12
201127NU00104,2011,27NU00,104,2,0,2,eneheuvel,20-03-12
201127NU00108,2011,27NU00,108,0,1,1,eneheuvel,20-03-12
201127NU00201,2011,27NU00,201,0,1,1,eneheuvel,20-03-12
201127NU00202,2011,27NU00,202,3,0,3,eneheuvel,20-03-12
201127NU00203,2011,27NU00,203,9,8,17,eneheuvel,20-03-12
201127NU00204,2011,27NU00,204,9,4,13,eneheuvel,20-03-12
201127NU00205,2011,27NU00,205,1,2,3,eneheuvel,20-03-12
201127NU00206,2011,27NU00,206,0,1,1,eneheuvel,20-03-12
201127NU00207,2011,27NU00,207,47,27,74,eneheuvel,20-03-12
201127NU00208,2011,27NU00,208,179,166,345,eneheuvel,20-03-12
201127NU00211,2011,27NU00,211,0,1,1,eneheuvel,20-03-12
201127NU00213,2011,27NU00,213,2,0,2,eneheuvel,20-03-12
201127NU00301,2011,27NU00,301,1,1,2,eneheuvel,20-03-12
201127NU00305,2011,27NU00,305,1,0,1,eneheuvel,20-03-12
201127NU00306,2011,27NU00,306,1,0,1,eneheuvel,20-03-12
201127NU00307,2011,27NU00,307,2,0,2,eneheuvel,20-03-12
201127NU00308,2011,27NU00,308,1,1,2,eneheuvel,20-03-12
201127NU00309,2011,27NU00,309,1,0,1,eneheuvel,20-03-12
201127NU00310,2011,27NU00,310,2,0,2,eneheuvel,20-03-12
201127NU00502,2011,27NU00,502,2,1,3,eneheuvel,20-03-12
201127NU009999,2011,27NU00,9999,2,1,3,eneheuvel,20-03-12
201127UB00103,2011,27UB00,103,0,2,2,eneheuvel,20-03-12
201127UB00104,2011,27UB00,104,1,0,1,eneheuvel,20-03-12
201127UB00201,2011,27UB00,201,3,0,3,eneheuvel,20-03-12
201127UB00202,2011,27UB00,202,1,2,3,eneheuvel,20-03-12
201127UB00203,2011,27UB00,203,8,5,13,eneheuvel,20-03-12
201127UB00204,2011,27UB00,204,2,1,3,eneheuvel,20-03-12
201127UB00205,2011,27UB00,205,0,1,1,eneheuvel,20-03-12
201127UB00206,2011,27UB00,206,0,1,1,eneheuvel,20-03-12
201127UB00207,2011,27UB00,207,9,11,20,eneheuvel,20-03-12
201127UB00208,2011,27UB00,208,191,141,332,eneheuvel,20-03-12
201127UB00209,2011,27UB00,209,2,0,2,eneheuvel,20-03-12
201127UB00213,2011,27UB00,213,1,0,1,eneheuvel,20-03-12
201127UB00216,2011,27UB00,216,0,1,1,eneheuvel,20-03-12
201127UB00302,2011,27UB00,302,0,1,1,eneheuvel,20-03-12
201127UB00304,2011,27UB00,304,1,0,1,eneheuvel,20-03-12
201127UB00305,2011,27UB00,305,2,1,3,eneheuvel,20-03-12
201127UB00306,2011,27UB00,306,1,2,3,eneheuvel,20-03-12
201127UB00307,2011,27UB00,307,1,1,2,eneheuvel,20-03-12
201127UB00308,2011,27UB00,308,1,1,2,eneheuvel,20-03-12
201127UB00309,2011,27UB00,309,1,0,1,eneheuvel,20-03-12
201127UB00311,2011,27UB00,311,0,1,1,eneheuvel,20-03-12
201127UB00312,2011,27UB00,312,0,1,1,eneheuvel,20-03-12
201127UB00401,2011,27UB00,401,1,0,1,eneheuvel,20-03-12
201127UB00502,2011,27UB00,502,3,1,4,eneheuvel,20-03-12
201127UB009999,2011,27UB00,9999,2,1,3,eneheuvel,20-03-12
201127XH00107,2011,27XH00,107,1,0,1,eneheuvel,20-03-12
201127XH00202,2011,27XH00,202,0,1,1,eneheuvel,20-03-12
201127XH00203,2011,27XH00,203,1,0,1,eneheuvel,20-03-12
201127XH00204,2011,27XH00,204,1,0,1,eneheuvel,20-03-12
201127XH00207,2011,27XH00,207,1,0,1,eneheuvel,20-03-12
201127XH00208,2011,27XH00,208,1,0,1,eneheuvel,20-03-12
201127XH00209,2011,27XH00,209,3,2,5,eneheuvel,20-03-12
201127XH00210,2011,27XH00,210,6,4,10,eneheuvel,20-03-12
201127XH00212,2011,27XH00,212,1,2,3,eneheuvel,20-03-12
201127XH00214,2011,27XH00,214,2,1,3,eneheuvel,20-03-12
201127XH00215,2011,27XH00,215,11,24,35,eneheuvel,20-03-12
201127XH00216,2011,27XH00,216,137,92,229,eneheuvel,20-03-12
201127XH00312,2011,27XH00,312,1,0,1,eneheuvel,20-03-12
201127XH00403,2011,27XH00,403,0,1,1,eneheuvel,20-03-12
201127XJ00106,2011,27XJ00,106,0,2,2,eneheuvel,20-03-12
201127XJ00213,2011,27XJ00,213,0,1,1,eneheuvel,20-03-12
201127XJ00302,2011,27XJ00,302,22,9,31,eneheuvel,20-03-12
201127XJ00303,2011,27XJ00,303,7,4,11,eneheuvel,20-03-12
201127XJ00306,2011,27XJ00,306,3,1,4,eneheuvel,20-03-12
201127XJ00307,2011,27XJ00,307,1,1,2,eneheuvel,20-03-12
201127XJ00308,2011,27XJ00,308,2,1,3,eneheuvel,20-03-12
201127XJ00309,2011,27XJ00,309,12,3,15,eneheuvel,20-03-12
201127XJ00311,2011,27XJ00,311,33,15,48,eneheuvel,20-03-12
201127XJ00312,2011,27XJ00,312,197,116,313,eneheuvel,20-03-12
201127XJ00313,2011,27XJ00,313,46,29,75,eneheuvel,20-03-12
201127XJ009999,2011,27XJ00,9999,2,0,2,eneheuvel,20-03-12
201127YN00109,2011,27YN00,109,1,1,2,eneheuvel,20-03-12
201127YN00110,2011,27YN00,110,0,4,4,eneheuvel,20-03-12
201127YN00201,2011,27YN00,201,2,1,3,eneheuvel,20-03-12
201127YN00202,2011,27YN00,202,1,0,1,eneheuvel,20-03-12
201127YN00203,2011,27YN00,203,0,1,1,eneheuvel,20-03-12
201127YN00206,2011,27YN00,206,2,2,4,eneheuvel,20-03-12
201127YN00207,2011,27YN00,207,2,2,4,eneheuvel,20-03-12
201127YN00208,2011,27YN00,208,1,3,4,eneheuvel,20-03-12
201127YN00210,2011,27YN00,210,19,16,35,eneheuvel,20-03-12
201127YN00211,2011,27YN00,211,2,1,3,eneheuvel,20-03-12
201127YN00212,2011,27YN00,212,7,6,13,eneheuvel,20-03-12
201127YN00214,2011,27YN00,214,3,1,4,eneheuvel,20-03-12
201127YN00215,2011,27YN00,215,10,7,17,eneheuvel,20-03-12
201127YN00216,2011,27YN00,216,190,128,318,eneheuvel,20-03-12
201127YN00302,2011,27YN00,302,0,2,2,eneheuvel,20-03-12
201127YN00303,2011,27YN00,303,0,2,2,eneheuvel,20-03-12
201127YN00305,2011,27YN00,305,1,0,1,eneheuvel,20-03-12
201127YN00306,2011,27YN00,306,2,2,4,eneheuvel,20-03-12
201127YN00308,2011,27YN00,308,1,2,3,eneheuvel,20-03-12
201127YN00309,2011,27YN00,309,4,1,5,eneheuvel,20-03-12
201127YN00310,2011,27YN00,310,1,0,1,eneheuvel,20-03-12
201127YN00311,2011,27YN00,311,2,2,4,eneheuvel,20-03-12
201127YN00312,2011,27YN00,312,3,1,4,eneheuvel,20-03-12
201127YN00403,2011,27YN00,403,0,2,2,eneheuvel,20-03-12
201127YN00502,2011,27YN00,502,2,1,3,eneheuvel,20-03-12
201127YN009999,2011,27YN00,9999,1,0,1,eneheuvel,20-03-12
201127YN01101,2011,27YN01,101,1,4,5,eneheuvel,20-03-12
201127YN01102,2011,27YN01,102,1,1,2,eneheuvel,20-03-12
201127YN01103,2011,27YN01,103,1,1,2,eneheuvel,20-03-12
201127YN01104,2011,27YN01,104,4,2,6,eneheuvel,20-03-12
201127YN01106,2011,27YN01,106,3,4,7,eneheuvel,20-03-12
201127YN01107,2011,27YN01,107,1,0,1,eneheuvel,20-03-12
201127YN01108,2011,27YN01,108,1,1,2,eneheuvel,20-03-12
201127YN01201,2011,27YN01,201,3,4,7,eneheuvel,20-03-12
201127YN01202,2011,27YN01,202,6,2,8,eneheuvel,20-03-12
201127YN01204,2011,27YN01,204,1,0,1,eneheuvel,20-03-12
201127YN01206,2011,27YN01,206,0,1,1,eneheuvel,20-03-12
201127YN01207,2011,27YN01,207,32,18,50,eneheuvel,20-03-12
201127YN01208,2011,27YN01,208,0,3,3,eneheuvel,20-03-12
201127YN01209,2011,27YN01,209,3,0,3,eneheuvel,20-03-12
201127YN01210,2011,27YN01,210,3,3,6,eneheuvel,20-03-12
201127YN01211,2011,27YN01,211,4,9,13,eneheuvel,20-03-12
201127YN01212,2011,27YN01,212,2,5,7,eneheuvel,20-03-12
201127YN01213,2011,27YN01,213,1,2,3,eneheuvel,20-03-12
201127YN01214,2011,27YN01,214,1,5,6,eneheuvel,20-03-12
201127YN01301,2011,27YN01,301,2,1,3,eneheuvel,20-03-12
201127YN01303,2011,27YN01,303,1,3,4,eneheuvel,20-03-12
201127YN01304,2011,27YN01,304,0,2,2,eneheuvel,20-03-12
201127YN01305,2011,27YN01,305,2,1,3,eneheuvel,20-03-12
201127YN01306,2011,27YN01,306,0,1,1,eneheuvel,20-03-12
201127YN01307,2011,27YN01,307,1,1,2,eneheuvel,20-03-12
201127YN01309,2011,27YN01,309,2,6,8,eneheuvel,20-03-12
201127YN01311,2011,27YN01,311,0,3,3,eneheuvel,20-03-12
201127YN01312,2011,27YN01,312,1,0,1,eneheuvel,20-03-12
201127YN01401,2011,27YN01,401,1,0,1,eneheuvel,20-03-12
201127YN01403,2011,27YN01,403,2,1,3,eneheuvel,20-03-12
201127YN019999,2011,27YN01,9999,0,2,2,eneheuvel,20-03-12
201128AM00102,2011,28AM00,102,1,1,2,eneheuvel,20-03-12
201128AM00206,2011,28AM00,206,2,0,2,eneheuvel,20-03-12
201128AM00302,2011,28AM00,302,10,3,13,eneheuvel,20-03-12
201128AM00303,2011,28AM00,303,1,0,1,eneheuvel,20-03-12
201128AM00304,2011,28AM00,304,2,0,2,eneheuvel,20-03-12
201128AM00305,2011,28AM00,305,2,0,2,eneheuvel,20-03-12
201128AM00307,2011,28AM00,307,1,0,1,eneheuvel,20-03-12
201128AM00308,2011,28AM00,308,0,1,1,eneheuvel,20-03-12
201128AM00309,2011,28AM00,309,2,3,5,eneheuvel,20-03-12
201128AM00310,2011,28AM00,310,1,0,1,eneheuvel,20-03-12
201128AM00311,2011,28AM00,311,28,15,43,eneheuvel,20-03-12
201128AM00312,2011,28AM00,312,184,163,347,eneheuvel,20-03-12
201128AM00313,2011,28AM00,313,7,9,16,eneheuvel,20-03-12
201129UB00108,2011,29UB00,108,1,0,1,eneheuvel,20-03-12
201129UB00109,2011,29UB00,109,2,0,2,eneheuvel,20-03-12
201129UB00201,2011,29UB00,201,2,2,4,eneheuvel,20-03-12
201129UB00202,2011,29UB00,202,3,0,3,eneheuvel,20-03-12
201129UB00204,2011,29UB00,204,1,0,1,eneheuvel,20-03-12
201129UB00206,2011,29UB00,206,1,0,1,eneheuvel,20-03-12
201129UB00208,2011,29UB00,208,3,2,5,eneheuvel,20-03-12
201129UB00210,2011,29UB00,210,2,2,4,eneheuvel,20-03-12
201129UB00211,2011,29UB00,211,2,1,3,eneheuvel,20-03-12
201129UB00212,2011,29UB00,212,2,10,12,eneheuvel,20-03-12
201129UB00213,2011,29UB00,213,1,1,2,eneheuvel,20-03-12
201129UB00214,2011,29UB00,214,26,31,57,eneheuvel,20-03-12
201129UB00305,2011,29UB00,305,0,1,1,eneheuvel,20-03-12
201129UB00307,2011,29UB00,307,0,1,1,eneheuvel,20-03-12
201129UB00312,2011,29UB00,312,1,0,1,eneheuvel,20-03-12
201129UB00401,2011,29UB00,401,12,12,24,eneheuvel,20-03-12
201129UB00402,2011,29UB00,402,77,44,121,eneheuvel,20-03-12
201129UB00403,2011,29UB00,403,53,39,92,eneheuvel,20-03-12
201129UN00203,2011,29UN00,203,1,0,1,eneheuvel,20-03-12
201129UN00207,2011,29UN00,207,1,0,1,eneheuvel,20-03-12
201129UN00209,2011,29UN00,209,1,0,1,eneheuvel,20-03-12
201129UN00301,2011,29UN00,301,2,0,2,eneheuvel,20-03-12
201129UN00302,2011,29UN00,302,1,2,3,eneheuvel,20-03-12
201129UN00305,2011,29UN00,305,2,5,7,eneheuvel,20-03-12
201129UN00306,2011,29UN00,306,0,2,2,eneheuvel,20-03-12
201129UN00307,2011,29UN00,307,0,1,1,eneheuvel,20-03-12
201129UN00309,2011,29UN00,309,0,2,2,eneheuvel,20-03-12
201129XC00103,2011,29XC00,103,0,1,1,eneheuvel,20-03-12
201129XC00107,2011,29XC00,107,3,5,8,eneheuvel,20-03-12
201129XC00202,2011,29XC00,202,0,1,1,eneheuvel,20-03-12
201129XC00203,2011,29XC00,203,0,1,1,eneheuvel,20-03-12
201129XC00204,2011,29XC00,204,0,2,2,eneheuvel,20-03-12
201129XC00207,2011,29XC00,207,0,1,1,eneheuvel,20-03-12
201129XC00208,2011,29XC00,208,1,1,2,eneheuvel,20-03-12
201129XC00212,2011,29XC00,212,1,1,2,eneheuvel,20-03-12
201129XC00214,2011,29XC00,214,2,5,7,eneheuvel,20-03-12
201129XC00216,2011,29XC00,216,2,0,2,eneheuvel,20-03-12
201129XC00307,2011,29XC00,307,0,2,2,eneheuvel,20-03-12
201129XC00401,2011,29XC00,401,5,2,7,eneheuvel,20-03-12
201129XC00402,2011,29XC00,402,3,1,4,eneheuvel,20-03-12
201129XC00403,2011,29XC00,403,4,2,6,eneheuvel,20-03-12
201129XT00103,2011,29XT00,103,0,1,1,eneheuvel,20-03-12
201129XT00108,2011,29XT00,108,0,2,2,eneheuvel,20-03-12
201129XT00203,2011,29XT00,203,1,1,2,eneheuvel,20-03-12
201129XT00210,2011,29XT00,210,2,0,2,eneheuvel,20-03-12
201129XT00212,2011,29XT00,212,1,1,2,eneheuvel,20-03-12
201129XT00214,2011,29XT00,214,12,5,17,eneheuvel,20-03-12
201129XT00303,2011,29XT00,303,1,1,2,eneheuvel,20-03-12
201129XT00304,2011,29XT00,304,1,2,3,eneheuvel,20-03-12
201129XT00305,2011,29XT00,305,0,2,2,eneheuvel,20-03-12
201129XT00307,2011,29XT00,307,0,1,1,eneheuvel,20-03-12
201129XT00313,2011,29XT00,313,2,0,2,eneheuvel,20-03-12
201129XT00401,2011,29XT00,401,23,14,37,eneheuvel,20-03-12
201129XT00402,2011,29XT00,402,6,9,15,eneheuvel,20-03-12
201129XT00403,2011,29XT00,403,17,9,26,eneheuvel,20-03-12
201129XT00502,2011,29XT00,502,1,0,1,eneheuvel,20-03-12
201129XT009999,2011,29XT00,9999,2,1,3,eneheuvel,20-03-12
201129XU00202,2011,29XU00,202,0,1,1,eneheuvel,20-03-12
201129XU00204,2011,29XU00,204,1,0,1,eneheuvel,20-03-12
201129XU00208,2011,29XU00,208,0,1,1,eneheuvel,20-03-12
201129XU00210,2011,29XU00,210,1,2,3,eneheuvel,20-03-12
201129XU00211,2011,29XU00,211,0,1,1,eneheuvel,20-03-12
201129XU00212,2011,29XU00,212,0,3,3,eneheuvel,20-03-12
201129XU00213,2011,29XU00,213,1,0,1,eneheuvel,20-03-12
201129XU00214,2011,29XU00,214,1,0,1,eneheuvel,20-03-12
201129XU00216,2011,29XU00,216,2,1,3,eneheuvel,20-03-12
201129XU00302,2011,29XU00,302,0,1,1,eneheuvel,20-03-12
201129XU00303,2011,29XU00,303,1,1,2,eneheuvel,20-03-12
201129XU00306,2011,29XU00,306,1,1,2,eneheuvel,20-03-12
201129XU00401,2011,29XU00,401,26,14,40,eneheuvel,20-03-12
201129XU00402,2011,29XU00,402,1,5,6,eneheuvel,20-03-12
201129XU00403,2011,29XU00,403,8,13,21,eneheuvel,20-03-12
201129XU00405,2011,29XU00,405,1,0,1,eneheuvel,20-03-12
201129XU009999,2011,29XU00,9999,0,2,2,eneheuvel,20-03-12
201129XX00102,2011,29XX00,102,0,1,1,eneheuvel,20-03-12
201129XX00109,2011,29XX00,109,3,0,3,eneheuvel,20-03-12
201129XX00202,2011,29XX00,202,1,3,4,eneheuvel,20-03-12
201129XX00203,2011,29XX00,203,0,3,3,eneheuvel,20-03-12
201129XX00204,2011,29XX00,204,2,0,2,eneheuvel,20-03-12
201129XX00205,2011,29XX00,205,0,3,3,eneheuvel,20-03-12
201129XX00207,2011,29XX00,207,2,4,6,eneheuvel,20-03-12
201129XX00208,2011,29XX00,208,4,10,14,eneheuvel,20-03-12
201129XX00209,2011,29XX00,209,2,4,6,eneheuvel,20-03-12
201129XX00210,2011,29XX00,210,1,3,4,eneheuvel,20-03-12
201129XX00211,2011,29XX00,211,2,1,3,eneheuvel,20-03-12
201129XX00212,2011,29XX00,212,4,6,10,eneheuvel,20-03-12
201129XX00213,2011,29XX00,213,0,1,1,eneheuvel,20-03-12
201129XX00214,2011,29XX00,214,6,10,16,eneheuvel,20-03-12
201129XX00216,2011,29XX00,216,2,2,4,eneheuvel,20-03-12
201129XX00302,2011,29XX00,302,5,5,10,eneheuvel,20-03-12
201129XX00303,2011,29XX00,303,1,3,4,eneheuvel,20-03-12
201129XX00306,2011,29XX00,306,1,1,2,eneheuvel,20-03-12
201129XX00307,2011,29XX00,307,0,1,1,eneheuvel,20-03-12
201129XX00309,2011,29XX00,309,2,1,3,eneheuvel,20-03-12
201129XX00311,2011,29XX00,311,3,3,6,eneheuvel,20-03-12
201129XX00312,2011,29XX00,312,2,3,5,eneheuvel,20-03-12
201129XX00313,2011,29XX00,313,1,1,2,eneheuvel,20-03-12
201129XX00401,2011,29XX00,401,1,1,2,eneheuvel,20-03-12
201129XX00502,2011,29XX00,502,0,1,1,eneheuvel,20-03-12
201129XX009999,2011,29XX00,9999,0,1,1,eneheuvel,20-03-12
201130AJ00106,2011,30AJ00,106,0,1,1,eneheuvel,20-03-12
201130AJ00109,2011,30AJ00,109,0,1,1,eneheuvel,20-03-12
201130AJ00201,2011,30AJ00,201,2,0,2,eneheuvel,20-03-12
201130AJ00202,2011,30AJ00,202,3,2,5,eneheuvel,20-03-12
201130AJ00206,2011,30AJ00,206,1,2,3,eneheuvel,20-03-12
201130AJ00207,2011,30AJ00,207,1,6,7,eneheuvel,20-03-12
201130AJ00208,2011,30AJ00,208,9,7,16,eneheuvel,20-03-12
201130AJ00211,2011,30AJ00,211,2,1,3,eneheuvel,20-03-12
201130AJ00212,2011,30AJ00,212,2,4,6,eneheuvel,20-03-12
201130AJ00213,2011,30AJ00,213,3,2,5,eneheuvel,20-03-12
201130AJ00214,2011,30AJ00,214,4,12,16,eneheuvel,20-03-12
201130AJ00215,2011,30AJ00,215,0,2,2,eneheuvel,20-03-12
201130AJ00216,2011,30AJ00,216,1,4,5,eneheuvel,20-03-12
201130AJ00303,2011,30AJ00,303,3,0,3,eneheuvel,20-03-12
201130AJ00304,2011,30AJ00,304,0,1,1,eneheuvel,20-03-12
201130AJ00308,2011,30AJ00,308,1,0,1,eneheuvel,20-03-12
201130AJ00309,2011,30AJ00,309,1,0,1,eneheuvel,20-03-12
201130AJ00311,2011,30AJ00,311,0,1,1,eneheuvel,20-03-12
201130AJ00312,2011,30AJ00,312,2,3,5,eneheuvel,20-03-12
201130AJ00401,2011,30AJ00,401,5,3,8,eneheuvel,20-03-12
201130AJ00402,2011,30AJ00,402,43,36,79,eneheuvel,20-03-12
201130AJ00403,2011,30AJ00,403,45,27,72,eneheuvel,20-03-12
201130AJ00502,2011,30AJ00,502,1,0,1,eneheuvel,20-03-12
201130AJ009999,2011,30AJ00,9999,1,1,2,eneheuvel,20-03-12
