LLPerWijk_Jaar,LLPerWijk_Brin,LLPerWijk_WijkNr,LLPerWijk_Onderbouw,LLPerWijk_Bovenbouw,LLPerWijk_Totaal,LLPerWijk_InvoerWie,LLPerWijk_InvoerWanneer
2005,15SJ00,209,4,0,4,eneheuvel,26-09-11
2005,15SJ00,210,6,0,6,eneheuvel,26-09-11
2005,15SJ00,211,4,0,4,eneheuvel,26-09-11
2005,15SJ00,212,4,0,4,eneheuvel,26-09-11
2005,15SJ00,214,1,0,1,eneheuvel,26-09-11
2005,15SJ00,302,2,0,2,eneheuvel,26-09-11
2005,15SJ00,303,2,0,2,eneheuvel,26-09-11
2005,15SJ00,304,1,0,1,eneheuvel,26-09-11
2005,15SJ00,305,2,0,2,eneheuvel,26-09-11
2005,15SJ00,307,1,0,1,eneheuvel,26-09-11
2005,15ZL00,105,0,1,1,eneheuvel,26-09-11
2005,15ZL00,202,0,2,2,eneheuvel,26-09-11
2005,15ZL00,205,1,0,1,eneheuvel,26-09-11
2005,15ZL00,206,2,3,5,eneheuvel,26-09-11
2005,15ZL00,207,1,5,6,eneheuvel,26-09-11
2005,15ZL00,208,1,3,4,eneheuvel,26-09-11
2005,15ZL00,210,0,1,1,eneheuvel,26-09-11
2005,15ZL00,211,2,0,2,eneheuvel,26-09-11
2005,15ZL00,215,0,1,1,eneheuvel,26-09-11
2005,15ZL00,302,1,5,6,eneheuvel,26-09-11
2005,15ZL00,303,4,7,11,eneheuvel,26-09-11
2005,15ZL00,304,2,4,6,eneheuvel,26-09-11
2005,15ZL00,305,47,46,93,eneheuvel,26-09-11
2005,15ZL00,306,10,19,29,eneheuvel,26-09-11
2005,15ZL00,307,1,4,5,eneheuvel,26-09-11
2005,15ZL00,308,4,0,4,eneheuvel,26-09-11
2005,15ZL00,309,7,8,15,eneheuvel,26-09-11
2005,15ZL00,311,2,0,2,eneheuvel,26-09-11
2005,15ZL00,312,1,1,2,eneheuvel,26-09-11
2005,15ZL00,9999,0,2,2,eneheuvel,26-09-11
2005,15ZL01,106,1,0,1,eneheuvel,26-09-11
2005,15ZL01,202,2,1,3,eneheuvel,26-09-11
2005,15ZL01,206,1,2,3,eneheuvel,26-09-11
2005,15ZL01,207,1,0,1,eneheuvel,26-09-11
2005,15ZL01,209,7,5,12,eneheuvel,26-09-11
2005,15ZL01,210,78,61,139,eneheuvel,26-09-11
2005,15ZL01,212,0,4,4,eneheuvel,26-09-11
2005,15ZL01,213,1,0,1,eneheuvel,26-09-11
2005,15ZL01,214,1,1,2,eneheuvel,26-09-11
2005,15ZL01,215,3,8,11,eneheuvel,26-09-11
2005,15ZL01,305,0,1,1,eneheuvel,26-09-11
2005,15ZL01,9999,1,2,3,eneheuvel,26-09-11
2005,16CK00,106,1,0,1,eneheuvel,26-09-11
2005,16CK00,202,3,0,3,eneheuvel,26-09-11
2005,16CK00,203,1,0,1,eneheuvel,26-09-11
2005,16CK00,204,1,0,1,eneheuvel,26-09-11
2005,16CK00,205,2,0,2,eneheuvel,26-09-11
2005,16CK00,208,1,0,1,eneheuvel,26-09-11
2005,16CK00,209,2,0,2,eneheuvel,26-09-11
2005,16CK00,210,1,0,1,eneheuvel,26-09-11
2005,16CK00,211,1,0,1,eneheuvel,26-09-11
2005,16CK00,302,2,0,2,eneheuvel,26-09-11
2005,16CK00,304,4,0,4,eneheuvel,26-09-11
2005,16CK00,305,2,0,2,eneheuvel,26-09-11
2005,16CK00,306,2,0,2,eneheuvel,26-09-11
2005,16CK00,308,1,0,1,eneheuvel,26-09-11
2005,16CK00,309,2,0,2,eneheuvel,26-09-11
2005,16CK00,311,3,0,3,eneheuvel,26-09-11
2005,16CK00,9999,2,0,2,eneheuvel,26-09-11
2005,06RM00,102,4,0,4,eneheuvel,26-09-11
2005,06RM00,103,2,1,3,eneheuvel,26-09-11
2005,06RM00,105,2,3,5,eneheuvel,26-09-11
2005,06RM00,106,1,1,2,eneheuvel,26-09-11
2005,06RM00,108,4,1,5,eneheuvel,26-09-11
2005,06RM00,109,0,2,2,eneheuvel,26-09-11
2005,06RM00,202,6,11,17,eneheuvel,26-09-11
2005,06RM00,206,4,5,9,eneheuvel,26-09-11
2005,06RM00,207,3,1,4,eneheuvel,26-09-11
2005,06RM00,208,2,4,6,eneheuvel,26-09-11
2005,06RM00,210,5,3,8,eneheuvel,26-09-11
2005,06RM00,211,5,7,12,eneheuvel,26-09-11
2005,06RM00,212,37,21,58,eneheuvel,26-09-11
2005,06RM00,213,10,7,17,eneheuvel,26-09-11
2005,06RM00,214,17,10,27,eneheuvel,26-09-11
2005,06RM00,215,4,2,6,eneheuvel,26-09-11
2005,06RM00,216,1,0,1,eneheuvel,26-09-11
2005,06RM00,302,4,5,9,eneheuvel,26-09-11
2005,06RM00,303,5,4,9,eneheuvel,26-09-11
2005,06RM00,304,1,1,2,eneheuvel,26-09-11
2005,06RM00,306,1,1,2,eneheuvel,26-09-11
2005,06RM00,307,1,0,1,eneheuvel,26-09-11
2005,06RM00,309,4,3,7,eneheuvel,26-09-11
2005,06RM00,311,2,2,4,eneheuvel,26-09-11
2005,06RM00,312,1,1,2,eneheuvel,26-09-11
2005,06RM00,502,4,3,7,eneheuvel,26-09-11
2005,06RM00,9999,9,7,16,eneheuvel,26-09-11
2005,12HU00,103,1,0,1,eneheuvel,26-09-11
2005,12HU00,104,0,1,1,eneheuvel,26-09-11
2005,12HU00,106,0,1,1,eneheuvel,26-09-11
2005,12HU00,201,4,10,14,eneheuvel,26-09-11
2005,12HU00,202,1,2,3,eneheuvel,26-09-11
2005,12HU00,203,1,0,1,eneheuvel,26-09-11
2005,12HU00,204,1,2,3,eneheuvel,26-09-11
2005,12HU00,205,1,0,1,eneheuvel,26-09-11
2005,12HU00,206,1,3,4,eneheuvel,26-09-11
2005,12HU00,209,1,3,4,eneheuvel,26-09-11
2005,12HU00,210,3,2,5,eneheuvel,26-09-11
2005,12HU00,211,56,46,102,eneheuvel,26-09-11
2005,12HU00,212,1,1,2,eneheuvel,26-09-11
2005,12HU00,213,1,2,3,eneheuvel,26-09-11
2005,12HU00,214,1,0,1,eneheuvel,26-09-11
2005,12HU00,312,0,1,1,eneheuvel,26-09-11
2005,12HU00,9999,0,3,3,eneheuvel,26-09-11
2005,12PM00,101,6,6,12,eneheuvel,26-09-11
2005,12PM00,102,4,6,10,eneheuvel,26-09-11
2005,12PM00,103,43,23,66,eneheuvel,26-09-11
2005,12PM00,104,1,1,2,eneheuvel,26-09-11
2005,12PM00,106,3,3,6,eneheuvel,26-09-11
2005,12PM00,107,18,14,32,eneheuvel,26-09-11
2005,12PM00,108,18,8,26,eneheuvel,26-09-11
2005,12PM00,109,18,19,37,eneheuvel,26-09-11
2005,12PM00,202,2,0,2,eneheuvel,26-09-11
2005,12PM00,212,1,1,2,eneheuvel,26-09-11
2005,12PM00,214,1,0,1,eneheuvel,26-09-11
2005,12PM00,311,3,0,3,eneheuvel,26-09-11
2005,12PM00,9999,0,2,2,eneheuvel,26-09-11
2005,12QK00,104,1,0,1,eneheuvel,26-09-11
2005,12QK00,202,2,0,2,eneheuvel,26-09-11
2005,12QK00,204,0,2,2,eneheuvel,26-09-11
2005,12QK00,205,0,3,3,eneheuvel,26-09-11
2005,12QK00,206,100,117,217,eneheuvel,26-09-11
2005,12QK00,207,3,1,4,eneheuvel,26-09-11
2005,12QK00,208,2,5,7,eneheuvel,26-09-11
2005,12QK00,209,4,4,8,eneheuvel,26-09-11
2005,12QK00,210,9,6,15,eneheuvel,26-09-11
2005,12QK00,212,1,1,2,eneheuvel,26-09-11
2005,12QK00,213,1,1,2,eneheuvel,26-09-11
2005,12QK00,215,11,17,28,eneheuvel,26-09-11
2005,12QK00,216,1,0,1,eneheuvel,26-09-11
2005,12QK00,303,1,0,1,eneheuvel,26-09-11
2005,12QK00,305,0,1,1,eneheuvel,26-09-11
2005,12QK00,308,1,1,2,eneheuvel,26-09-11
2005,12QK00,309,1,1,2,eneheuvel,26-09-11
2005,12QK00,311,1,1,2,eneheuvel,26-09-11
2005,12QK00,502,0,1,1,eneheuvel,26-09-11
2005,12XA00,201,1,1,2,eneheuvel,26-09-11
2005,12XA00,211,71,47,118,eneheuvel,26-09-11
2005,12XA00,213,0,1,1,eneheuvel,26-09-11
2005,12XA00,309,0,1,1,eneheuvel,26-09-11
2005,13CW00,201,1,0,1,eneheuvel,26-09-11
2005,13CW00,205,6,2,8,eneheuvel,26-09-11
2005,13CW00,206,79,72,151,eneheuvel,26-09-11
2005,13CW00,207,5,1,6,eneheuvel,26-09-11
2005,13CW00,208,1,1,2,eneheuvel,26-09-11
2005,13CW00,209,9,7,16,eneheuvel,26-09-11
2005,13CW00,210,7,13,20,eneheuvel,26-09-11
2005,13CW00,211,1,0,1,eneheuvel,26-09-11
2005,13CW00,212,0,3,3,eneheuvel,26-09-11
2005,13CW00,215,13,11,24,eneheuvel,26-09-11
2005,13CW00,216,1,0,1,eneheuvel,26-09-11
2005,13CW00,302,0,1,1,eneheuvel,26-09-11
2005,13CW00,305,0,1,1,eneheuvel,26-09-11
2005,13CW00,9999,3,0,3,eneheuvel,26-09-11
2005,13IF00,105,3,2,5,eneheuvel,26-09-11
2005,13IF00,208,0,1,1,eneheuvel,26-09-11
2005,13IF00,211,0,1,1,eneheuvel,26-09-11
2005,13IF00,301,8,5,13,eneheuvel,26-09-11
2005,13IF00,302,1,3,4,eneheuvel,26-09-11
2005,13IF00,303,13,9,22,eneheuvel,26-09-11
2005,13IF00,304,43,23,66,eneheuvel,26-09-11
2005,13IF00,305,17,19,36,eneheuvel,26-09-11
2005,13IF00,306,8,11,19,eneheuvel,26-09-11
2005,13IF00,307,0,2,2,eneheuvel,26-09-11
2005,13IF00,308,0,2,2,eneheuvel,26-09-11
2005,13IF00,309,1,2,3,eneheuvel,26-09-11
2005,13IF00,311,0,1,1,eneheuvel,26-09-11
2005,13IF00,9999,0,1,1,eneheuvel,26-09-11
2005,13IU00,101,1,1,2,eneheuvel,26-09-11
2005,13IU00,102,8,6,14,eneheuvel,26-09-11
2005,13IU00,103,6,2,8,eneheuvel,26-09-11
2005,13IU00,104,1,0,1,eneheuvel,26-09-11
2005,13IU00,105,2,4,6,eneheuvel,26-09-11
2005,13IU00,106,48,38,86,eneheuvel,26-09-11
2005,13IU00,107,6,4,10,eneheuvel,26-09-11
2005,13IU00,108,4,2,6,eneheuvel,26-09-11
2005,13IU00,109,1,2,3,eneheuvel,26-09-11
2005,13IU00,203,0,1,1,eneheuvel,26-09-11
2005,13IU00,205,1,0,1,eneheuvel,26-09-11
2005,13IU00,211,1,1,2,eneheuvel,26-09-11
2005,13IU00,308,0,1,1,eneheuvel,26-09-11
2005,13IU00,309,1,1,2,eneheuvel,26-09-11
2005,13IU00,311,0,1,1,eneheuvel,26-09-11
2005,13IU00,9999,1,4,5,eneheuvel,26-09-11
2005,13NH00,101,3,1,4,eneheuvel,26-09-11
2005,13NH00,102,7,10,17,eneheuvel,26-09-11
2005,13NH00,103,1,0,1,eneheuvel,26-09-11
2005,13NH00,104,16,19,35,eneheuvel,26-09-11
2005,16KK00,101,17,12,29,eneheuvel,26-09-11
2005,16KK00,102,47,47,94,eneheuvel,26-09-11
2005,16KK00,103,62,43,105,eneheuvel,26-09-11
2005,16KK00,104,1,3,4,eneheuvel,26-09-11
2005,16KK00,105,5,1,6,eneheuvel,26-09-11
2005,16KK00,106,2,6,8,eneheuvel,26-09-11
2005,16KK00,107,17,16,33,eneheuvel,26-09-11
2005,16KK00,108,25,35,60,eneheuvel,26-09-11
2005,16KK00,109,23,16,39,eneheuvel,26-09-11
2005,16KK00,110,2,0,2,eneheuvel,26-09-11
2005,16KK00,202,4,0,4,eneheuvel,26-09-11
2005,16KK00,203,2,0,2,eneheuvel,26-09-11
2005,16KK00,207,3,0,3,eneheuvel,26-09-11
2005,16KK00,208,1,0,1,eneheuvel,26-09-11
2005,16KK00,210,1,0,1,eneheuvel,26-09-11
2005,16KK00,211,2,2,4,eneheuvel,26-09-11
2005,16KK00,213,2,0,2,eneheuvel,26-09-11
2005,16KK00,214,3,1,4,eneheuvel,26-09-11
2005,16KK00,303,2,0,2,eneheuvel,26-09-11
2005,16KK00,305,2,0,2,eneheuvel,26-09-11
2005,13NH00,105,57,55,112,eneheuvel,26-09-11
2005,13NH00,106,3,7,10,eneheuvel,26-09-11
2005,13NH00,107,2,5,7,eneheuvel,26-09-11
2005,13NH00,108,0,1,1,eneheuvel,26-09-11
2005,13NH00,109,0,1,1,eneheuvel,26-09-11
2005,13NH00,110,1,4,5,eneheuvel,26-09-11
2005,13NH00,202,0,3,3,eneheuvel,26-09-11
2005,13NH00,203,1,0,1,eneheuvel,26-09-11
2005,13NH00,213,1,0,1,eneheuvel,26-09-11
2005,13NH00,303,1,0,1,eneheuvel,26-09-11
2005,13NH00,9999,1,1,2,eneheuvel,26-09-11
2005,13NU00,205,0,1,1,eneheuvel,26-09-11
2005,13NU00,207,1,0,1,eneheuvel,26-09-11
2005,13NU00,208,1,2,3,eneheuvel,26-09-11
2005,13NU00,210,1,0,1,eneheuvel,26-09-11
2005,13NU00,211,1,0,1,eneheuvel,26-09-11
2005,13NU00,213,1,0,1,eneheuvel,26-09-11
2005,13NU00,214,1,0,1,eneheuvel,26-09-11
2005,13NU00,301,12,7,19,eneheuvel,26-09-11
2005,13NU00,302,0,3,3,eneheuvel,26-09-11
2005,13NU00,303,38,38,76,eneheuvel,26-09-11
2005,13NU00,304,67,69,136,eneheuvel,26-09-11
2005,13NU00,305,15,13,28,eneheuvel,26-09-11
2005,13NU00,306,8,12,20,eneheuvel,26-09-11
2005,13NU00,307,1,2,3,eneheuvel,26-09-11
2005,13NU00,308,3,10,13,eneheuvel,26-09-11
2005,13NU00,309,0,8,8,eneheuvel,26-09-11
2005,13NU00,311,1,1,2,eneheuvel,26-09-11
2005,13NU00,502,0,1,1,eneheuvel,26-09-11
2005,13NU00,9999,1,1,2,eneheuvel,26-09-11
2005,14QC00,102,0,1,1,eneheuvel,26-09-11
2005,14QC00,108,0,1,1,eneheuvel,26-09-11
2005,14QC00,109,3,0,3,eneheuvel,26-09-11
2005,14QC00,201,3,1,4,eneheuvel,26-09-11
2005,14QC00,202,56,70,126,eneheuvel,26-09-11
2005,14QC00,203,60,38,98,eneheuvel,26-09-11
2005,14QC00,204,26,26,52,eneheuvel,26-09-11
2005,14QC00,205,11,12,23,eneheuvel,26-09-11
2005,14QC00,206,6,2,8,eneheuvel,26-09-11
2005,14QC00,207,9,6,15,eneheuvel,26-09-11
2005,14QC00,208,16,15,31,eneheuvel,26-09-11
2005,14QC00,210,5,1,6,eneheuvel,26-09-11
2005,14QC00,211,3,1,4,eneheuvel,26-09-11
2005,14QC00,212,2,7,9,eneheuvel,26-09-11
2005,14QC00,213,1,0,1,eneheuvel,26-09-11
2005,14QC00,214,3,6,9,eneheuvel,26-09-11
2005,14QC00,215,1,1,2,eneheuvel,26-09-11
2005,14QC00,216,1,0,1,eneheuvel,26-09-11
2005,14QC00,301,1,0,1,eneheuvel,26-09-11
2005,14QC00,302,3,6,9,eneheuvel,26-09-11
2005,14QC00,303,1,1,2,eneheuvel,26-09-11
2005,14QC00,304,2,0,2,eneheuvel,26-09-11
2005,14QC00,307,2,1,3,eneheuvel,26-09-11
2005,14QC00,309,3,1,4,eneheuvel,26-09-11
2005,14QC00,310,2,0,2,eneheuvel,26-09-11
2005,14QC00,311,2,1,3,eneheuvel,26-09-11
2005,14QC00,312,1,0,1,eneheuvel,26-09-11
2005,14QC00,502,14,9,23,eneheuvel,26-09-11
2005,14QC00,9999,1,2,3,eneheuvel,26-09-11
2005,15SJ00,102,1,0,1,eneheuvel,26-09-11
2005,15SJ00,103,1,0,1,eneheuvel,26-09-11
2005,15SJ00,104,1,0,1,eneheuvel,26-09-11
2005,15SJ00,108,1,0,1,eneheuvel,26-09-11
2005,15SJ00,201,1,0,1,eneheuvel,26-09-11
2005,15SJ00,202,2,0,2,eneheuvel,26-09-11
2005,15SJ00,204,2,0,2,eneheuvel,26-09-11
2005,15SJ00,205,1,0,1,eneheuvel,26-09-11
2005,15SJ00,206,6,0,6,eneheuvel,26-09-11
2005,15SJ00,208,2,0,2,eneheuvel,26-09-11
2005,16KK00,306,1,0,1,eneheuvel,26-09-11
2005,16KK00,309,0,1,1,eneheuvel,26-09-11
2005,16KK00,311,1,1,2,eneheuvel,26-09-11
2005,16KK00,502,2,2,4,eneheuvel,26-09-11
2005,16KK00,9999,2,0,2,eneheuvel,26-09-11
2005,16LJ00,101,2,2,4,eneheuvel,26-09-11
2005,16LJ00,102,3,3,6,eneheuvel,26-09-11
2005,16LJ00,103,1,2,3,eneheuvel,26-09-11
2005,16LJ00,104,2,5,7,eneheuvel,26-09-11
2005,16LJ00,105,0,1,1,eneheuvel,26-09-11
2005,16LJ00,106,53,45,98,eneheuvel,26-09-11
2005,16LJ00,107,6,3,9,eneheuvel,26-09-11
2005,16LJ00,108,5,6,11,eneheuvel,26-09-11
2005,16LJ00,109,1,1,2,eneheuvel,26-09-11
2005,16LJ00,202,0,3,3,eneheuvel,26-09-11
2005,16LJ00,203,1,0,1,eneheuvel,26-09-11
2005,16LJ00,204,0,1,1,eneheuvel,26-09-11
2005,16LJ00,205,0,1,1,eneheuvel,26-09-11
2005,16LJ00,207,0,1,1,eneheuvel,26-09-11
2005,16LJ00,211,0,2,2,eneheuvel,26-09-11
2005,16LJ00,213,1,0,1,eneheuvel,26-09-11
2005,16LJ00,302,0,1,1,eneheuvel,26-09-11
2005,16LJ00,305,0,1,1,eneheuvel,26-09-11
2005,16LJ00,308,0,1,1,eneheuvel,26-09-11
2005,16LJ00,9999,0,2,2,eneheuvel,26-09-11
2005,16ML00,101,1,7,8,eneheuvel,26-09-11
2005,16ML00,102,22,19,41,eneheuvel,26-09-11
2005,16ML00,103,1,1,2,eneheuvel,26-09-11
2005,16ML00,104,58,72,130,eneheuvel,26-09-11
2005,16ML00,105,31,34,65,eneheuvel,26-09-11
2005,16ML00,106,1,2,3,eneheuvel,26-09-11
2005,16ML00,107,2,1,3,eneheuvel,26-09-11
2005,16ML00,108,0,4,4,eneheuvel,26-09-11
2005,16ML00,109,2,5,7,eneheuvel,26-09-11
2005,16ML00,110,1,1,2,eneheuvel,26-09-11
2005,16ML00,202,0,1,1,eneheuvel,26-09-11
2005,16ML00,203,1,0,1,eneheuvel,26-09-11
2005,16ML00,205,1,0,1,eneheuvel,26-09-11
2005,16ML00,207,0,1,1,eneheuvel,26-09-11
2005,16ML00,209,0,1,1,eneheuvel,26-09-11
2005,16ML00,210,0,2,2,eneheuvel,26-09-11
2005,16ML00,212,3,0,3,eneheuvel,26-09-11
2005,16ML00,214,2,0,2,eneheuvel,26-09-11
2005,16ML00,302,2,0,2,eneheuvel,26-09-11
2005,16ML00,303,1,1,2,eneheuvel,26-09-11
2005,16ML00,306,1,1,2,eneheuvel,26-09-11
2005,16ML00,309,0,2,2,eneheuvel,26-09-11
2005,16ML00,502,1,0,1,eneheuvel,26-09-11
2005,16ML00,9999,1,0,1,eneheuvel,26-09-11
2005,16OC00,101,1,0,1,eneheuvel,26-09-11
2005,16OC00,102,0,1,1,eneheuvel,26-09-11
2005,16OC00,103,3,5,8,eneheuvel,26-09-11
2005,16OC00,104,0,1,1,eneheuvel,26-09-11
2005,16OC00,105,1,1,2,eneheuvel,26-09-11
2005,16OC00,106,1,0,1,eneheuvel,26-09-11
2005,16OC00,107,69,81,150,eneheuvel,26-09-11
2005,16OC00,108,16,21,37,eneheuvel,26-09-11
2005,16OC00,109,43,47,90,eneheuvel,26-09-11
2005,16OC00,202,0,1,1,eneheuvel,26-09-11
2005,16OC00,207,1,0,1,eneheuvel,26-09-11
2005,16OC00,208,0,2,2,eneheuvel,26-09-11
2005,16OC00,209,0,2,2,eneheuvel,26-09-11
2005,16OC00,210,0,1,1,eneheuvel,26-09-11
2005,16OC00,212,0,1,1,eneheuvel,26-09-11
2005,16OC00,214,1,1,2,eneheuvel,26-09-11
2005,16OC00,302,1,0,1,eneheuvel,26-09-11
2005,16OC00,307,1,1,2,eneheuvel,26-09-11
2005,16OC00,308,0,1,1,eneheuvel,26-09-11
2005,16OC00,311,1,2,3,eneheuvel,26-09-11
2005,16UK00,101,2,1,3,eneheuvel,26-09-11
2005,16UK00,102,1,3,4,eneheuvel,26-09-11
2005,16UK00,103,6,12,18,eneheuvel,26-09-11
2005,16UK00,107,0,1,1,eneheuvel,26-09-11
2005,16UK00,108,63,64,127,eneheuvel,26-09-11
2005,16UK00,109,1,4,5,eneheuvel,26-09-11
2005,16UK00,207,1,0,1,eneheuvel,26-09-11
2005,16UK00,210,0,1,1,eneheuvel,26-09-11
2005,16UK00,306,0,1,1,eneheuvel,26-09-11
2005,16UK00,9999,1,6,7,eneheuvel,26-09-11
2005,16WV00,201,4,5,9,eneheuvel,26-09-11
2005,16WV00,202,0,1,1,eneheuvel,26-09-11
2005,16WV00,205,0,1,1,eneheuvel,26-09-11
2005,16WV00,209,15,17,32,eneheuvel,26-09-11
2005,16WV00,210,1,3,4,eneheuvel,26-09-11
2005,16WV00,211,49,64,113,eneheuvel,26-09-11
2005,16WV00,305,1,0,1,eneheuvel,26-09-11
2005,16YS00,201,9,9,18,eneheuvel,26-09-11
2005,16YS00,208,1,0,1,eneheuvel,26-09-11
2005,16YS00,209,0,1,1,eneheuvel,26-09-11
2005,16YS00,210,0,1,1,eneheuvel,26-09-11
2005,16YS00,211,86,67,153,eneheuvel,26-09-11
2005,16YS00,212,0,4,4,eneheuvel,26-09-11
2005,16YS00,213,1,0,1,eneheuvel,26-09-11
2005,16YS00,303,0,1,1,eneheuvel,26-09-11
2005,16YS00,311,0,1,1,eneheuvel,26-09-11
2005,16YS00,312,1,0,1,eneheuvel,26-09-11
2005,16YS00,9999,0,1,1,eneheuvel,26-09-11
2005,16ZG00,102,0,1,1,eneheuvel,26-09-11
2005,16ZG00,206,1,1,2,eneheuvel,26-09-11
2005,16ZG00,208,1,0,1,eneheuvel,26-09-11
2005,16ZG00,210,1,0,1,eneheuvel,26-09-11
2005,16ZG00,211,90,81,171,eneheuvel,26-09-11
2005,16ZG00,212,3,1,4,eneheuvel,26-09-11
2005,16ZG00,214,0,1,1,eneheuvel,26-09-11
2005,16ZG00,303,0,1,1,eneheuvel,26-09-11
2005,16ZG00,308,1,0,1,eneheuvel,26-09-11
2005,16ZG00,309,1,0,1,eneheuvel,26-09-11
2005,16ZG00,311,0,1,1,eneheuvel,26-09-11
2005,16ZG00,9999,1,0,1,eneheuvel,26-09-11
2005,16ZX00,108,1,1,2,eneheuvel,26-09-11
2005,16ZX00,201,2,1,3,eneheuvel,26-09-11
2005,16ZX00,204,0,1,1,eneheuvel,26-09-11
2005,16ZX00,206,25,43,68,eneheuvel,26-09-11
2005,16ZX00,207,38,15,53,eneheuvel,26-09-11
2005,16ZX00,209,45,45,90,eneheuvel,26-09-11
2005,16ZX00,210,0,1,1,eneheuvel,26-09-11
2005,16ZX00,211,1,0,1,eneheuvel,26-09-11
2005,16ZX00,212,0,1,1,eneheuvel,26-09-11
2005,16ZX00,304,1,0,1,eneheuvel,26-09-11
2005,16ZX00,305,0,1,1,eneheuvel,26-09-11
2005,16ZX00,9999,3,1,4,eneheuvel,26-09-11
2005,17AK00,202,0,2,2,eneheuvel,26-09-11
2005,17AK00,203,0,3,3,eneheuvel,26-09-11
2005,17AK00,204,0,1,1,eneheuvel,26-09-11
2005,17AK00,205,1,2,3,eneheuvel,26-09-11
2005,17AK00,206,66,66,132,eneheuvel,26-09-11
2005,17AK00,207,0,2,2,eneheuvel,26-09-11
2005,17AK00,209,2,0,2,eneheuvel,26-09-11
2005,17AK00,210,4,2,6,eneheuvel,26-09-11
2005,17AK00,212,0,1,1,eneheuvel,26-09-11
2005,17AK00,215,2,2,4,eneheuvel,26-09-11
2005,17AK00,301,1,1,2,eneheuvel,26-09-11
2005,17AK00,302,2,1,3,eneheuvel,26-09-11
2005,17AK00,303,1,0,1,eneheuvel,26-09-11
2005,17AK00,304,1,1,2,eneheuvel,26-09-11
2005,17AK00,305,3,2,5,eneheuvel,26-09-11
2005,17AK00,306,1,0,1,eneheuvel,26-09-11
2005,17AK00,307,1,1,2,eneheuvel,26-09-11
2005,17AK00,309,1,2,3,eneheuvel,26-09-11
2005,17AK00,312,1,0,1,eneheuvel,26-09-11
2005,17AV00,103,1,0,1,eneheuvel,26-09-11
2005,17AV00,201,0,1,1,eneheuvel,26-09-11
2005,17AV00,203,0,1,1,eneheuvel,26-09-11
2005,17AV00,204,0,1,1,eneheuvel,26-09-11
2005,17AV00,205,1,1,2,eneheuvel,26-09-11
2005,17AV00,206,76,74,150,eneheuvel,26-09-11
2005,17AV00,207,1,5,6,eneheuvel,26-09-11
2005,17AV00,208,0,1,1,eneheuvel,26-09-11
2005,17AV00,209,1,2,3,eneheuvel,26-09-11
2005,17AV00,210,0,6,6,eneheuvel,26-09-11
2005,17AV00,211,0,1,1,eneheuvel,26-09-11
2005,17AV00,305,0,1,1,eneheuvel,26-09-11
2005,17AV00,9999,4,3,7,eneheuvel,26-09-11
2005,17BP00,202,0,1,1,eneheuvel,26-09-11
2005,17BP00,207,1,0,1,eneheuvel,26-09-11
2005,17BP00,208,0,1,1,eneheuvel,26-09-11
2005,17BP00,211,55,59,114,eneheuvel,26-09-11
2005,17BP00,212,4,5,9,eneheuvel,26-09-11
2005,17BP00,213,76,90,166,eneheuvel,26-09-11
2005,17BP00,214,2,7,9,eneheuvel,26-09-11
2005,17BP00,301,0,1,1,eneheuvel,26-09-11
2005,17BP00,303,0,3,3,eneheuvel,26-09-11
2005,17BP00,312,1,0,1,eneheuvel,26-09-11
2005,17BP00,9999,2,0,2,eneheuvel,26-09-11
2005,17DA00,207,1,1,2,eneheuvel,26-09-11
2005,17DA00,209,16,11,27,eneheuvel,26-09-11
2005,17DA00,210,50,69,119,eneheuvel,26-09-11
2005,17DA00,211,1,2,3,eneheuvel,26-09-11
2005,17DA00,214,0,1,1,eneheuvel,26-09-11
2005,17DA00,215,0,2,2,eneheuvel,26-09-11
2005,17DA00,307,1,1,2,eneheuvel,26-09-11
2005,17DA00,309,1,0,1,eneheuvel,26-09-11
2005,17DA00,9999,2,2,4,eneheuvel,26-09-11
2005,17DK00,201,0,1,1,eneheuvel,26-09-11
2005,17DK00,206,1,0,1,eneheuvel,26-09-11
2005,17DK00,207,1,0,1,eneheuvel,26-09-11
2005,17DK00,208,0,1,1,eneheuvel,26-09-11
2005,17DK00,301,5,5,10,eneheuvel,26-09-11
2005,17DK00,302,1,0,1,eneheuvel,26-09-11
2005,17DK00,303,1,5,6,eneheuvel,26-09-11
2005,17DK00,304,35,47,82,eneheuvel,26-09-11
2005,17DK00,305,0,2,2,eneheuvel,26-09-11
2005,17DK00,306,0,2,2,eneheuvel,26-09-11
2005,17DK00,309,3,1,4,eneheuvel,26-09-11
2005,17DV00,103,0,1,1,eneheuvel,26-09-11
2005,17DV00,106,1,0,1,eneheuvel,26-09-11
2005,17DV00,108,1,0,1,eneheuvel,26-09-11
2005,17DV00,202,1,0,1,eneheuvel,26-09-11
2005,17DV00,203,2,0,2,eneheuvel,26-09-11
2005,17DV00,204,3,2,5,eneheuvel,26-09-11
2005,17DV00,205,1,1,2,eneheuvel,26-09-11
2005,17DV00,206,0,1,1,eneheuvel,26-09-11
2005,17DV00,207,0,2,2,eneheuvel,26-09-11
2005,17DV00,208,0,4,4,eneheuvel,26-09-11
2005,17DV00,209,1,1,2,eneheuvel,26-09-11
2005,17DV00,211,1,2,3,eneheuvel,26-09-11
2005,17DV00,301,13,7,20,eneheuvel,26-09-11
2005,17DV00,302,4,4,8,eneheuvel,26-09-11
2005,17DV00,303,37,22,59,eneheuvel,26-09-11
2005,17DV00,304,43,45,88,eneheuvel,26-09-11
2005,17DV00,305,6,10,16,eneheuvel,26-09-11
2005,17DV00,306,12,9,21,eneheuvel,26-09-11
2005,17DV00,307,10,7,17,eneheuvel,26-09-11
2005,17DV00,308,10,10,20,eneheuvel,26-09-11
2005,17DV00,309,10,14,24,eneheuvel,26-09-11
2005,17DV00,310,0,2,2,eneheuvel,26-09-11
2005,17DV00,311,3,3,6,eneheuvel,26-09-11
2005,17DV00,312,2,0,2,eneheuvel,26-09-11
2005,17DV00,9999,1,0,1,eneheuvel,26-09-11
2005,17FI00,102,3,0,3,eneheuvel,26-09-11
2005,17FI00,103,3,0,3,eneheuvel,26-09-11
2005,17FI00,106,4,0,4,eneheuvel,26-09-11
2005,17FI00,108,4,0,4,eneheuvel,26-09-11
2005,17FI00,202,7,0,7,eneheuvel,26-09-11
2005,17FI00,203,5,0,5,eneheuvel,26-09-11
2005,17FI00,204,3,0,3,eneheuvel,26-09-11
2005,17FI00,205,2,0,2,eneheuvel,26-09-11
2005,17FI00,206,4,0,4,eneheuvel,26-09-11
2005,17FI00,207,8,0,8,eneheuvel,26-09-11
2005,17FI00,208,7,0,7,eneheuvel,26-09-11
2005,17FI00,209,1,0,1,eneheuvel,26-09-11
2005,17FI00,210,7,0,7,eneheuvel,26-09-11
2005,17FI00,211,4,0,4,eneheuvel,26-09-11
2005,17FI00,212,5,0,5,eneheuvel,26-09-11
2005,17FI00,213,6,0,6,eneheuvel,26-09-11
2005,17FI00,214,5,0,5,eneheuvel,26-09-11
2005,17FI00,302,4,0,4,eneheuvel,26-09-11
2005,17FI00,303,6,0,6,eneheuvel,26-09-11
2005,17FI00,304,5,0,5,eneheuvel,26-09-11
2005,17FI00,305,5,0,5,eneheuvel,26-09-11
2005,17FI00,306,3,0,3,eneheuvel,26-09-11
2005,17FI00,307,2,0,2,eneheuvel,26-09-11
2005,17FI00,308,4,0,4,eneheuvel,26-09-11
2005,17FI00,309,5,0,5,eneheuvel,26-09-11
2005,17FI00,311,1,0,1,eneheuvel,26-09-11
2005,17FI00,502,1,0,1,eneheuvel,26-09-11
2005,17FI00,9999,1,0,1,eneheuvel,26-09-11
2005,17LP00,202,0,1,1,eneheuvel,26-09-11
2005,17LP00,207,2,14,16,eneheuvel,26-09-11
2005,17LP00,214,1,0,1,eneheuvel,26-09-11
2005,17LP00,304,2,2,4,eneheuvel,26-09-11
2005,17LP00,305,58,61,119,eneheuvel,26-09-11
2005,17LP00,306,2,5,7,eneheuvel,26-09-11
2005,17LP00,307,0,1,1,eneheuvel,26-09-11
2005,17LP00,309,1,0,1,eneheuvel,26-09-11
2005,17LP00,9999,1,1,2,eneheuvel,26-09-11
2005,17MH00,207,9,23,32,eneheuvel,26-09-11
2005,17MH00,210,3,0,3,eneheuvel,26-09-11
2005,17MH00,211,0,1,1,eneheuvel,26-09-11
2005,17MH00,212,1,0,1,eneheuvel,26-09-11
2005,17MH00,216,1,1,2,eneheuvel,26-09-11
2005,17MH00,302,2,4,6,eneheuvel,26-09-11
2005,17MH00,303,1,2,3,eneheuvel,26-09-11
2005,17MH00,304,0,1,1,eneheuvel,26-09-11
2005,17MH00,305,74,82,156,eneheuvel,26-09-11
2005,17MH00,306,2,0,2,eneheuvel,26-09-11
2005,17MH00,307,0,2,2,eneheuvel,26-09-11
2005,17MH00,311,0,1,1,eneheuvel,26-09-11
2005,21KO00,209,3,3,6,eneheuvel,26-09-11
2005,21KO00,210,87,151,238,eneheuvel,26-09-11
2005,21KO00,212,0,3,3,eneheuvel,26-09-11
2005,21KO00,216,0,3,3,eneheuvel,26-09-11
2005,21KO00,302,1,0,1,eneheuvel,26-09-11
2005,21KO00,9999,0,1,1,eneheuvel,26-09-11
2005,21NC00,103,1,0,1,eneheuvel,26-09-11
2005,21NC00,201,0,2,2,eneheuvel,26-09-11
2005,21NC00,203,0,1,1,eneheuvel,26-09-11
2005,21NC00,211,2,0,2,eneheuvel,26-09-11
2005,21NC00,212,2,0,2,eneheuvel,26-09-11
2005,21NC00,213,58,47,105,eneheuvel,26-09-11
2005,21NC00,214,1,2,3,eneheuvel,26-09-11
2005,21NC00,302,0,1,1,eneheuvel,26-09-11
2005,21NC00,305,1,0,1,eneheuvel,26-09-11
2005,21NC00,311,1,0,1,eneheuvel,26-09-11
2005,21NC00,9999,2,2,4,eneheuvel,26-09-11
2005,21ND00,201,0,1,1,eneheuvel,26-09-11
2005,21ND00,207,0,1,1,eneheuvel,26-09-11
2005,21ND00,210,0,1,1,eneheuvel,26-09-11
2005,21ND00,211,6,3,9,eneheuvel,26-09-11
2005,21ND00,212,3,5,8,eneheuvel,26-09-11
2005,21ND00,213,103,142,245,eneheuvel,26-09-11
2005,21ND00,214,0,5,5,eneheuvel,26-09-11
2005,21ND00,302,0,2,2,eneheuvel,26-09-11
2005,21ND00,9999,1,3,4,eneheuvel,26-09-11
2005,22KP00,201,2,0,2,eneheuvel,26-09-11
2005,22KP00,203,1,0,1,eneheuvel,26-09-11
2005,22KP00,207,0,2,2,eneheuvel,26-09-11
2005,22KP00,208,0,2,2,eneheuvel,26-09-11
2005,22KP00,211,1,1,2,eneheuvel,26-09-11
2005,22KP00,301,3,4,7,eneheuvel,26-09-11
2005,22KP00,302,2,2,4,eneheuvel,26-09-11
2005,22KP00,303,2,4,6,eneheuvel,26-09-11
2005,22KP00,304,1,1,2,eneheuvel,26-09-11
2005,22KP00,306,1,1,2,eneheuvel,26-09-11
2005,22KP00,308,5,7,12,eneheuvel,26-09-11
2005,22KP00,309,150,166,316,eneheuvel,26-09-11
2005,22KP00,310,3,4,7,eneheuvel,26-09-11
2005,22KP00,311,11,24,35,eneheuvel,26-09-11
2005,22KP00,312,1,0,1,eneheuvel,26-09-11
2005,22KP00,9999,2,1,3,eneheuvel,26-09-11
2005,22KQ00,201,1,0,1,eneheuvel,26-09-11
2005,22KQ00,205,1,1,2,eneheuvel,26-09-11
2005,22KQ00,208,1,0,1,eneheuvel,26-09-11
2005,22KQ00,209,1,1,2,eneheuvel,26-09-11
2005,22KQ00,210,109,130,239,eneheuvel,26-09-11
2005,22KQ00,212,1,5,6,eneheuvel,26-09-11
2005,22KQ00,213,1,0,1,eneheuvel,26-09-11
2005,22KQ00,214,1,1,2,eneheuvel,26-09-11
2005,22KQ00,215,0,1,1,eneheuvel,26-09-11
2005,22KQ00,216,2,1,3,eneheuvel,26-09-11
2005,22KQ00,307,1,0,1,eneheuvel,26-09-11
2005,22KQ00,9999,0,1,1,eneheuvel,26-09-11
2005,23EP00,102,1,0,1,eneheuvel,26-09-11
2005,23EP00,109,0,1,1,eneheuvel,26-09-11
2005,23EP00,202,2,3,5,eneheuvel,26-09-11
2005,23EP00,204,1,0,1,eneheuvel,26-09-11
2005,23EP00,205,0,1,1,eneheuvel,26-09-11
2005,23EP00,209,0,1,1,eneheuvel,26-09-11
2005,23EP00,211,1,1,2,eneheuvel,26-09-11
2005,23EP00,212,50,76,126,eneheuvel,26-09-11
2005,23EP00,213,8,10,18,eneheuvel,26-09-11
2005,23EP00,214,0,6,6,eneheuvel,26-09-11
2005,23EP00,303,0,1,1,eneheuvel,26-09-11
2005,23EP00,304,0,2,2,eneheuvel,26-09-11
2005,23EP00,305,1,1,2,eneheuvel,26-09-11
2005,23EP00,9999,0,1,1,eneheuvel,26-09-11
2005,23ER00,208,3,0,3,eneheuvel,26-09-11
2005,23ER00,210,0,1,1,eneheuvel,26-09-11
2005,23ER00,211,1,2,3,eneheuvel,26-09-11
2005,23ER00,212,98,111,209,eneheuvel,26-09-11
2005,23ER00,213,1,7,8,eneheuvel,26-09-11
2005,23ER00,214,4,2,6,eneheuvel,26-09-11
2005,23ER00,311,0,1,1,eneheuvel,26-09-11
2005,23ER00,9999,2,0,2,eneheuvel,26-09-11
2005,23ET00,107,1,1,2,eneheuvel,26-09-11
2005,23ET00,202,0,3,3,eneheuvel,26-09-11
2005,23ET00,206,0,2,2,eneheuvel,26-09-11
2005,23ET00,208,1,0,1,eneheuvel,26-09-11
2005,23ET00,209,0,1,1,eneheuvel,26-09-11
2005,23ET00,210,0,1,1,eneheuvel,26-09-11
2005,23ET00,211,1,2,3,eneheuvel,26-09-11
2005,23ET00,212,1,0,1,eneheuvel,26-09-11
2005,23ET00,214,1,0,1,eneheuvel,26-09-11
2005,23ET00,302,4,5,9,eneheuvel,26-09-11
2005,23ET00,303,2,3,5,eneheuvel,26-09-11
2005,23ET00,304,0,1,1,eneheuvel,26-09-11
2005,23ET00,305,0,1,1,eneheuvel,26-09-11
2005,23ET00,306,4,3,7,eneheuvel,26-09-11
2005,23ET00,307,7,13,20,eneheuvel,26-09-11
2005,23ET00,308,86,107,193,eneheuvel,26-09-11
2005,23ET00,309,9,6,15,eneheuvel,26-09-11
2005,23ET00,310,0,1,1,eneheuvel,26-09-11
2005,23ET00,311,4,0,4,eneheuvel,26-09-11
2005,23ET00,312,1,1,2,eneheuvel,26-09-11
2005,23ET00,502,0,1,1,eneheuvel,26-09-11
2005,23ET00,9999,2,0,2,eneheuvel,26-09-11
2005,23EU00,102,0,1,1,eneheuvel,26-09-11
2005,23EU00,207,1,1,2,eneheuvel,26-09-11
2005,23EU00,208,1,2,3,eneheuvel,26-09-11
2005,23EU00,216,1,1,2,eneheuvel,26-09-11
2005,23EU00,301,1,1,2,eneheuvel,26-09-11
2005,23EU00,302,1,3,4,eneheuvel,26-09-11
2005,23EU00,304,1,0,1,eneheuvel,26-09-11
2005,23EU00,305,9,6,15,eneheuvel,26-09-11
2005,23EU00,306,131,133,264,eneheuvel,26-09-11
2005,23EU00,307,8,4,12,eneheuvel,26-09-11
2005,23EU00,309,0,3,3,eneheuvel,26-09-11
2005,23EU00,310,1,0,1,eneheuvel,26-09-11
2005,23EU00,311,0,3,3,eneheuvel,26-09-11
2005,23EU00,9999,2,2,4,eneheuvel,26-09-11
2005,23EV00,102,0,1,1,eneheuvel,26-09-11
2005,23EV00,201,1,0,1,eneheuvel,26-09-11
2005,23EV00,203,1,0,1,eneheuvel,26-09-11
2005,23EV00,204,0,1,1,eneheuvel,26-09-11
2005,23EV00,208,2,0,2,eneheuvel,26-09-11
2005,23EV00,209,1,0,1,eneheuvel,26-09-11
2005,23EV00,210,12,7,19,eneheuvel,26-09-11
2005,23EV00,211,16,9,25,eneheuvel,26-09-11
2005,23EV00,212,141,144,285,eneheuvel,26-09-11
2005,23EV00,213,21,43,64,eneheuvel,26-09-11
2005,23EV00,214,5,9,14,eneheuvel,26-09-11
2005,23EV00,215,2,0,2,eneheuvel,26-09-11
2005,23EV00,216,1,4,5,eneheuvel,26-09-11
2005,23EV00,303,1,0,1,eneheuvel,26-09-11
2005,23EV00,306,0,1,1,eneheuvel,26-09-11
2005,23EV00,307,2,0,2,eneheuvel,26-09-11
2005,23EV00,311,1,0,1,eneheuvel,26-09-11
2005,23EV00,9999,1,0,1,eneheuvel,26-09-11
2005,23EY00,204,1,0,1,eneheuvel,26-09-11
2005,23EY00,205,1,0,1,eneheuvel,26-09-11
2005,23EY00,207,1,1,2,eneheuvel,26-09-11
2005,23EY00,208,1,2,3,eneheuvel,26-09-11
2005,23EY00,209,0,1,1,eneheuvel,26-09-11
2005,23EY00,210,10,3,13,eneheuvel,26-09-11
2005,23EY00,211,6,2,8,eneheuvel,26-09-11
2005,23EY00,212,133,133,266,eneheuvel,26-09-11
2005,23EY00,213,25,21,46,eneheuvel,26-09-11
2005,23EY00,214,0,12,12,eneheuvel,26-09-11
2005,23EY00,216,1,1,2,eneheuvel,26-09-11
2005,23EY00,502,2,0,2,eneheuvel,26-09-11
2005,23EY00,9999,1,1,2,eneheuvel,26-09-11
2005,23ZU00,110,0,1,1,eneheuvel,26-09-11
2005,23ZU00,201,2,1,3,eneheuvel,26-09-11
2005,23ZU00,202,96,96,192,eneheuvel,26-09-11
2005,23ZU00,203,5,5,10,eneheuvel,26-09-11
2005,23ZU00,204,41,68,109,eneheuvel,26-09-11
2005,23ZU00,205,90,83,173,eneheuvel,26-09-11
2005,23ZU00,206,2,1,3,eneheuvel,26-09-11
2005,23ZU00,207,15,15,30,eneheuvel,26-09-11
2005,23ZU00,208,11,20,31,eneheuvel,26-09-11
2005,23ZU00,209,1,0,1,eneheuvel,26-09-11
2005,23ZU00,210,1,0,1,eneheuvel,26-09-11
2005,23ZU00,211,2,4,6,eneheuvel,26-09-11
2005,23ZU00,212,2,1,3,eneheuvel,26-09-11
2005,23ZU00,214,1,0,1,eneheuvel,26-09-11
2005,23ZU00,215,2,1,3,eneheuvel,26-09-11
2005,23ZU00,216,0,1,1,eneheuvel,26-09-11
2005,23ZU00,302,1,2,3,eneheuvel,26-09-11
2005,23ZU00,303,3,3,6,eneheuvel,26-09-11
2005,23ZU00,306,0,2,2,eneheuvel,26-09-11
2005,23ZU00,307,0,1,1,eneheuvel,26-09-11
2005,23ZU00,309,1,1,2,eneheuvel,26-09-11
2005,23ZU00,310,0,1,1,eneheuvel,26-09-11
2005,23ZU00,502,2,1,3,eneheuvel,26-09-11
2005,23ZU00,9999,2,0,2,eneheuvel,26-09-11
2005,23ZV00,107,1,0,1,eneheuvel,26-09-11
2005,23ZV00,201,2,0,2,eneheuvel,26-09-11
2005,23ZV00,202,40,44,84,eneheuvel,26-09-11
2005,23ZV00,203,6,8,14,eneheuvel,26-09-11
2005,23ZV00,204,31,48,79,eneheuvel,26-09-11
2005,23ZV00,205,60,80,140,eneheuvel,26-09-11
2005,23ZV00,206,0,2,2,eneheuvel,26-09-11
2005,23ZV00,207,12,12,24,eneheuvel,26-09-11
2005,23ZV00,208,10,12,22,eneheuvel,26-09-11
2005,23ZV00,211,0,1,1,eneheuvel,26-09-11
2005,23ZV00,212,1,0,1,eneheuvel,26-09-11
2005,23ZV00,305,0,1,1,eneheuvel,26-09-11
2005,23ZV00,308,1,0,1,eneheuvel,26-09-11
2005,23ZV00,309,1,1,2,eneheuvel,26-09-11
2005,23ZV00,311,0,3,3,eneheuvel,26-09-11
2005,23ZW00,108,0,1,1,eneheuvel,26-09-11
2005,23ZW00,202,1,0,1,eneheuvel,26-09-11
2005,23ZW00,207,0,1,1,eneheuvel,26-09-11
2005,23ZW00,208,4,5,9,eneheuvel,26-09-11
2005,23ZW00,211,0,1,1,eneheuvel,26-09-11
2005,23ZW00,301,1,0,1,eneheuvel,26-09-11
2005,23ZW00,302,4,1,5,eneheuvel,26-09-11
2005,23ZW00,303,7,8,15,eneheuvel,26-09-11
2005,23ZW00,304,3,0,3,eneheuvel,26-09-11
2005,23ZW00,305,2,0,2,eneheuvel,26-09-11
2005,23ZW00,306,31,38,69,eneheuvel,26-09-11
2005,23ZW00,307,78,64,142,eneheuvel,26-09-11
2005,23ZW00,308,100,105,205,eneheuvel,26-09-11
2005,23ZW00,309,1,3,4,eneheuvel,26-09-11
2005,23ZW00,310,2,1,3,eneheuvel,26-09-11
2005,23ZW00,311,1,2,3,eneheuvel,26-09-11
2005,23ZW00,312,1,1,2,eneheuvel,26-09-11
2005,23ZW00,502,1,4,5,eneheuvel,26-09-11
2005,23ZW00,9999,2,1,3,eneheuvel,26-09-11
2005,23ZX00,105,0,1,1,eneheuvel,26-09-11
2005,23ZX00,201,3,4,7,eneheuvel,26-09-11
2005,23ZX00,202,149,119,268,eneheuvel,26-09-11
2005,23ZX00,204,2,5,7,eneheuvel,26-09-11
2005,23ZX00,205,2,2,4,eneheuvel,26-09-11
2005,23ZX00,206,0,2,2,eneheuvel,26-09-11
2005,23ZX00,207,2,1,3,eneheuvel,26-09-11
2005,23ZX00,208,6,3,9,eneheuvel,26-09-11
2005,23ZX00,209,1,0,1,eneheuvel,26-09-11
2005,23ZX00,211,2,5,7,eneheuvel,26-09-11
2005,23ZX00,214,1,1,2,eneheuvel,26-09-11
2005,23ZY00,109,0,2,2,eneheuvel,26-09-11
2005,23ZY00,201,2,0,2,eneheuvel,26-09-11
2005,23ZY00,202,0,1,1,eneheuvel,26-09-11
2005,23ZY00,206,0,2,2,eneheuvel,26-09-11
2005,23ZY00,207,1,0,1,eneheuvel,26-09-11
2005,23ZY00,208,0,1,1,eneheuvel,26-09-11
2005,23ZY00,210,1,3,4,eneheuvel,26-09-11
2005,23ZY00,211,1,1,2,eneheuvel,26-09-11
2005,23ZY00,212,172,245,417,eneheuvel,26-09-11
2005,23ZY00,213,2,1,3,eneheuvel,26-09-11
2005,23ZY00,214,1,1,2,eneheuvel,26-09-11
2005,23ZY00,216,0,4,4,eneheuvel,26-09-11
2005,23ZY00,302,0,1,1,eneheuvel,26-09-11
2005,23ZY00,311,1,0,1,eneheuvel,26-09-11
2005,23ZY00,9999,1,0,1,eneheuvel,26-09-11
2005,24EJ00,102,4,3,7,eneheuvel,26-09-11
2005,24EJ00,103,4,9,13,eneheuvel,26-09-11
2005,24EJ00,105,0,1,1,eneheuvel,26-09-11
2005,24EJ00,106,1,3,4,eneheuvel,26-09-11
2005,24EJ00,107,1,0,1,eneheuvel,26-09-11
2005,24EJ00,201,3,0,3,eneheuvel,26-09-11
2005,24EJ00,202,3,6,9,eneheuvel,26-09-11
2005,24EJ00,203,2,0,2,eneheuvel,26-09-11
2005,24EJ00,204,7,5,12,eneheuvel,26-09-11
2005,24EJ00,205,0,2,2,eneheuvel,26-09-11
2005,24EJ00,206,5,6,11,eneheuvel,26-09-11
2005,24EJ00,207,2,5,7,eneheuvel,26-09-11
2005,24EJ00,208,6,7,13,eneheuvel,26-09-11
2005,24EJ00,209,16,9,25,eneheuvel,26-09-11
2005,24EJ00,210,14,6,20,eneheuvel,26-09-11
2005,24EJ00,211,27,20,47,eneheuvel,26-09-11
2005,24EJ00,212,12,8,20,eneheuvel,26-09-11
2005,24EJ00,213,7,4,11,eneheuvel,26-09-11
2005,24EJ00,214,4,7,11,eneheuvel,26-09-11
2005,24EJ00,301,1,0,1,eneheuvel,26-09-11
2005,24EJ00,302,3,2,5,eneheuvel,26-09-11
2005,24EJ00,303,2,2,4,eneheuvel,26-09-11
2005,24EJ00,304,2,1,3,eneheuvel,26-09-11
2005,24EJ00,305,0,3,3,eneheuvel,26-09-11
2005,24EJ00,306,0,1,1,eneheuvel,26-09-11
2005,24EJ00,307,1,1,2,eneheuvel,26-09-11
2005,24EJ00,308,1,1,2,eneheuvel,26-09-11
2005,24EJ00,9999,7,13,20,eneheuvel,26-09-11
2005,24EJ00,,0,0,0,eneheuvel,26-09-11
2005,24FT00,105,1,0,1,eneheuvel,26-09-11
2005,24FT00,106,1,0,1,eneheuvel,26-09-11
2005,24FT00,202,1,0,1,eneheuvel,26-09-11
2005,24FT00,204,2,0,2,eneheuvel,26-09-11
2005,24FT00,205,2,0,2,eneheuvel,26-09-11
2005,24FT00,206,1,0,1,eneheuvel,26-09-11
2005,24FT00,209,1,0,1,eneheuvel,26-09-11
2005,24FT00,211,2,0,2,eneheuvel,26-09-11
2005,24FT00,212,5,0,5,eneheuvel,26-09-11
2005,24FT00,213,2,0,2,eneheuvel,26-09-11
2005,24FT00,214,1,0,1,eneheuvel,26-09-11
2005,24FT00,302,1,0,1,eneheuvel,26-09-11
2005,24FT00,303,1,0,1,eneheuvel,26-09-11
2005,24FT00,304,1,0,1,eneheuvel,26-09-11
2005,24FT00,306,1,0,1,eneheuvel,26-09-11
2005,24FT00,307,2,0,2,eneheuvel,26-09-11
2005,24FT00,308,1,0,1,eneheuvel,26-09-11
2005,24FT00,309,1,0,1,eneheuvel,26-09-11
2005,24FT00,311,1,0,1,eneheuvel,26-09-11
2005,24FT00,9999,1,0,1,eneheuvel,26-09-11
2005,24MR00,102,1,0,1,eneheuvel,26-09-11
2005,24MR00,109,0,1,1,eneheuvel,26-09-11
2005,24MR00,201,2,1,3,eneheuvel,26-09-11
2005,24MR00,202,1,0,1,eneheuvel,26-09-11
2005,24MR00,207,2,2,4,eneheuvel,26-09-11
2005,24MR00,208,2,5,7,eneheuvel,26-09-11
2005,24MR00,209,1,0,1,eneheuvel,26-09-11
2005,24MR00,211,1,0,1,eneheuvel,26-09-11
2005,24MR00,302,2,1,3,eneheuvel,26-09-11
2005,24MR00,303,0,2,2,eneheuvel,26-09-11
2005,24MR00,304,2,0,2,eneheuvel,26-09-11
2005,24MR00,305,1,3,4,eneheuvel,26-09-11
2005,24MR00,306,16,30,46,eneheuvel,26-09-11
2005,24MR00,307,159,216,375,eneheuvel,26-09-11
2005,24MR00,308,9,19,28,eneheuvel,26-09-11
2005,24MR00,309,0,1,1,eneheuvel,26-09-11
2005,24MR00,310,0,2,2,eneheuvel,26-09-11
2005,24MR00,311,1,5,6,eneheuvel,26-09-11
2005,24MR00,502,2,1,3,eneheuvel,26-09-11
2005,24MR00,9999,1,0,1,eneheuvel,26-09-11
2005,24RK00,108,0,1,1,eneheuvel,26-09-11
2005,24RK00,202,19,18,37,eneheuvel,26-09-11
2005,24RK00,203,12,13,25,eneheuvel,26-09-11
2005,24RK00,204,15,12,27,eneheuvel,26-09-11
2005,24RK00,205,6,7,13,eneheuvel,26-09-11
2005,24RK00,206,1,2,3,eneheuvel,26-09-11
2005,24RK00,207,9,7,16,eneheuvel,26-09-11
2005,24RK00,208,7,2,9,eneheuvel,26-09-11
2005,24RK00,210,3,2,5,eneheuvel,26-09-11
2005,24RK00,212,4,4,8,eneheuvel,26-09-11
2005,24RK00,213,4,0,4,eneheuvel,26-09-11
2005,24RK00,214,4,0,4,eneheuvel,26-09-11
2005,24RK00,301,1,1,2,eneheuvel,26-09-11
2005,24RK00,302,7,1,8,eneheuvel,26-09-11
2005,24RK00,303,6,2,8,eneheuvel,26-09-11
2005,24RK00,304,4,2,6,eneheuvel,26-09-11
2005,24RK00,305,1,3,4,eneheuvel,26-09-11
2005,24RK00,306,6,7,13,eneheuvel,26-09-11
2005,24RK00,307,4,3,7,eneheuvel,26-09-11
2005,24RK00,308,3,3,6,eneheuvel,26-09-11
2005,24RK00,9999,2,0,2,eneheuvel,26-09-11
2005,24UN00,207,1,1,2,eneheuvel,26-09-11
2005,24UN00,208,1,2,3,eneheuvel,26-09-11
2005,24UN00,302,1,3,4,eneheuvel,26-09-11
2005,24UN00,303,1,5,6,eneheuvel,26-09-11
2005,24UN00,306,33,24,57,eneheuvel,26-09-11
2005,24UN00,307,58,31,89,eneheuvel,26-09-11
2005,24UN00,308,53,71,124,eneheuvel,26-09-11
2005,24UN00,309,25,15,40,eneheuvel,26-09-11
2005,24UN00,310,2,0,2,eneheuvel,26-09-11
2005,24UN00,311,3,4,7,eneheuvel,26-09-11
2005,24UN00,312,1,0,1,eneheuvel,26-09-11
2005,24UN00,502,0,3,3,eneheuvel,26-09-11
2005,24UN00,9999,1,1,2,eneheuvel,26-09-11
2005,25CF00,108,0,1,1,eneheuvel,26-09-11
2005,25CF00,202,12,5,17,eneheuvel,26-09-11
2005,25CF00,203,12,9,21,eneheuvel,26-09-11
2005,25CF00,204,72,113,185,eneheuvel,26-09-11
2005,25CF00,205,46,55,101,eneheuvel,26-09-11
2005,25CF00,206,1,0,1,eneheuvel,26-09-11
2005,25CF00,207,7,4,11,eneheuvel,26-09-11
2005,25CF00,208,7,6,13,eneheuvel,26-09-11
2005,25CF00,209,0,3,3,eneheuvel,26-09-11
2005,25CF00,210,3,0,3,eneheuvel,26-09-11
2005,25CF00,211,0,1,1,eneheuvel,26-09-11
2005,25CF00,302,0,1,1,eneheuvel,26-09-11
2005,25CF00,307,0,1,1,eneheuvel,26-09-11
2005,25CF00,308,0,2,2,eneheuvel,26-09-11
2005,25CF00,502,0,1,1,eneheuvel,26-09-11
2005,25CF00,9999,0,2,2,eneheuvel,26-09-11
2005,25KT00,107,2,0,2,eneheuvel,26-09-11
2005,25KT00,201,1,0,1,eneheuvel,26-09-11
2005,25KT00,202,67,50,117,eneheuvel,26-09-11
2005,25KT00,203,101,50,151,eneheuvel,26-09-11
2005,25KT00,204,83,83,166,eneheuvel,26-09-11
2005,25KT00,205,13,3,16,eneheuvel,26-09-11
2005,25KT00,207,9,3,12,eneheuvel,26-09-11
2005,25KT00,208,33,18,51,eneheuvel,26-09-11
2005,25KT00,211,2,0,2,eneheuvel,26-09-11
2005,25KT00,212,0,1,1,eneheuvel,26-09-11
2005,25KT00,216,0,1,1,eneheuvel,26-09-11
2005,25KT00,302,0,1,1,eneheuvel,26-09-11
2005,25KT00,311,0,2,2,eneheuvel,26-09-11
2005,25KT00,312,0,1,1,eneheuvel,26-09-11
2005,25KT00,502,18,10,28,eneheuvel,26-09-11
2005,25KT00,9999,3,2,5,eneheuvel,26-09-11
2005,25KU00,110,1,0,1,eneheuvel,26-09-11
2005,25KU00,201,0,1,1,eneheuvel,26-09-11
2005,25KU00,202,37,29,66,eneheuvel,26-09-11
2005,25KU00,203,68,35,103,eneheuvel,26-09-11
2005,25KU00,204,84,79,163,eneheuvel,26-09-11
2005,25KU00,205,2,1,3,eneheuvel,26-09-11
2005,25KU00,206,1,0,1,eneheuvel,26-09-11
2005,25KU00,207,9,7,16,eneheuvel,26-09-11
2005,25KU00,208,37,23,60,eneheuvel,26-09-11
2005,25KU00,211,1,1,2,eneheuvel,26-09-11
2005,25KU00,309,1,0,1,eneheuvel,26-09-11
2005,25KU00,502,13,12,25,eneheuvel,26-09-11
2005,25KV00,108,0,1,1,eneheuvel,26-09-11
2005,25KV00,202,2,6,8,eneheuvel,26-09-11
2005,25KV00,203,212,172,384,eneheuvel,26-09-11
2005,25KV00,204,6,11,17,eneheuvel,26-09-11
2005,25KV00,205,3,2,5,eneheuvel,26-09-11
2005,25KV00,206,0,1,1,eneheuvel,26-09-11
2005,25KV00,208,7,11,18,eneheuvel,26-09-11
2005,25KV00,211,2,2,4,eneheuvel,26-09-11
2005,25KV00,212,0,2,2,eneheuvel,26-09-11
2005,25KV00,214,2,0,2,eneheuvel,26-09-11
2005,25KV00,302,0,2,2,eneheuvel,26-09-11
2005,25KV00,9999,3,1,4,eneheuvel,26-09-11
2005,26AB00,103,1,0,1,eneheuvel,26-09-11
2005,26AB00,201,3,0,3,eneheuvel,26-09-11
2005,26AB00,206,0,1,1,eneheuvel,26-09-11
2005,26AB00,209,1,0,1,eneheuvel,26-09-11
2005,26AB00,212,1,1,2,eneheuvel,26-09-11
2005,26AB00,301,0,2,2,eneheuvel,26-09-11
2005,26AB00,302,17,12,29,eneheuvel,26-09-11
2005,26AB00,303,215,199,414,eneheuvel,26-09-11
2005,26AB00,304,3,2,5,eneheuvel,26-09-11
2005,26AB00,305,2,2,4,eneheuvel,26-09-11
2005,26AB00,306,3,2,5,eneheuvel,26-09-11
2005,26AB00,308,2,3,5,eneheuvel,26-09-11
2005,26AB00,309,3,3,6,eneheuvel,26-09-11
2005,26AB00,310,2,3,5,eneheuvel,26-09-11
2005,26AB00,311,5,3,8,eneheuvel,26-09-11
2005,26AB00,312,0,1,1,eneheuvel,26-09-11
2005,26AB00,9999,2,1,3,eneheuvel,26-09-11
2005,26AC00,101,0,1,1,eneheuvel,26-09-11
2005,26AC00,103,1,0,1,eneheuvel,26-09-11
2005,26AC00,109,12,2,14,eneheuvel,26-09-11
2005,26AC00,201,1,1,2,eneheuvel,26-09-11
2005,26AC00,202,2,0,2,eneheuvel,26-09-11
2005,26AC00,203,1,1,2,eneheuvel,26-09-11
2005,26AC00,205,1,0,1,eneheuvel,26-09-11
2005,26AC00,206,1,0,1,eneheuvel,26-09-11
2005,26AC00,207,1,0,1,eneheuvel,26-09-11
2005,26AC00,208,0,3,3,eneheuvel,26-09-11
2005,26AC00,209,1,0,1,eneheuvel,26-09-11
2005,26AC00,211,3,3,6,eneheuvel,26-09-11
2005,26AC00,212,20,23,43,eneheuvel,26-09-11
2005,26AC00,213,20,23,43,eneheuvel,26-09-11
2005,26AC00,214,454,299,753,eneheuvel,26-09-11
2005,26AC00,216,1,0,1,eneheuvel,26-09-11
2005,26AC00,302,1,0,1,eneheuvel,26-09-11
2005,26AC00,307,3,0,3,eneheuvel,26-09-11
2005,26AC00,308,1,0,1,eneheuvel,26-09-11
2005,26AC00,311,1,1,2,eneheuvel,26-09-11
2005,26AC00,312,0,1,1,eneheuvel,26-09-11
2005,26AC00,9999,6,0,6,eneheuvel,26-09-11
2005,26AD00,203,1,0,1,eneheuvel,26-09-11
2005,26AD00,204,1,0,1,eneheuvel,26-09-11
2005,26AD00,207,2,0,2,eneheuvel,26-09-11
2005,26AD00,208,3,0,3,eneheuvel,26-09-11
2005,26AD00,214,1,0,1,eneheuvel,26-09-11
2005,26AD00,301,0,1,1,eneheuvel,26-09-11
2005,26AD00,302,101,69,170,eneheuvel,26-09-11
2005,26AD00,303,32,23,55,eneheuvel,26-09-11
2005,26AD00,305,2,0,2,eneheuvel,26-09-11
2005,26AD00,306,4,0,4,eneheuvel,26-09-11
2005,26AD00,307,0,1,1,eneheuvel,26-09-11
2005,26AD00,308,1,0,1,eneheuvel,26-09-11
2005,26AD00,309,61,39,100,eneheuvel,26-09-11
2005,26AD00,310,7,5,12,eneheuvel,26-09-11
2005,26AD00,311,52,46,98,eneheuvel,26-09-11
2005,26AD00,312,1,0,1,eneheuvel,26-09-11
2005,26AD00,313,2,2,4,eneheuvel,26-09-11
2005,26AD00,502,1,2,3,eneheuvel,26-09-11
2005,26AD00,9999,0,1,1,eneheuvel,26-09-11
2005,26PD00,203,1,2,3,eneheuvel,26-09-11
2005,26PD00,204,1,1,2,eneheuvel,26-09-11
2005,26PD00,205,4,8,12,eneheuvel,26-09-11
2005,26PD00,206,1,0,1,eneheuvel,26-09-11
2005,26PD00,207,188,218,406,eneheuvel,26-09-11
2005,26PD00,208,60,69,129,eneheuvel,26-09-11
2005,26PD00,210,1,0,1,eneheuvel,26-09-11
2005,26PD00,211,1,0,1,eneheuvel,26-09-11
2005,26PD00,303,1,0,1,eneheuvel,26-09-11
2005,26PD00,306,0,2,2,eneheuvel,26-09-11
2005,26PD00,309,0,3,3,eneheuvel,26-09-11
2005,26PD00,311,0,1,1,eneheuvel,26-09-11
2005,26PD00,312,0,1,1,eneheuvel,26-09-11
2005,26PD00,502,1,1,2,eneheuvel,26-09-11
2005,26PD00,9999,6,2,8,eneheuvel,26-09-11
2005,26PE00,108,1,0,1,eneheuvel,26-09-11
2005,26PE00,109,1,0,1,eneheuvel,26-09-11
2005,26PE00,207,0,1,1,eneheuvel,26-09-11
2005,26PE00,208,0,1,1,eneheuvel,26-09-11
2005,26PE00,210,1,0,1,eneheuvel,26-09-11
2005,26PE00,212,0,1,1,eneheuvel,26-09-11
2005,26PE00,301,1,0,1,eneheuvel,26-09-11
2005,26PE00,302,271,249,520,eneheuvel,26-09-11
2005,26PE00,303,14,8,22,eneheuvel,26-09-11
2005,26PE00,304,0,1,1,eneheuvel,26-09-11
2005,26PE00,306,0,1,1,eneheuvel,26-09-11
2005,26PE00,308,0,1,1,eneheuvel,26-09-11
2005,26PE00,309,3,1,4,eneheuvel,26-09-11
2005,26PE00,310,0,1,1,eneheuvel,26-09-11
2005,26PE00,311,3,5,8,eneheuvel,26-09-11
2005,26PE00,312,0,3,3,eneheuvel,26-09-11
2005,26PE00,9999,2,1,3,eneheuvel,26-09-11
2005,26PF00,101,0,1,1,eneheuvel,26-09-11
2005,26PF00,102,0,1,1,eneheuvel,26-09-11
2005,26PF00,201,1,0,1,eneheuvel,26-09-11
2005,26PF00,202,0,2,2,eneheuvel,26-09-11
2005,26PF00,206,2,1,3,eneheuvel,26-09-11
2005,26PF00,207,2,1,3,eneheuvel,26-09-11
2005,26PF00,208,3,1,4,eneheuvel,26-09-11
2005,26PF00,211,5,3,8,eneheuvel,26-09-11
2005,26PF00,212,4,5,9,eneheuvel,26-09-11
2005,26PF00,213,0,6,6,eneheuvel,26-09-11
2005,26PF00,214,211,192,403,eneheuvel,26-09-11
2005,26PF00,216,0,1,1,eneheuvel,26-09-11
2005,26PF00,302,0,1,1,eneheuvel,26-09-11
2005,26PF00,303,0,2,2,eneheuvel,26-09-11
2005,26PF00,305,0,1,1,eneheuvel,26-09-11
2005,26PF00,311,1,0,1,eneheuvel,26-09-11
2005,26PF00,312,0,1,1,eneheuvel,26-09-11
2005,26PF00,9999,2,0,2,eneheuvel,26-09-11
2005,26PG00,103,1,1,2,eneheuvel,26-09-11
2005,26PG00,201,0,1,1,eneheuvel,26-09-11
2005,26PG00,207,1,0,1,eneheuvel,26-09-11
2005,26PG00,209,1,1,2,eneheuvel,26-09-11
2005,26PG00,210,1,0,1,eneheuvel,26-09-11
2005,26PG00,211,0,3,3,eneheuvel,26-09-11
2005,26PG00,212,0,3,3,eneheuvel,26-09-11
2005,26PG00,213,1,1,2,eneheuvel,26-09-11
2005,26PG00,214,87,130,217,eneheuvel,26-09-11
2005,26PG00,304,0,1,1,eneheuvel,26-09-11
2005,26PG00,9999,2,0,2,eneheuvel,26-09-11
2005,26PH00,108,0,1,1,eneheuvel,26-09-11
2005,26PH00,203,1,0,1,eneheuvel,26-09-11
2005,26PH00,208,1,0,1,eneheuvel,26-09-11
2005,26PH00,216,1,0,1,eneheuvel,26-09-11
2005,26PH00,302,22,10,32,eneheuvel,26-09-11
2005,26PH00,303,5,5,10,eneheuvel,26-09-11
2005,26PH00,305,3,0,3,eneheuvel,26-09-11
2005,26PH00,306,2,0,2,eneheuvel,26-09-11
2005,26PH00,308,2,0,2,eneheuvel,26-09-11
2005,26PH00,309,51,11,62,eneheuvel,26-09-11
2005,26PH00,311,281,149,430,eneheuvel,26-09-11
2005,26PH00,312,6,0,6,eneheuvel,26-09-11
2005,26PH00,313,0,3,3,eneheuvel,26-09-11
2005,26PH00,9999,1,1,2,eneheuvel,26-09-11
2005,26PW00,207,1,0,1,eneheuvel,26-09-11
2005,26PW00,208,2,0,2,eneheuvel,26-09-11
2005,26PW00,214,1,0,1,eneheuvel,26-09-11
2005,26PW00,216,2,0,2,eneheuvel,26-09-11
2005,26PW00,302,58,34,92,eneheuvel,26-09-11
2005,26PW00,303,32,11,43,eneheuvel,26-09-11
2005,26PW00,305,1,0,1,eneheuvel,26-09-11
2005,26PW00,306,0,1,1,eneheuvel,26-09-11
2005,26PW00,307,3,2,5,eneheuvel,26-09-11
2005,26PW00,308,3,0,3,eneheuvel,26-09-11
2005,26PW00,309,37,23,60,eneheuvel,26-09-11
2005,26PW00,310,3,4,7,eneheuvel,26-09-11
2005,26PW00,311,29,32,61,eneheuvel,26-09-11
2005,26PW00,312,1,0,1,eneheuvel,26-09-11
2005,26PW00,502,1,0,1,eneheuvel,26-09-11
2005,26PW00,9999,2,1,3,eneheuvel,26-09-11
2005,26ZZ00,201,1,0,1,eneheuvel,26-09-11
2005,26ZZ00,202,219,215,434,eneheuvel,26-09-11
2005,26ZZ00,203,9,6,15,eneheuvel,26-09-11
2005,26ZZ00,204,1,1,2,eneheuvel,26-09-11
2005,26ZZ00,205,1,0,1,eneheuvel,26-09-11
2005,26ZZ00,208,4,8,12,eneheuvel,26-09-11
2005,26ZZ00,209,1,0,1,eneheuvel,26-09-11
2005,26ZZ00,210,2,0,2,eneheuvel,26-09-11
2005,26ZZ00,211,0,2,2,eneheuvel,26-09-11
2005,26ZZ00,213,0,1,1,eneheuvel,26-09-11
2005,26ZZ00,214,0,1,1,eneheuvel,26-09-11
2005,26ZZ00,302,0,1,1,eneheuvel,26-09-11
2005,26ZZ00,304,1,1,2,eneheuvel,26-09-11
2005,26ZZ00,307,1,1,2,eneheuvel,26-09-11
2005,26ZZ00,308,1,2,3,eneheuvel,26-09-11
2005,26ZZ00,309,0,2,2,eneheuvel,26-09-11
2005,26ZZ00,311,0,1,1,eneheuvel,26-09-11
2005,26ZZ00,502,1,1,2,eneheuvel,26-09-11
2005,26ZZ00,9999,1,1,2,eneheuvel,26-09-11
2005,27AA00,102,1,1,2,eneheuvel,26-09-11
2005,27AA00,106,0,1,1,eneheuvel,26-09-11
2005,27AA00,107,1,0,1,eneheuvel,26-09-11
2005,27AA00,202,1,1,2,eneheuvel,26-09-11
2005,27AA00,203,4,2,6,eneheuvel,26-09-11
2005,27AA00,204,10,2,12,eneheuvel,26-09-11
2005,27AA00,205,8,0,8,eneheuvel,26-09-11
2005,27AA00,206,2,0,2,eneheuvel,26-09-11
2005,27AA00,207,72,41,113,eneheuvel,26-09-11
2005,27AA00,208,169,126,295,eneheuvel,26-09-11
2005,27AA00,209,1,0,1,eneheuvel,26-09-11
2005,27AA00,210,1,0,1,eneheuvel,26-09-11
2005,27AA00,211,2,1,3,eneheuvel,26-09-11
2005,27AA00,212,3,1,4,eneheuvel,26-09-11
2005,27AA00,214,1,0,1,eneheuvel,26-09-11
2005,27AA00,302,1,0,1,eneheuvel,26-09-11
2005,27AA00,303,1,0,1,eneheuvel,26-09-11
2005,27AA00,305,0,2,2,eneheuvel,26-09-11
2005,27AA00,306,1,1,2,eneheuvel,26-09-11
2005,27AA00,307,3,1,4,eneheuvel,26-09-11
2005,27AA00,308,2,1,3,eneheuvel,26-09-11
2005,27AA00,312,1,2,3,eneheuvel,26-09-11
2005,27AA00,502,2,1,3,eneheuvel,26-09-11
2005,27AA00,9999,5,2,7,eneheuvel,26-09-11
2005,27NU00,201,0,1,1,eneheuvel,26-09-11
2005,27NU00,202,0,1,1,eneheuvel,26-09-11
2005,27NU00,203,6,2,8,eneheuvel,26-09-11
2005,27NU00,204,2,0,2,eneheuvel,26-09-11
2005,27NU00,205,1,0,1,eneheuvel,26-09-11
2005,27NU00,206,1,0,1,eneheuvel,26-09-11
2005,27NU00,207,14,6,20,eneheuvel,26-09-11
2005,27NU00,208,170,82,252,eneheuvel,26-09-11
2005,27NU00,210,1,0,1,eneheuvel,26-09-11
2005,27NU00,303,0,1,1,eneheuvel,26-09-11
2005,27NU00,307,1,1,2,eneheuvel,26-09-11
2005,27NU00,502,1,0,1,eneheuvel,26-09-11
2005,27NU00,9999,2,1,3,eneheuvel,26-09-11
2005,27UB00,201,0,1,1,eneheuvel,26-09-11
2005,27UB00,202,0,1,1,eneheuvel,26-09-11
2005,27UB00,203,2,0,2,eneheuvel,26-09-11
2005,27UB00,204,0,1,1,eneheuvel,26-09-11
2005,27UB00,205,0,1,1,eneheuvel,26-09-11
2005,27UB00,207,4,1,5,eneheuvel,26-09-11
2005,27UB00,208,113,63,176,eneheuvel,26-09-11
2005,27UB00,210,1,0,1,eneheuvel,26-09-11
2005,27UB00,212,1,0,1,eneheuvel,26-09-11
2005,27UB00,306,0,2,2,eneheuvel,26-09-11
2005,27UB00,307,1,0,1,eneheuvel,26-09-11
2005,27UB00,310,1,0,1,eneheuvel,26-09-11
2005,27UB00,9999,1,0,1,eneheuvel,26-09-11
2005,27XH00,210,2,0,2,eneheuvel,26-09-11
2005,27XH00,211,0,2,2,eneheuvel,26-09-11
2005,27XH00,212,4,2,6,eneheuvel,26-09-11
2005,27XH00,214,1,2,3,eneheuvel,26-09-11
2005,27XH00,215,3,5,8,eneheuvel,26-09-11
2005,27XH00,216,23,14,37,eneheuvel,26-09-11
2005,27XH00,302,0,1,1,eneheuvel,26-09-11
2005,27XJ00,207,2,0,2,eneheuvel,26-09-11
2005,27XJ00,302,5,3,8,eneheuvel,26-09-11
2005,27XJ00,307,2,0,2,eneheuvel,26-09-11
2005,27XJ00,308,1,0,1,eneheuvel,26-09-11
2005,27XJ00,309,3,0,3,eneheuvel,26-09-11
2005,27XJ00,310,0,1,1,eneheuvel,26-09-11
2005,27XJ00,311,10,1,11,eneheuvel,26-09-11
2005,27XJ00,312,26,13,39,eneheuvel,26-09-11
2005,27XJ00,502,0,1,1,eneheuvel,26-09-11
2005,27XJ00,9999,1,0,1,eneheuvel,26-09-11
2005,27YN00,202,1,1,2,eneheuvel,26-09-11
2005,27YN00,206,0,2,2,eneheuvel,26-09-11
2005,27YN00,207,1,0,1,eneheuvel,26-09-11
2005,27YN00,210,0,2,2,eneheuvel,26-09-11
2005,27YN00,212,1,6,7,eneheuvel,26-09-11
2005,27YN00,214,0,2,2,eneheuvel,26-09-11
2005,27YN00,215,1,0,1,eneheuvel,26-09-11
2005,27YN00,216,23,29,52,eneheuvel,26-09-11
2005,27YN00,302,1,0,1,eneheuvel,26-09-11
2005,28AM00,207,2,0,2,eneheuvel,26-09-11
2005,28AM00,211,0,1,1,eneheuvel,26-09-11
2005,28AM00,311,1,0,1,eneheuvel,26-09-11
2005,28AM00,312,13,6,19,eneheuvel,26-09-11
2005,28BR00,207,0,1,1,eneheuvel,26-09-11
2005,28BR00,208,1,1,2,eneheuvel,26-09-11
2005,28BR00,211,1,1,2,eneheuvel,26-09-11
2005,28BR00,212,2,3,5,eneheuvel,26-09-11
2005,28BR00,213,0,1,1,eneheuvel,26-09-11
2005,28BR00,302,1,2,3,eneheuvel,26-09-11
2005,28BR00,303,2,0,2,eneheuvel,26-09-11
2005,28BR00,306,2,1,3,eneheuvel,26-09-11
2005,28BR00,307,1,0,1,eneheuvel,26-09-11
2005,28BR00,309,1,0,1,eneheuvel,26-09-11
2005,28BR00,311,5,2,7,eneheuvel,26-09-11
2005,28BR00,9999,1,0,1,eneheuvel,26-09-11
2006,06RM00,102,5,0,5,eneheuvel,26-09-11
2006,06RM00,103,5,0,5,eneheuvel,26-09-11
2006,06RM00,105,2,1,3,eneheuvel,26-09-11
2006,06RM00,106,1,0,1,eneheuvel,26-09-11
2006,06RM00,108,3,1,4,eneheuvel,26-09-11
2006,06RM00,109,0,3,3,eneheuvel,26-09-11
2006,06RM00,202,6,10,16,eneheuvel,26-09-11
2006,06RM00,203,1,0,1,eneheuvel,26-09-11
2006,06RM00,206,4,6,10,eneheuvel,26-09-11
2006,06RM00,207,3,2,5,eneheuvel,26-09-11
2006,06RM00,208,1,5,6,eneheuvel,26-09-11
2006,06RM00,209,1,0,1,eneheuvel,26-09-11
2006,06RM00,210,10,4,14,eneheuvel,26-09-11
2006,06RM00,211,6,5,11,eneheuvel,26-09-11
2006,06RM00,212,27,37,64,eneheuvel,26-09-11
2006,06RM00,213,9,5,14,eneheuvel,26-09-11
2006,06RM00,214,18,12,30,eneheuvel,26-09-11
2006,06RM00,215,2,2,4,eneheuvel,26-09-11
2006,06RM00,216,6,4,10,eneheuvel,26-09-11
2006,06RM00,302,3,6,9,eneheuvel,26-09-11
2006,06RM00,303,5,5,10,eneheuvel,26-09-11
2006,06RM00,304,4,2,6,eneheuvel,26-09-11
2006,06RM00,305,1,0,1,eneheuvel,26-09-11
2006,06RM00,306,2,1,3,eneheuvel,26-09-11
2006,06RM00,309,3,4,7,eneheuvel,26-09-11
2006,06RM00,311,0,4,4,eneheuvel,26-09-11
2006,06RM00,312,1,2,3,eneheuvel,26-09-11
2006,06RM00,502,2,4,6,eneheuvel,26-09-11
2006,06RM00,9999,17,6,23,eneheuvel,26-09-11
2006,12HU00,103,1,0,1,eneheuvel,26-09-11
2006,12HU00,104,0,1,1,eneheuvel,26-09-11
2006,12HU00,201,4,13,17,eneheuvel,26-09-11
2006,12HU00,202,2,2,4,eneheuvel,26-09-11
2006,12HU00,203,1,0,1,eneheuvel,26-09-11
2006,12HU00,204,0,1,1,eneheuvel,26-09-11
2006,12HU00,205,1,0,1,eneheuvel,26-09-11
2006,12HU00,206,0,3,3,eneheuvel,26-09-11
2006,12HU00,207,1,0,1,eneheuvel,26-09-11
2006,12HU00,208,1,1,2,eneheuvel,26-09-11
2006,12HU00,209,2,0,2,eneheuvel,26-09-11
2006,12HU00,210,3,1,4,eneheuvel,26-09-11
2006,12HU00,211,54,48,102,eneheuvel,26-09-11
2006,12HU00,212,0,1,1,eneheuvel,26-09-11
2006,12HU00,213,0,1,1,eneheuvel,26-09-11
2006,12PM00,101,11,6,17,eneheuvel,26-09-11
2006,12PM00,102,6,3,9,eneheuvel,26-09-11
2006,12PM00,103,42,29,71,eneheuvel,26-09-11
2006,12PM00,104,1,3,4,eneheuvel,26-09-11
2006,12PM00,106,2,6,8,eneheuvel,26-09-11
2006,12PM00,107,22,14,36,eneheuvel,26-09-11
2006,12PM00,108,19,11,30,eneheuvel,26-09-11
2006,12PM00,109,16,17,33,eneheuvel,26-09-11
2006,12PM00,202,2,0,2,eneheuvel,26-09-11
2006,12PM00,212,1,1,2,eneheuvel,26-09-11
2006,12PM00,214,1,0,1,eneheuvel,26-09-11
2006,12PM00,216,1,0,1,eneheuvel,26-09-11
2006,12PM00,311,2,0,2,eneheuvel,26-09-11
2006,12QK00,101,1,0,1,eneheuvel,26-09-11
2006,12QK00,104,0,1,1,eneheuvel,26-09-11
2006,12QK00,201,1,0,1,eneheuvel,26-09-11
2006,12QK00,202,2,0,2,eneheuvel,26-09-11
2006,12QK00,204,0,1,1,eneheuvel,26-09-11
2006,12QK00,205,0,2,2,eneheuvel,26-09-11
2006,12QK00,206,108,102,210,eneheuvel,26-09-11
2006,12QK00,207,2,1,3,eneheuvel,26-09-11
2006,12QK00,208,1,5,6,eneheuvel,26-09-11
2006,12QK00,209,3,3,6,eneheuvel,26-09-11
2006,12QK00,210,9,6,15,eneheuvel,26-09-11
2006,12QK00,213,0,2,2,eneheuvel,26-09-11
2006,12QK00,214,1,0,1,eneheuvel,26-09-11
2006,12QK00,215,8,15,23,eneheuvel,26-09-11
2006,12QK00,216,0,1,1,eneheuvel,26-09-11
2006,12QK00,303,0,1,1,eneheuvel,26-09-11
2006,12QK00,307,0,1,1,eneheuvel,26-09-11
2006,12QK00,309,0,1,1,eneheuvel,26-09-11
2006,12QK00,311,2,2,4,eneheuvel,26-09-11
2006,12QK00,312,0,1,1,eneheuvel,26-09-11
2006,12XA00,201,0,1,1,eneheuvel,26-09-11
2006,12XA00,207,1,0,1,eneheuvel,26-09-11
2006,12XA00,211,66,54,120,eneheuvel,26-09-11
2006,12XA00,213,1,1,2,eneheuvel,26-09-11
2006,12XA00,303,1,0,1,eneheuvel,26-09-11
2006,12XA00,309,0,1,1,eneheuvel,26-09-11
2006,13CW00,201,1,0,1,eneheuvel,26-09-11
2006,13CW00,203,1,0,1,eneheuvel,26-09-11
2006,13CW00,205,3,3,6,eneheuvel,26-09-11
2006,13CW00,206,75,67,142,eneheuvel,26-09-11
2006,13CW00,207,1,2,3,eneheuvel,26-09-11
2006,13CW00,208,2,0,2,eneheuvel,26-09-11
2006,13CW00,209,13,6,19,eneheuvel,26-09-11
2006,13CW00,210,5,9,14,eneheuvel,26-09-11
2006,13CW00,211,1,0,1,eneheuvel,26-09-11
2006,13CW00,212,0,2,2,eneheuvel,26-09-11
2006,13CW00,215,2,5,7,eneheuvel,26-09-11
2006,13CW00,216,1,0,1,eneheuvel,26-09-11
2006,13CW00,308,1,1,2,eneheuvel,26-09-11
2006,13IF00,105,0,1,1,eneheuvel,26-09-11
2006,13IF00,207,1,0,1,eneheuvel,26-09-11
2006,13IF00,208,1,1,2,eneheuvel,26-09-11
2006,13IF00,211,0,1,1,eneheuvel,26-09-11
2006,13IF00,301,9,8,17,eneheuvel,26-09-11
2006,13IF00,302,2,3,5,eneheuvel,26-09-11
2006,13IF00,303,14,6,20,eneheuvel,26-09-11
2006,13IF00,304,42,28,70,eneheuvel,26-09-11
2006,13IF00,305,13,11,24,eneheuvel,26-09-11
2006,13IF00,306,7,15,22,eneheuvel,26-09-11
2006,13IF00,307,0,2,2,eneheuvel,26-09-11
2006,13IF00,308,1,3,4,eneheuvel,26-09-11
2006,13IF00,309,0,2,2,eneheuvel,26-09-11
2006,13IF00,311,0,1,1,eneheuvel,26-09-11
2006,13IU00,101,0,1,1,eneheuvel,26-09-11
2006,13IU00,102,11,6,17,eneheuvel,26-09-11
2006,13IU00,103,4,5,9,eneheuvel,26-09-11
2006,13IU00,104,2,0,2,eneheuvel,26-09-11
2006,13IU00,105,2,4,6,eneheuvel,26-09-11
2006,13IU00,106,53,35,88,eneheuvel,26-09-11
2006,13IU00,107,5,3,8,eneheuvel,26-09-11
2006,13IU00,108,5,2,7,eneheuvel,26-09-11
2006,13IU00,109,2,1,3,eneheuvel,26-09-11
2006,13IU00,203,0,1,1,eneheuvel,26-09-11
2006,13IU00,205,1,0,1,eneheuvel,26-09-11
2006,13IU00,211,1,1,2,eneheuvel,26-09-11
2006,13IU00,212,2,0,2,eneheuvel,26-09-11
2006,13IU00,9999,0,4,4,eneheuvel,26-09-11
2006,13NH00,101,6,1,7,eneheuvel,26-09-11
2006,13NH00,102,10,7,17,eneheuvel,26-09-11
2006,13NH00,103,3,0,3,eneheuvel,26-09-11
2006,13NH00,104,21,27,48,eneheuvel,26-09-11
2006,13NH00,105,55,60,115,eneheuvel,26-09-11
2006,13NH00,106,3,8,11,eneheuvel,26-09-11
2006,13NH00,107,2,2,4,eneheuvel,26-09-11
2006,13NH00,109,0,1,1,eneheuvel,26-09-11
2006,13NH00,110,3,2,5,eneheuvel,26-09-11
2006,13NH00,202,0,1,1,eneheuvel,26-09-11
2006,13NH00,203,0,2,2,eneheuvel,26-09-11
2006,13NH00,211,1,0,1,eneheuvel,26-09-11
2006,13NH00,213,1,0,1,eneheuvel,26-09-11
2006,13NH00,301,1,0,1,eneheuvel,26-09-11
2006,13NH00,305,0,1,1,eneheuvel,26-09-11
2006,13NH00,502,1,0,1,eneheuvel,26-09-11
2006,13NH00,9999,3,0,3,eneheuvel,26-09-11
2006,13NU00,205,0,1,1,eneheuvel,26-09-11
2006,13NU00,207,2,0,2,eneheuvel,26-09-11
2006,13NU00,208,1,1,2,eneheuvel,26-09-11
2006,13NU00,211,1,0,1,eneheuvel,26-09-11
2006,13NU00,213,1,1,2,eneheuvel,26-09-11
2006,13NU00,301,12,9,21,eneheuvel,26-09-11
2006,13NU00,303,36,43,79,eneheuvel,26-09-11
2006,13NU00,304,75,63,138,eneheuvel,26-09-11
2006,13NU00,305,18,16,34,eneheuvel,26-09-11
2006,13NU00,306,12,9,21,eneheuvel,26-09-11
2006,13NU00,307,1,2,3,eneheuvel,26-09-11
2006,13NU00,308,2,12,14,eneheuvel,26-09-11
2006,13NU00,309,3,3,6,eneheuvel,26-09-11
2006,13NU00,310,1,2,3,eneheuvel,26-09-11
2006,13NU00,502,0,1,1,eneheuvel,26-09-11
2006,13NU00,9999,1,0,1,eneheuvel,26-09-11
2006,14QC00,105,0,1,1,eneheuvel,26-09-11
2006,14QC00,109,2,1,3,eneheuvel,26-09-11
2006,14QC00,201,2,1,3,eneheuvel,26-09-11
2006,14QC00,202,52,67,119,eneheuvel,26-09-11
2006,14QC00,203,57,40,97,eneheuvel,26-09-11
2006,14QC00,204,19,31,50,eneheuvel,26-09-11
2006,14QC00,205,13,12,25,eneheuvel,26-09-11
2006,14QC00,206,9,4,13,eneheuvel,26-09-11
2006,14QC00,207,12,7,19,eneheuvel,26-09-11
2006,14QC00,208,15,17,32,eneheuvel,26-09-11
2006,14QC00,210,6,1,7,eneheuvel,26-09-11
2006,14QC00,211,1,1,2,eneheuvel,26-09-11
2006,14QC00,212,4,7,11,eneheuvel,26-09-11
2006,14QC00,213,3,2,5,eneheuvel,26-09-11
2006,14QC00,214,3,5,8,eneheuvel,26-09-11
2006,14QC00,215,1,0,1,eneheuvel,26-09-11
2006,14QC00,216,2,0,2,eneheuvel,26-09-11
2006,14QC00,302,4,5,9,eneheuvel,26-09-11
2006,14QC00,303,3,1,4,eneheuvel,26-09-11
2006,14QC00,304,5,0,5,eneheuvel,26-09-11
2006,14QC00,307,2,1,3,eneheuvel,26-09-11
2006,14QC00,308,1,0,1,eneheuvel,26-09-11
2006,14QC00,309,4,2,6,eneheuvel,26-09-11
2006,14QC00,311,4,1,5,eneheuvel,26-09-11
2006,14QC00,312,1,0,1,eneheuvel,26-09-11
2006,14QC00,502,12,14,26,eneheuvel,26-09-11
2006,14QC00,9999,0,1,1,eneheuvel,26-09-11
2006,15SJ00,101,0,2,2,eneheuvel,26-09-11
2006,15SJ00,102,1,2,3,eneheuvel,26-09-11
2006,15SJ00,103,0,7,7,eneheuvel,26-09-11
2006,15SJ00,104,0,4,4,eneheuvel,26-09-11
2006,15SJ00,105,0,1,1,eneheuvel,26-09-11
2006,15SJ00,106,0,5,5,eneheuvel,26-09-11
2006,15SJ00,107,0,2,2,eneheuvel,26-09-11
2006,15SJ00,108,1,4,5,eneheuvel,26-09-11
2006,15SJ00,201,1,1,2,eneheuvel,26-09-11
2006,15SJ00,202,2,6,8,eneheuvel,26-09-11
2006,15SJ00,203,1,8,9,eneheuvel,26-09-11
2006,15SJ00,204,2,10,12,eneheuvel,26-09-11
2006,15SJ00,205,1,7,8,eneheuvel,26-09-11
2006,15SJ00,206,4,26,30,eneheuvel,26-09-11
2006,15SJ00,207,4,14,18,eneheuvel,26-09-11
2006,15SJ00,208,2,14,16,eneheuvel,26-09-11
2006,15SJ00,209,2,12,14,eneheuvel,26-09-11
2006,15SJ00,210,4,17,21,eneheuvel,26-09-11
2006,15SJ00,211,5,13,18,eneheuvel,26-09-11
2006,15SJ00,212,3,18,21,eneheuvel,26-09-11
2006,15SJ00,213,1,7,8,eneheuvel,26-09-11
2006,15SJ00,214,4,10,14,eneheuvel,26-09-11
2006,15SJ00,301,0,4,4,eneheuvel,26-09-11
2006,15SJ00,302,1,9,10,eneheuvel,26-09-11
2006,15SJ00,303,4,7,11,eneheuvel,26-09-11
2006,15SJ00,304,3,7,10,eneheuvel,26-09-11
2006,15SJ00,305,2,4,6,eneheuvel,26-09-11
2006,15SJ00,306,1,7,8,eneheuvel,26-09-11
2006,15SJ00,307,1,8,9,eneheuvel,26-09-11
2006,15SJ00,308,1,4,5,eneheuvel,26-09-11
2006,15SJ00,309,0,5,5,eneheuvel,26-09-11
2006,15SJ00,311,0,6,6,eneheuvel,26-09-11
2006,15SJ00,312,0,4,4,eneheuvel,26-09-11
2006,15SJ00,9999,1,1,2,eneheuvel,26-09-11
2006,15ZL00,103,0,1,1,eneheuvel,26-09-11
2006,15ZL00,107,0,1,1,eneheuvel,26-09-11
2006,15ZL00,108,1,0,1,eneheuvel,26-09-11
2006,15ZL00,201,0,2,2,eneheuvel,26-09-11
2006,15ZL00,204,1,1,2,eneheuvel,26-09-11
2006,15ZL00,205,1,1,2,eneheuvel,26-09-11
2006,15ZL00,206,1,3,4,eneheuvel,26-09-11
2006,15ZL00,207,0,1,1,eneheuvel,26-09-11
2006,15ZL00,208,0,1,1,eneheuvel,26-09-11
2006,15ZL00,210,0,2,2,eneheuvel,26-09-11
2006,15ZL00,302,1,7,8,eneheuvel,26-09-11
2006,15ZL00,303,4,7,11,eneheuvel,26-09-11
2006,15ZL00,304,2,2,4,eneheuvel,26-09-11
2006,15ZL00,305,58,43,101,eneheuvel,26-09-11
2006,15ZL00,306,9,15,24,eneheuvel,26-09-11
2006,15ZL00,307,1,8,9,eneheuvel,26-09-11
2006,15ZL00,308,4,3,7,eneheuvel,26-09-11
2006,15ZL00,309,7,8,15,eneheuvel,26-09-11
2006,15ZL00,311,3,0,3,eneheuvel,26-09-11
2006,15ZL00,313,0,2,2,eneheuvel,26-09-11
2006,15ZL00,9999,0,2,2,eneheuvel,26-09-11
2006,15ZL01,201,0,1,1,eneheuvel,26-09-11
2006,15ZL01,206,1,3,4,eneheuvel,26-09-11
2006,15ZL01,207,0,1,1,eneheuvel,26-09-11
2006,15ZL01,209,10,3,13,eneheuvel,26-09-11
2006,15ZL01,210,73,72,145,eneheuvel,26-09-11
2006,15ZL01,212,1,6,7,eneheuvel,26-09-11
2006,15ZL01,213,1,0,1,eneheuvel,26-09-11
2006,15ZL01,214,1,0,1,eneheuvel,26-09-11
2006,15ZL01,215,2,7,9,eneheuvel,26-09-11
2006,15ZL01,303,1,0,1,eneheuvel,26-09-11
2006,16CK00,102,0,2,2,eneheuvel,26-09-11
2006,16CK00,103,0,2,2,eneheuvel,26-09-11
2006,16CK00,104,0,1,1,eneheuvel,26-09-11
2006,16CK00,106,0,1,1,eneheuvel,26-09-11
2006,16CK00,201,1,0,1,eneheuvel,26-09-11
2006,16CK00,202,5,8,13,eneheuvel,26-09-11
2006,16CK00,203,3,2,5,eneheuvel,26-09-11
2006,16CK00,204,1,1,2,eneheuvel,26-09-11
2006,16CK00,205,1,1,2,eneheuvel,26-09-11
2006,16CK00,206,0,2,2,eneheuvel,26-09-11
2006,16CK00,207,0,2,2,eneheuvel,26-09-11
2006,16CK00,208,3,1,4,eneheuvel,26-09-11
2006,16CK00,209,1,1,2,eneheuvel,26-09-11
2006,16CK00,210,2,2,4,eneheuvel,26-09-11
2006,16CK00,211,4,5,9,eneheuvel,26-09-11
2006,16CK00,212,0,3,3,eneheuvel,26-09-11
2006,16CK00,213,2,0,2,eneheuvel,26-09-11
2006,16CK00,214,2,4,6,eneheuvel,26-09-11
2006,16CK00,216,0,1,1,eneheuvel,26-09-11
2006,16CK00,302,2,1,3,eneheuvel,26-09-11
2006,16CK00,303,0,3,3,eneheuvel,26-09-11
2006,16CK00,304,3,2,5,eneheuvel,26-09-11
2006,16CK00,305,4,2,6,eneheuvel,26-09-11
2006,16CK00,306,2,3,5,eneheuvel,26-09-11
2006,16CK00,307,0,2,2,eneheuvel,26-09-11
2006,16CK00,308,0,1,1,eneheuvel,26-09-11
2006,16CK00,309,2,6,8,eneheuvel,26-09-11
2006,16CK00,311,2,3,5,eneheuvel,26-09-11
2006,16CK00,312,0,1,1,eneheuvel,26-09-11
2006,16CK00,9999,0,1,1,eneheuvel,26-09-11
2006,16KK00,101,24,10,34,eneheuvel,26-09-11
2006,16KK00,102,44,50,94,eneheuvel,26-09-11
2006,16KK00,103,56,48,104,eneheuvel,26-09-11
2006,16KK00,104,2,3,5,eneheuvel,26-09-11
2006,16KK00,105,2,3,5,eneheuvel,26-09-11
2006,16KK00,106,5,5,10,eneheuvel,26-09-11
2006,16KK00,107,15,14,29,eneheuvel,26-09-11
2006,16KK00,108,24,31,55,eneheuvel,26-09-11
2006,16KK00,109,21,14,35,eneheuvel,26-09-11
2006,16KK00,202,2,0,2,eneheuvel,26-09-11
2006,16KK00,203,1,1,2,eneheuvel,26-09-11
2006,16KK00,204,2,1,3,eneheuvel,26-09-11
2006,16KK00,206,2,0,2,eneheuvel,26-09-11
2006,16KK00,207,3,0,3,eneheuvel,26-09-11
2006,16KK00,208,2,0,2,eneheuvel,26-09-11
2006,16KK00,210,4,0,4,eneheuvel,26-09-11
2006,16KK00,211,3,1,4,eneheuvel,26-09-11
2006,16KK00,212,1,1,2,eneheuvel,26-09-11
2006,16KK00,213,3,1,4,eneheuvel,26-09-11
2006,16KK00,214,2,3,5,eneheuvel,26-09-11
2006,16KK00,303,1,0,1,eneheuvel,26-09-11
2006,16KK00,309,1,0,1,eneheuvel,26-09-11
2006,16KK00,311,0,2,2,eneheuvel,26-09-11
2006,16KK00,502,2,2,4,eneheuvel,26-09-11
2006,16KK00,9999,3,0,3,eneheuvel,26-09-11
2006,16LJ00,101,3,3,6,eneheuvel,26-09-11
2006,16LJ00,102,3,4,7,eneheuvel,26-09-11
2006,16LJ00,103,1,1,2,eneheuvel,26-09-11
2006,16LJ00,104,2,4,6,eneheuvel,26-09-11
2006,16LJ00,105,2,1,3,eneheuvel,26-09-11
2006,16LJ00,106,60,37,97,eneheuvel,26-09-11
2006,16LJ00,107,6,5,11,eneheuvel,26-09-11
2006,16LJ00,108,2,6,8,eneheuvel,26-09-11
2006,16LJ00,109,2,0,2,eneheuvel,26-09-11
2006,16LJ00,201,0,1,1,eneheuvel,26-09-11
2006,16LJ00,202,1,1,2,eneheuvel,26-09-11
2006,16LJ00,203,3,0,3,eneheuvel,26-09-11
2006,16LJ00,205,0,1,1,eneheuvel,26-09-11
2006,16LJ00,206,0,1,1,eneheuvel,26-09-11
2006,16LJ00,208,1,1,2,eneheuvel,26-09-11
2006,16LJ00,209,0,2,2,eneheuvel,26-09-11
2006,16LJ00,211,0,3,3,eneheuvel,26-09-11
2006,16LJ00,213,1,0,1,eneheuvel,26-09-11
2006,16LJ00,214,1,0,1,eneheuvel,26-09-11
2006,16LJ00,304,0,1,1,eneheuvel,26-09-11
2006,16LJ00,305,0,1,1,eneheuvel,26-09-11
2006,16LJ00,9999,0,1,1,eneheuvel,26-09-11
2006,16ML00,101,4,10,14,eneheuvel,26-09-11
2006,16ML00,102,25,19,44,eneheuvel,26-09-11
2006,16ML00,103,1,0,1,eneheuvel,26-09-11
2006,16ML00,104,55,68,123,eneheuvel,26-09-11
2006,16ML00,105,28,28,56,eneheuvel,26-09-11
2006,16ML00,106,2,4,6,eneheuvel,26-09-11
2006,16ML00,107,1,2,3,eneheuvel,26-09-11
2006,16ML00,108,1,4,5,eneheuvel,26-09-11
2006,16ML00,109,3,4,7,eneheuvel,26-09-11
2006,16ML00,110,0,2,2,eneheuvel,26-09-11
2006,16ML00,203,1,1,2,eneheuvel,26-09-11
2006,16ML00,205,1,0,1,eneheuvel,26-09-11
2006,16ML00,210,0,1,1,eneheuvel,26-09-11
2006,16ML00,211,1,2,3,eneheuvel,26-09-11
2006,16ML00,212,2,1,3,eneheuvel,26-09-11
2006,16ML00,214,2,1,3,eneheuvel,26-09-11
2006,16ML00,302,0,1,1,eneheuvel,26-09-11
2006,16ML00,303,1,1,2,eneheuvel,26-09-11
2006,16ML00,309,0,1,1,eneheuvel,26-09-11
2006,16ML00,502,2,0,2,eneheuvel,26-09-11
2006,16ML00,9999,2,1,3,eneheuvel,26-09-11
2006,16OC00,101,1,0,1,eneheuvel,26-09-11
2006,16OC00,102,2,2,4,eneheuvel,26-09-11
2006,16OC00,103,4,6,10,eneheuvel,26-09-11
2006,16OC00,104,0,1,1,eneheuvel,26-09-11
2006,16OC00,105,0,1,1,eneheuvel,26-09-11
2006,16OC00,106,1,1,2,eneheuvel,26-09-11
2006,16OC00,107,61,74,135,eneheuvel,26-09-11
2006,16OC00,108,19,17,36,eneheuvel,26-09-11
2006,16OC00,109,49,45,94,eneheuvel,26-09-11
2006,16OC00,201,0,1,1,eneheuvel,26-09-11
2006,16OC00,203,0,1,1,eneheuvel,26-09-11
2006,16OC00,204,0,1,1,eneheuvel,26-09-11
2006,16OC00,207,1,1,2,eneheuvel,26-09-11
2006,16OC00,208,0,2,2,eneheuvel,26-09-11
2006,16OC00,211,1,4,5,eneheuvel,26-09-11
2006,16OC00,214,1,1,2,eneheuvel,26-09-11
2006,16OC00,302,1,1,2,eneheuvel,26-09-11
2006,16OC00,304,1,1,2,eneheuvel,26-09-11
2006,16OC00,307,0,1,1,eneheuvel,26-09-11
2006,16OC00,309,1,1,2,eneheuvel,26-09-11
2006,16OC00,311,0,2,2,eneheuvel,26-09-11
2006,16UK00,101,0,1,1,eneheuvel,26-09-11
2006,16UK00,102,0,1,1,eneheuvel,26-09-11
2006,16UK00,103,3,8,11,eneheuvel,26-09-11
2006,16UK00,106,0,1,1,eneheuvel,26-09-11
2006,16UK00,108,75,77,152,eneheuvel,26-09-11
2006,16UK00,109,1,2,3,eneheuvel,26-09-11
2006,16UK00,210,1,0,1,eneheuvel,26-09-11
2006,16UK00,212,1,2,3,eneheuvel,26-09-11
2006,16UK00,306,0,1,1,eneheuvel,26-09-11
2006,16UK00,311,1,0,1,eneheuvel,26-09-11
2006,16UK00,9999,4,0,4,eneheuvel,26-09-11
2006,16WV00,201,2,4,6,eneheuvel,26-09-11
2006,16WV00,202,0,1,1,eneheuvel,26-09-11
2006,16WV00,209,21,20,41,eneheuvel,26-09-11
2006,16WV00,210,1,3,4,eneheuvel,26-09-11
2006,16WV00,211,59,52,111,eneheuvel,26-09-11
2006,16WV00,214,1,0,1,eneheuvel,26-09-11
2006,16WV00,216,0,1,1,eneheuvel,26-09-11
2006,16WV00,9999,3,1,4,eneheuvel,26-09-11
2006,16YS00,108,0,1,1,eneheuvel,26-09-11
2006,16YS00,201,16,5,21,eneheuvel,26-09-11
2006,16YS00,208,0,1,1,eneheuvel,26-09-11
2006,16YS00,210,1,0,1,eneheuvel,26-09-11
2006,16YS00,211,87,66,153,eneheuvel,26-09-11
2006,16YS00,212,0,2,2,eneheuvel,26-09-11
2006,16YS00,213,1,0,1,eneheuvel,26-09-11
2006,16YS00,309,1,0,1,eneheuvel,26-09-11
2006,16YS00,312,1,0,1,eneheuvel,26-09-11
2006,16YS00,9999,1,0,1,eneheuvel,26-09-11
2006,16ZG00,102,1,1,2,eneheuvel,26-09-11
2006,16ZG00,202,1,1,2,eneheuvel,26-09-11
2006,16ZG00,204,0,1,1,eneheuvel,26-09-11
2006,16ZG00,206,0,1,1,eneheuvel,26-09-11
2006,16ZG00,208,1,0,1,eneheuvel,26-09-11
2006,16ZG00,210,1,0,1,eneheuvel,26-09-11
2006,16ZG00,211,78,78,156,eneheuvel,26-09-11
2006,16ZG00,212,4,1,5,eneheuvel,26-09-11
2006,16ZG00,214,2,3,5,eneheuvel,26-09-11
2006,16ZG00,308,1,0,1,eneheuvel,26-09-11
2006,16ZG00,309,0,1,1,eneheuvel,26-09-11
2006,16ZX00,201,1,1,2,eneheuvel,26-09-11
2006,16ZX00,203,1,2,3,eneheuvel,26-09-11
2006,16ZX00,204,1,0,1,eneheuvel,26-09-11
2006,16ZX00,206,20,35,55,eneheuvel,26-09-11
2006,16ZX00,209,39,38,77,eneheuvel,26-09-11
2006,16ZX00,210,0,2,2,eneheuvel,26-09-11
2006,16ZX00,211,0,1,1,eneheuvel,26-09-11
2006,16ZX00,304,1,0,1,eneheuvel,26-09-11
2006,16ZX00,305,1,0,1,eneheuvel,26-09-11
2006,16ZX00,9999,1,1,2,eneheuvel,26-09-11
2006,17AK00,202,0,1,1,eneheuvel,26-09-11
2006,17AK00,203,0,3,3,eneheuvel,26-09-11
2006,17AK00,205,2,2,4,eneheuvel,26-09-11
2006,17AK00,206,56,55,111,eneheuvel,26-09-11
2006,17AK00,209,2,0,2,eneheuvel,26-09-11
2006,17AK00,210,3,2,5,eneheuvel,26-09-11
2006,17AK00,212,0,1,1,eneheuvel,26-09-11
2006,17AK00,215,2,2,4,eneheuvel,26-09-11
2006,17AK00,301,1,0,1,eneheuvel,26-09-11
2006,17AK00,302,1,1,2,eneheuvel,26-09-11
2006,17AK00,304,1,1,2,eneheuvel,26-09-11
2006,17AK00,305,3,4,7,eneheuvel,26-09-11
2006,17AK00,306,1,0,1,eneheuvel,26-09-11
2006,17AK00,307,1,1,2,eneheuvel,26-09-11
2006,17AK00,309,1,2,3,eneheuvel,26-09-11
2006,17AK00,312,1,0,1,eneheuvel,26-09-11
2006,17AK00,9999,1,0,1,eneheuvel,26-09-11
2006,17AV00,204,0,2,2,eneheuvel,26-09-11
2006,17AV00,205,1,0,1,eneheuvel,26-09-11
2006,17AV00,206,69,80,149,eneheuvel,26-09-11
2006,17AV00,207,0,1,1,eneheuvel,26-09-11
2006,17AV00,208,0,1,1,eneheuvel,26-09-11
2006,17AV00,209,2,2,4,eneheuvel,26-09-11
2006,17AV00,210,0,3,3,eneheuvel,26-09-11
2006,17AV00,211,0,1,1,eneheuvel,26-09-11
2006,17AV00,302,1,0,1,eneheuvel,26-09-11
2006,17AV00,305,1,0,1,eneheuvel,26-09-11
2006,17AV00,312,0,1,1,eneheuvel,26-09-11
2006,17AV00,9999,2,0,2,eneheuvel,26-09-11
2006,17BP00,201,0,2,2,eneheuvel,26-09-11
2006,17BP00,203,2,0,2,eneheuvel,26-09-11
2006,17BP00,208,1,2,3,eneheuvel,26-09-11
2006,17BP00,211,49,73,122,eneheuvel,26-09-11
2006,17BP00,212,4,4,8,eneheuvel,26-09-11
2006,17BP00,213,77,94,171,eneheuvel,26-09-11
2006,17BP00,214,0,11,11,eneheuvel,26-09-11
2006,17BP00,303,0,1,1,eneheuvel,26-09-11
2006,17BP00,312,1,0,1,eneheuvel,26-09-11
2006,17DA00,102,0,2,2,eneheuvel,26-09-11
2006,17DA00,201,1,0,1,eneheuvel,26-09-11
2006,17DA00,209,17,4,21,eneheuvel,26-09-11
2006,17DA00,210,55,52,107,eneheuvel,26-09-11
2006,17DA00,211,0,2,2,eneheuvel,26-09-11
2006,17DA00,215,0,1,1,eneheuvel,26-09-11
2006,17DA00,302,2,1,3,eneheuvel,26-09-11
2006,17DA00,307,1,1,2,eneheuvel,26-09-11
2006,17DA00,309,1,0,1,eneheuvel,26-09-11
2006,17DK00,206,1,0,1,eneheuvel,26-09-11
2006,17DK00,207,1,0,1,eneheuvel,26-09-11
2006,17DK00,301,4,8,12,eneheuvel,26-09-11
2006,17DK00,302,1,0,1,eneheuvel,26-09-11
2006,17DK00,303,1,3,4,eneheuvel,26-09-11
2006,17DK00,304,25,46,71,eneheuvel,26-09-11
2006,17DK00,305,1,1,2,eneheuvel,26-09-11
2006,17DK00,306,0,2,2,eneheuvel,26-09-11
2006,17DK00,309,3,1,4,eneheuvel,26-09-11
2006,17DK00,311,0,1,1,eneheuvel,26-09-11
2006,17DV00,106,0,1,1,eneheuvel,26-09-11
2006,17DV00,108,1,0,1,eneheuvel,26-09-11
2006,17DV00,202,1,0,1,eneheuvel,26-09-11
2006,17DV00,203,0,1,1,eneheuvel,26-09-11
2006,17DV00,204,2,3,5,eneheuvel,26-09-11
2006,17DV00,207,0,1,1,eneheuvel,26-09-11
2006,17DV00,208,1,2,3,eneheuvel,26-09-11
2006,17DV00,209,1,1,2,eneheuvel,26-09-11
2006,17DV00,211,1,2,3,eneheuvel,26-09-11
2006,17DV00,301,12,8,20,eneheuvel,26-09-11
2006,17DV00,302,3,5,8,eneheuvel,26-09-11
2006,17DV00,303,29,26,55,eneheuvel,26-09-11
2006,17DV00,304,46,36,82,eneheuvel,26-09-11
2006,17DV00,305,7,10,17,eneheuvel,26-09-11
2006,17DV00,306,11,9,20,eneheuvel,26-09-11
2006,17DV00,307,11,11,22,eneheuvel,26-09-11
2006,17DV00,308,13,8,21,eneheuvel,26-09-11
2006,17DV00,309,16,14,30,eneheuvel,26-09-11
2006,17DV00,310,1,0,1,eneheuvel,26-09-11
2006,17DV00,311,6,2,8,eneheuvel,26-09-11
2006,17DV00,312,0,1,1,eneheuvel,26-09-11
2006,17DV00,502,1,1,2,eneheuvel,26-09-11
2006,17DV00,9999,1,0,1,eneheuvel,26-09-11
2006,17FI00,101,1,1,2,eneheuvel,26-09-11
2006,17FI00,102,1,2,3,eneheuvel,26-09-11
2006,17FI00,103,4,7,11,eneheuvel,26-09-11
2006,17FI00,105,0,1,1,eneheuvel,26-09-11
2006,17FI00,106,4,2,6,eneheuvel,26-09-11
2006,17FI00,107,0,2,2,eneheuvel,26-09-11
2006,17FI00,108,4,2,6,eneheuvel,26-09-11
2006,17FI00,109,0,1,1,eneheuvel,26-09-11
2006,17FI00,201,3,0,3,eneheuvel,26-09-11
2006,17FI00,202,8,20,28,eneheuvel,26-09-11
2006,17FI00,203,11,7,18,eneheuvel,26-09-11
2006,17FI00,204,1,7,8,eneheuvel,26-09-11
2006,17FI00,205,1,5,6,eneheuvel,26-09-11
2006,17FI00,206,4,11,15,eneheuvel,26-09-11
2006,17FI00,207,8,2,10,eneheuvel,26-09-11
2006,17FI00,208,6,11,17,eneheuvel,26-09-11
2006,17FI00,209,1,2,3,eneheuvel,26-09-11
2006,17FI00,210,5,9,14,eneheuvel,26-09-11
2006,17FI00,211,1,4,5,eneheuvel,26-09-11
2006,17FI00,212,5,7,12,eneheuvel,26-09-11
2006,17FI00,213,6,5,11,eneheuvel,26-09-11
2006,17FI00,214,3,7,10,eneheuvel,26-09-11
2006,17FI00,216,1,1,2,eneheuvel,26-09-11
2006,17FI00,302,3,5,8,eneheuvel,26-09-11
2006,17FI00,303,5,2,7,eneheuvel,26-09-11
2006,17FI00,304,4,4,8,eneheuvel,26-09-11
2006,17FI00,305,7,9,16,eneheuvel,26-09-11
2006,17FI00,306,3,4,7,eneheuvel,26-09-11
2006,17FI00,307,5,5,10,eneheuvel,26-09-11
2006,17FI00,308,1,3,4,eneheuvel,26-09-11
2006,17FI00,309,7,6,13,eneheuvel,26-09-11
2006,17FI00,310,0,1,1,eneheuvel,26-09-11
2006,17FI00,311,2,3,5,eneheuvel,26-09-11
2006,17FI00,312,2,1,3,eneheuvel,26-09-11
2006,17FI00,502,1,1,2,eneheuvel,26-09-11
2006,17FI00,9999,2,2,4,eneheuvel,26-09-11
2006,17LP00,202,0,2,2,eneheuvel,26-09-11
2006,17LP00,207,3,2,5,eneheuvel,26-09-11
2006,17LP00,211,1,0,1,eneheuvel,26-09-11
2006,17LP00,302,1,0,1,eneheuvel,26-09-11
2006,17LP00,304,5,0,5,eneheuvel,26-09-11
2006,17LP00,305,49,55,104,eneheuvel,26-09-11
2006,17LP00,306,3,4,7,eneheuvel,26-09-11
2006,17LP00,307,0,2,2,eneheuvel,26-09-11
2006,17LP00,308,1,1,2,eneheuvel,26-09-11
2006,17LP00,309,1,0,1,eneheuvel,26-09-11
2006,17LP00,9999,5,3,8,eneheuvel,26-09-11
2006,17MH00,202,2,0,2,eneheuvel,26-09-11
2006,17MH00,207,0,1,1,eneheuvel,26-09-11
2006,17MH00,210,2,1,3,eneheuvel,26-09-11
2006,17MH00,212,1,0,1,eneheuvel,26-09-11
2006,17MH00,216,1,0,1,eneheuvel,26-09-11
2006,17MH00,302,1,4,5,eneheuvel,26-09-11
2006,17MH00,303,0,1,1,eneheuvel,26-09-11
2006,17MH00,304,0,2,2,eneheuvel,26-09-11
2006,17MH00,305,70,73,143,eneheuvel,26-09-11
2006,17MH00,306,6,0,6,eneheuvel,26-09-11
2006,17MH00,307,0,1,1,eneheuvel,26-09-11
2006,17MH00,311,0,1,1,eneheuvel,26-09-11
2006,21KO00,106,0,1,1,eneheuvel,26-09-11
2006,21KO00,202,1,1,2,eneheuvel,26-09-11
2006,21KO00,209,2,5,7,eneheuvel,26-09-11
2006,21KO00,210,87,116,203,eneheuvel,26-09-11
2006,21KO00,211,2,0,2,eneheuvel,26-09-11
2006,21KO00,212,0,3,3,eneheuvel,26-09-11
2006,21KO00,216,1,3,4,eneheuvel,26-09-11
2006,21KO00,309,0,2,2,eneheuvel,26-09-11
2006,21KO00,9999,0,1,1,eneheuvel,26-09-11
2006,21NC00,103,1,0,1,eneheuvel,26-09-11
2006,21NC00,208,0,1,1,eneheuvel,26-09-11
2006,21NC00,211,3,0,3,eneheuvel,26-09-11
2006,21NC00,212,3,2,5,eneheuvel,26-09-11
2006,21NC00,213,48,52,100,eneheuvel,26-09-11
2006,21NC00,214,3,1,4,eneheuvel,26-09-11
2006,21NC00,215,0,2,2,eneheuvel,26-09-11
2006,21NC00,302,1,0,1,eneheuvel,26-09-11
2006,21NC00,303,1,0,1,eneheuvel,26-09-11
2006,21NC00,305,1,0,1,eneheuvel,26-09-11
2006,21NC00,308,0,1,1,eneheuvel,26-09-11
2006,21NC00,309,1,0,1,eneheuvel,26-09-11
2006,21NC00,9999,0,1,1,eneheuvel,26-09-11
2006,21ND00,201,0,1,1,eneheuvel,26-09-11
2006,21ND00,209,1,0,1,eneheuvel,26-09-11
2006,21ND00,210,0,2,2,eneheuvel,26-09-11
2006,21ND00,211,8,6,14,eneheuvel,26-09-11
2006,21ND00,212,4,3,7,eneheuvel,26-09-11
2006,21ND00,213,90,112,202,eneheuvel,26-09-11
2006,21ND00,214,0,5,5,eneheuvel,26-09-11
2006,21ND00,302,0,1,1,eneheuvel,26-09-11
2006,21ND00,304,0,1,1,eneheuvel,26-09-11
2006,21ND00,312,3,0,3,eneheuvel,26-09-11
2006,21ND00,9999,1,1,2,eneheuvel,26-09-11
2006,22KP00,203,1,0,1,eneheuvel,26-09-11
2006,22KP00,207,0,2,2,eneheuvel,26-09-11
2006,22KP00,208,0,2,2,eneheuvel,26-09-11
2006,22KP00,211,0,1,1,eneheuvel,26-09-11
2006,22KP00,301,3,3,6,eneheuvel,26-09-11
2006,22KP00,302,5,4,9,eneheuvel,26-09-11
2006,22KP00,303,3,5,8,eneheuvel,26-09-11
2006,22KP00,304,1,1,2,eneheuvel,26-09-11
2006,22KP00,306,1,2,3,eneheuvel,26-09-11
2006,22KP00,308,3,5,8,eneheuvel,26-09-11
2006,22KP00,309,151,154,305,eneheuvel,26-09-11
2006,22KP00,310,2,3,5,eneheuvel,26-09-11
2006,22KP00,311,13,20,33,eneheuvel,26-09-11
2006,22KP00,312,1,2,3,eneheuvel,26-09-11
2006,22KP00,313,0,1,1,eneheuvel,26-09-11
2006,22KP00,9999,1,0,1,eneheuvel,26-09-11
2006,22KQ00,105,0,1,1,eneheuvel,26-09-11
2006,22KQ00,202,0,1,1,eneheuvel,26-09-11
2006,22KQ00,205,1,1,2,eneheuvel,26-09-11
2006,22KQ00,206,1,0,1,eneheuvel,26-09-11
2006,22KQ00,208,1,0,1,eneheuvel,26-09-11
2006,22KQ00,209,1,1,2,eneheuvel,26-09-11
2006,22KQ00,210,91,111,202,eneheuvel,26-09-11
2006,22KQ00,211,1,1,2,eneheuvel,26-09-11
2006,22KQ00,212,0,2,2,eneheuvel,26-09-11
2006,22KQ00,213,0,1,1,eneheuvel,26-09-11
2006,22KQ00,214,1,1,2,eneheuvel,26-09-11
2006,22KQ00,215,0,1,1,eneheuvel,26-09-11
2006,22KQ00,216,1,1,2,eneheuvel,26-09-11
2006,22KQ00,307,1,0,1,eneheuvel,26-09-11
2006,22KQ00,312,3,1,4,eneheuvel,26-09-11
2006,22KQ00,9999,0,1,1,eneheuvel,26-09-11
2006,23EP00,201,1,1,2,eneheuvel,26-09-11
2006,23EP00,202,1,2,3,eneheuvel,26-09-11
2006,23EP00,205,0,1,1,eneheuvel,26-09-11
2006,23EP00,209,2,1,3,eneheuvel,26-09-11
2006,23EP00,211,1,0,1,eneheuvel,26-09-11
2006,23EP00,212,31,60,91,eneheuvel,26-09-11
2006,23EP00,213,5,9,14,eneheuvel,26-09-11
2006,23EP00,214,1,3,4,eneheuvel,26-09-11
2006,23EP00,9999,1,0,1,eneheuvel,26-09-11
2006,23ER00,101,1,1,2,eneheuvel,26-09-11
2006,23ER00,202,1,0,1,eneheuvel,26-09-11
2006,23ER00,208,1,0,1,eneheuvel,26-09-11
2006,23ER00,210,0,1,1,eneheuvel,26-09-11
2006,23ER00,211,0,2,2,eneheuvel,26-09-11
2006,23ER00,212,105,106,211,eneheuvel,26-09-11
2006,23ER00,213,0,3,3,eneheuvel,26-09-11
2006,23ER00,214,4,2,6,eneheuvel,26-09-11
2006,23ET00,107,0,2,2,eneheuvel,26-09-11
2006,23ET00,201,1,0,1,eneheuvel,26-09-11
2006,23ET00,202,0,2,2,eneheuvel,26-09-11
2006,23ET00,203,1,0,1,eneheuvel,26-09-11
2006,23ET00,206,0,1,1,eneheuvel,26-09-11
2006,23ET00,208,1,0,1,eneheuvel,26-09-11
2006,23ET00,210,0,1,1,eneheuvel,26-09-11
2006,23ET00,211,2,2,4,eneheuvel,26-09-11
2006,23ET00,212,2,0,2,eneheuvel,26-09-11
2006,23ET00,214,1,0,1,eneheuvel,26-09-11
2006,23ET00,302,2,2,4,eneheuvel,26-09-11
2006,23ET00,303,2,2,4,eneheuvel,26-09-11
2006,23ET00,304,0,1,1,eneheuvel,26-09-11
2006,23ET00,305,0,1,1,eneheuvel,26-09-11
2006,23ET00,306,2,6,8,eneheuvel,26-09-11
2006,23ET00,307,10,11,21,eneheuvel,26-09-11
2006,23ET00,308,71,103,174,eneheuvel,26-09-11
2006,23ET00,309,11,3,14,eneheuvel,26-09-11
2006,23ET00,311,2,3,5,eneheuvel,26-09-11
2006,23ET00,312,2,1,3,eneheuvel,26-09-11
2006,23ET00,502,0,1,1,eneheuvel,26-09-11
2006,23EU00,102,0,1,1,eneheuvel,26-09-11
2006,23EU00,107,1,0,1,eneheuvel,26-09-11
2006,23EU00,207,2,1,3,eneheuvel,26-09-11
2006,23EU00,208,0,2,2,eneheuvel,26-09-11
2006,23EU00,301,1,2,3,eneheuvel,26-09-11
2006,23EU00,303,2,0,2,eneheuvel,26-09-11
2006,23EU00,305,6,8,14,eneheuvel,26-09-11
2006,23EU00,306,111,125,236,eneheuvel,26-09-11
2006,23EU00,307,8,5,13,eneheuvel,26-09-11
2006,23EU00,309,2,4,6,eneheuvel,26-09-11
2006,23EU00,310,1,0,1,eneheuvel,26-09-11
2006,23EU00,311,0,1,1,eneheuvel,26-09-11
2006,23EU00,313,0,2,2,eneheuvel,26-09-11
2006,23EU00,9999,2,0,2,eneheuvel,26-09-11
2006,23EV00,102,0,1,1,eneheuvel,26-09-11
2006,23EV00,201,1,0,1,eneheuvel,26-09-11
2006,23EV00,203,2,0,2,eneheuvel,26-09-11
2006,23EV00,207,1,1,2,eneheuvel,26-09-11
2006,23EV00,208,0,1,1,eneheuvel,26-09-11
2006,23EV00,209,2,1,3,eneheuvel,26-09-11
2006,23EV00,210,16,8,24,eneheuvel,26-09-11
2006,23EV00,211,10,9,19,eneheuvel,26-09-11
2006,23EV00,212,133,141,274,eneheuvel,26-09-11
2006,23EV00,213,22,36,58,eneheuvel,26-09-11
2006,23EV00,214,4,7,11,eneheuvel,26-09-11
2006,23EV00,215,1,1,2,eneheuvel,26-09-11
2006,23EV00,216,2,3,5,eneheuvel,26-09-11
2006,23EV00,303,1,0,1,eneheuvel,26-09-11
2006,23EV00,306,0,1,1,eneheuvel,26-09-11
2006,23EV00,307,2,0,2,eneheuvel,26-09-11
2006,23EV00,309,1,0,1,eneheuvel,26-09-11
2006,23EV00,9999,1,0,1,eneheuvel,26-09-11
2006,23EY00,102,1,0,1,eneheuvel,26-09-11
2006,23EY00,201,2,0,2,eneheuvel,26-09-11
2006,23EY00,204,1,0,1,eneheuvel,26-09-11
2006,23EY00,206,1,1,2,eneheuvel,26-09-11
2006,23EY00,207,1,2,3,eneheuvel,26-09-11
2006,23EY00,208,2,1,3,eneheuvel,26-09-11
2006,23EY00,209,0,1,1,eneheuvel,26-09-11
2006,23EY00,210,11,2,13,eneheuvel,26-09-11
2006,23EY00,211,9,4,13,eneheuvel,26-09-11
2006,23EY00,212,130,126,256,eneheuvel,26-09-11
2006,23EY00,213,28,19,47,eneheuvel,26-09-11
2006,23EY00,214,2,6,8,eneheuvel,26-09-11
2006,23EY00,215,1,0,1,eneheuvel,26-09-11
2006,23EY00,216,0,1,1,eneheuvel,26-09-11
2006,23EY00,312,0,1,1,eneheuvel,26-09-11
2006,23EY00,502,0,1,1,eneheuvel,26-09-11
2006,23EY00,9999,1,1,2,eneheuvel,26-09-11
2006,23ZU00,201,2,2,4,eneheuvel,26-09-11
2006,23ZU00,202,88,94,182,eneheuvel,26-09-11
2006,23ZU00,203,5,6,11,eneheuvel,26-09-11
2006,23ZU00,204,45,56,101,eneheuvel,26-09-11
2006,23ZU00,205,103,90,193,eneheuvel,26-09-11
2006,23ZU00,206,1,2,3,eneheuvel,26-09-11
2006,23ZU00,207,21,14,35,eneheuvel,26-09-11
2006,23ZU00,208,17,22,39,eneheuvel,26-09-11
2006,23ZU00,209,0,1,1,eneheuvel,26-09-11
2006,23ZU00,210,1,0,1,eneheuvel,26-09-11
2006,23ZU00,211,2,5,7,eneheuvel,26-09-11
2006,23ZU00,212,0,2,2,eneheuvel,26-09-11
2006,23ZU00,214,1,0,1,eneheuvel,26-09-11
2006,23ZU00,215,2,1,3,eneheuvel,26-09-11
2006,23ZU00,302,3,1,4,eneheuvel,26-09-11
2006,23ZU00,303,1,4,5,eneheuvel,26-09-11
2006,23ZU00,306,2,2,4,eneheuvel,26-09-11
2006,23ZU00,307,0,1,1,eneheuvel,26-09-11
2006,23ZU00,309,1,1,2,eneheuvel,26-09-11
2006,23ZU00,310,0,1,1,eneheuvel,26-09-11
2006,23ZU00,311,0,1,1,eneheuvel,26-09-11
2006,23ZU00,502,1,4,5,eneheuvel,26-09-11
2006,23ZU00,9999,1,3,4,eneheuvel,26-09-11
2006,23ZV00,107,1,0,1,eneheuvel,26-09-11
2006,23ZV00,110,0,1,1,eneheuvel,26-09-11
2006,23ZV00,201,2,1,3,eneheuvel,26-09-11
2006,23ZV00,202,42,46,88,eneheuvel,26-09-11
2006,23ZV00,203,5,8,13,eneheuvel,26-09-11
2006,23ZV00,204,23,43,66,eneheuvel,26-09-11
2006,23ZV00,205,53,76,129,eneheuvel,26-09-11
2006,23ZV00,206,0,1,1,eneheuvel,26-09-11
2006,23ZV00,207,8,13,21,eneheuvel,26-09-11
2006,23ZV00,208,6,10,16,eneheuvel,26-09-11
2006,23ZV00,210,1,0,1,eneheuvel,26-09-11
2006,23ZV00,211,1,0,1,eneheuvel,26-09-11
2006,23ZV00,214,1,0,1,eneheuvel,26-09-11
2006,23ZV00,216,1,0,1,eneheuvel,26-09-11
2006,23ZV00,303,1,1,2,eneheuvel,26-09-11
2006,23ZV00,305,0,1,1,eneheuvel,26-09-11
2006,23ZV00,308,1,0,1,eneheuvel,26-09-11
2006,23ZV00,9999,1,0,1,eneheuvel,26-09-11
2006,23ZW00,206,0,1,1,eneheuvel,26-09-11
2006,23ZW00,207,1,0,1,eneheuvel,26-09-11
2006,23ZW00,208,3,5,8,eneheuvel,26-09-11
2006,23ZW00,210,0,1,1,eneheuvel,26-09-11
2006,23ZW00,301,1,0,1,eneheuvel,26-09-11
2006,23ZW00,302,4,3,7,eneheuvel,26-09-11
2006,23ZW00,303,5,9,14,eneheuvel,26-09-11
2006,23ZW00,304,4,0,4,eneheuvel,26-09-11
2006,23ZW00,305,2,0,2,eneheuvel,26-09-11
2006,23ZW00,306,31,35,66,eneheuvel,26-09-11
2006,23ZW00,307,82,73,155,eneheuvel,26-09-11
2006,23ZW00,308,103,95,198,eneheuvel,26-09-11
2006,23ZW00,309,5,3,8,eneheuvel,26-09-11
2006,23ZW00,310,2,0,2,eneheuvel,26-09-11
2006,23ZW00,312,2,1,3,eneheuvel,26-09-11
2006,23ZW00,313,0,2,2,eneheuvel,26-09-11
2006,23ZW00,502,1,3,4,eneheuvel,26-09-11
2006,23ZW00,9999,2,2,4,eneheuvel,26-09-11
2006,23ZX00,103,0,1,1,eneheuvel,26-09-11
2006,23ZX00,105,0,1,1,eneheuvel,26-09-11
2006,23ZX00,106,1,0,1,eneheuvel,26-09-11
2006,23ZX00,110,1,1,2,eneheuvel,26-09-11
2006,23ZX00,201,7,3,10,eneheuvel,26-09-11
2006,23ZX00,202,141,129,270,eneheuvel,26-09-11
2006,23ZX00,204,3,5,8,eneheuvel,26-09-11
2006,23ZX00,205,1,2,3,eneheuvel,26-09-11
2006,23ZX00,206,0,1,1,eneheuvel,26-09-11
2006,23ZX00,207,2,2,4,eneheuvel,26-09-11
2006,23ZX00,208,3,4,7,eneheuvel,26-09-11
2006,23ZX00,209,2,1,3,eneheuvel,26-09-11
2006,23ZX00,211,2,3,5,eneheuvel,26-09-11
2006,23ZX00,311,1,0,1,eneheuvel,26-09-11
2006,23ZY00,109,0,2,2,eneheuvel,26-09-11
2006,23ZY00,210,2,2,4,eneheuvel,26-09-11
2006,23ZY00,211,2,3,5,eneheuvel,26-09-11
2006,23ZY00,212,173,236,409,eneheuvel,26-09-11
2006,23ZY00,213,0,1,1,eneheuvel,26-09-11
2006,23ZY00,214,1,1,2,eneheuvel,26-09-11
2006,23ZY00,216,0,1,1,eneheuvel,26-09-11
2006,23ZY00,302,0,1,1,eneheuvel,26-09-11
2006,23ZY00,305,0,1,1,eneheuvel,26-09-11
2006,23ZY00,9999,1,0,1,eneheuvel,26-09-11
2006,24EJ00,102,4,5,9,eneheuvel,26-09-11
2006,24EJ00,103,4,6,10,eneheuvel,26-09-11
2006,24EJ00,106,2,2,4,eneheuvel,26-09-11
2006,24EJ00,107,3,0,3,eneheuvel,26-09-11
2006,24EJ00,202,6,5,11,eneheuvel,26-09-11
2006,24EJ00,203,2,2,4,eneheuvel,26-09-11
2006,24EJ00,204,8,5,13,eneheuvel,26-09-11
2006,24EJ00,205,0,2,2,eneheuvel,26-09-11
2006,24EJ00,206,1,5,6,eneheuvel,26-09-11
2006,24EJ00,207,3,5,8,eneheuvel,26-09-11
2006,24EJ00,208,7,6,13,eneheuvel,26-09-11
2006,24EJ00,209,16,9,25,eneheuvel,26-09-11
2006,24EJ00,210,24,9,33,eneheuvel,26-09-11
2006,24EJ00,211,30,20,50,eneheuvel,26-09-11
2006,24EJ00,212,13,8,21,eneheuvel,26-09-11
2006,24EJ00,213,7,5,12,eneheuvel,26-09-11
2006,24EJ00,214,4,6,10,eneheuvel,26-09-11
2006,24EJ00,302,2,2,4,eneheuvel,26-09-11
2006,24EJ00,303,2,2,4,eneheuvel,26-09-11
2006,24EJ00,304,1,2,3,eneheuvel,26-09-11
2006,24EJ00,305,0,3,3,eneheuvel,26-09-11
2006,24EJ00,306,0,1,1,eneheuvel,26-09-11
2006,24EJ00,307,3,0,3,eneheuvel,26-09-11
2006,24EJ00,308,1,1,2,eneheuvel,26-09-11
2006,24EJ00,309,1,1,2,eneheuvel,26-09-11
2006,24EJ00,311,1,0,1,eneheuvel,26-09-11
2006,24EJ00,312,1,2,3,eneheuvel,26-09-11
2006,24EJ00,9999,6,1,7,eneheuvel,26-09-11
2006,24FT00,102,1,1,2,eneheuvel,26-09-11
2006,24FT00,103,0,1,1,eneheuvel,26-09-11
2006,24FT00,105,0,4,4,eneheuvel,26-09-11
2006,24FT00,106,1,1,2,eneheuvel,26-09-11
2006,24FT00,110,0,1,1,eneheuvel,26-09-11
2006,24FT00,202,1,6,7,eneheuvel,26-09-11
2006,24FT00,203,0,2,2,eneheuvel,26-09-11
2006,24FT00,204,1,7,8,eneheuvel,26-09-11
2006,24FT00,205,1,5,6,eneheuvel,26-09-11
2006,24FT00,206,0,8,8,eneheuvel,26-09-11
2006,24FT00,207,0,2,2,eneheuvel,26-09-11
2006,24FT00,208,2,9,11,eneheuvel,26-09-11
2006,24FT00,209,2,1,3,eneheuvel,26-09-11
2006,24FT00,210,0,4,4,eneheuvel,26-09-11
2006,24FT00,211,5,10,15,eneheuvel,26-09-11
2006,24FT00,212,4,11,15,eneheuvel,26-09-11
2006,24FT00,213,2,8,10,eneheuvel,26-09-11
2006,24FT00,214,6,12,18,eneheuvel,26-09-11
2006,24FT00,216,0,1,1,eneheuvel,26-09-11
2006,24FT00,302,1,10,11,eneheuvel,26-09-11
2006,24FT00,303,1,11,12,eneheuvel,26-09-11
2006,24FT00,304,0,3,3,eneheuvel,26-09-11
2006,24FT00,305,1,1,2,eneheuvel,26-09-11
2006,24FT00,306,0,1,1,eneheuvel,26-09-11
2006,24FT00,307,0,3,3,eneheuvel,26-09-11
2006,24FT00,308,1,15,16,eneheuvel,26-09-11
2006,24FT00,309,1,7,8,eneheuvel,26-09-11
2006,24FT00,311,0,12,12,eneheuvel,26-09-11
2006,24FT00,312,1,8,9,eneheuvel,26-09-11
2006,24FT00,502,0,2,2,eneheuvel,26-09-11
2006,24FT00,9999,5,0,5,eneheuvel,26-09-11
2006,24MR00,201,2,1,3,eneheuvel,26-09-11
2006,24MR00,207,1,1,2,eneheuvel,26-09-11
2006,24MR00,208,1,4,5,eneheuvel,26-09-11
2006,24MR00,209,0,1,1,eneheuvel,26-09-11
2006,24MR00,210,1,0,1,eneheuvel,26-09-11
2006,24MR00,213,2,0,2,eneheuvel,26-09-11
2006,24MR00,301,1,0,1,eneheuvel,26-09-11
2006,24MR00,302,0,1,1,eneheuvel,26-09-11
2006,24MR00,303,0,1,1,eneheuvel,26-09-11
2006,24MR00,304,1,1,2,eneheuvel,26-09-11
2006,24MR00,305,1,2,3,eneheuvel,26-09-11
2006,24MR00,306,16,20,36,eneheuvel,26-09-11
2006,24MR00,307,141,180,321,eneheuvel,26-09-11
2006,24MR00,308,5,15,20,eneheuvel,26-09-11
2006,24MR00,310,0,1,1,eneheuvel,26-09-11
2006,24MR00,311,0,2,2,eneheuvel,26-09-11
2006,24MR00,312,0,1,1,eneheuvel,26-09-11
2006,24MR00,502,1,1,2,eneheuvel,26-09-11
2006,24MR00,9999,1,0,1,eneheuvel,26-09-11
2006,24RK00,108,0,1,1,eneheuvel,26-09-11
2006,24RK00,202,23,16,39,eneheuvel,26-09-11
2006,24RK00,203,12,15,27,eneheuvel,26-09-11
2006,24RK00,204,16,13,29,eneheuvel,26-09-11
2006,24RK00,205,6,8,14,eneheuvel,26-09-11
2006,24RK00,206,2,2,4,eneheuvel,26-09-11
2006,24RK00,207,9,3,12,eneheuvel,26-09-11
2006,24RK00,208,4,5,9,eneheuvel,26-09-11
2006,24RK00,210,0,3,3,eneheuvel,26-09-11
2006,24RK00,212,1,3,4,eneheuvel,26-09-11
2006,24RK00,213,2,1,3,eneheuvel,26-09-11
2006,24RK00,214,3,1,4,eneheuvel,26-09-11
2006,24RK00,216,1,1,2,eneheuvel,26-09-11
2006,24RK00,301,1,1,2,eneheuvel,26-09-11
2006,24RK00,302,7,1,8,eneheuvel,26-09-11
2006,24RK00,303,7,3,10,eneheuvel,26-09-11
2006,24RK00,304,3,4,7,eneheuvel,26-09-11
2006,24RK00,305,0,5,5,eneheuvel,26-09-11
2006,24RK00,306,5,4,9,eneheuvel,26-09-11
2006,24RK00,307,4,3,7,eneheuvel,26-09-11
2006,24RK00,308,3,4,7,eneheuvel,26-09-11
2006,24RK00,309,3,1,4,eneheuvel,26-09-11
2006,24UN00,201,1,0,1,eneheuvel,26-09-11
2006,24UN00,202,1,0,1,eneheuvel,26-09-11
2006,24UN00,208,0,2,2,eneheuvel,26-09-11
2006,24UN00,214,1,0,1,eneheuvel,26-09-11
2006,24UN00,216,0,1,1,eneheuvel,26-09-11
2006,24UN00,302,0,1,1,eneheuvel,26-09-11
2006,24UN00,303,3,2,5,eneheuvel,26-09-11
2006,24UN00,306,30,27,57,eneheuvel,26-09-11
2006,24UN00,307,64,29,93,eneheuvel,26-09-11
2006,24UN00,308,56,68,124,eneheuvel,26-09-11
2006,24UN00,309,23,19,42,eneheuvel,26-09-11
2006,24UN00,310,0,2,2,eneheuvel,26-09-11
2006,24UN00,311,5,2,7,eneheuvel,26-09-11
2006,24UN00,502,0,1,1,eneheuvel,26-09-11
2006,24UN00,9999,3,0,3,eneheuvel,26-09-11
2006,25CF00,202,7,5,12,eneheuvel,26-09-11
2006,25CF00,203,6,10,16,eneheuvel,26-09-11
2006,25CF00,204,71,100,171,eneheuvel,26-09-11
2006,25CF00,205,39,54,93,eneheuvel,26-09-11
2006,25CF00,206,1,0,1,eneheuvel,26-09-11
2006,25CF00,207,4,5,9,eneheuvel,26-09-11
2006,25CF00,208,4,7,11,eneheuvel,26-09-11
2006,25CF00,209,0,3,3,eneheuvel,26-09-11
2006,25CF00,210,2,0,2,eneheuvel,26-09-11
2006,25CF00,302,0,1,1,eneheuvel,26-09-11
2006,25CF00,303,0,2,2,eneheuvel,26-09-11
2006,25CF00,307,0,1,1,eneheuvel,26-09-11
2006,25CF00,308,0,2,2,eneheuvel,26-09-11
2006,25CF00,9999,4,2,6,eneheuvel,26-09-11
2006,25KT00,107,0,1,1,eneheuvel,26-09-11
2006,25KT00,202,52,55,107,eneheuvel,26-09-11
2006,25KT00,203,101,56,157,eneheuvel,26-09-11
2006,25KT00,204,85,88,173,eneheuvel,26-09-11
2006,25KT00,205,9,7,16,eneheuvel,26-09-11
2006,25KT00,207,16,2,18,eneheuvel,26-09-11
2006,25KT00,208,44,22,66,eneheuvel,26-09-11
2006,25KT00,211,1,0,1,eneheuvel,26-09-11
2006,25KT00,212,0,1,1,eneheuvel,26-09-11
2006,25KT00,306,1,0,1,eneheuvel,26-09-11
2006,25KT00,312,0,1,1,eneheuvel,26-09-11
2006,25KT00,502,14,9,23,eneheuvel,26-09-11
2006,25KT00,9999,2,0,2,eneheuvel,26-09-11
2006,25KU00,110,2,0,2,eneheuvel,26-09-11
2006,25KU00,201,0,1,1,eneheuvel,26-09-11
2006,25KU00,202,31,30,61,eneheuvel,26-09-11
2006,25KU00,203,65,38,103,eneheuvel,26-09-11
2006,25KU00,204,84,77,161,eneheuvel,26-09-11
2006,25KU00,205,3,0,3,eneheuvel,26-09-11
2006,25KU00,206,1,0,1,eneheuvel,26-09-11
2006,25KU00,207,13,5,18,eneheuvel,26-09-11
2006,25KU00,208,32,28,60,eneheuvel,26-09-11
2006,25KU00,210,1,0,1,eneheuvel,26-09-11
2006,25KU00,216,1,0,1,eneheuvel,26-09-11
2006,25KU00,309,1,0,1,eneheuvel,26-09-11
2006,25KU00,502,7,13,20,eneheuvel,26-09-11
2006,25KU00,9999,1,0,1,eneheuvel,26-09-11
2006,25KV00,201,0,1,1,eneheuvel,26-09-11
2006,25KV00,202,1,6,7,eneheuvel,26-09-11
2006,25KV00,203,205,179,384,eneheuvel,26-09-11
2006,25KV00,204,9,11,20,eneheuvel,26-09-11
2006,25KV00,205,1,2,3,eneheuvel,26-09-11
2006,25KV00,208,7,10,17,eneheuvel,26-09-11
2006,25KV00,211,2,2,4,eneheuvel,26-09-11
2006,25KV00,212,0,1,1,eneheuvel,26-09-11
2006,25KV00,302,0,1,1,eneheuvel,26-09-11
2006,25KV00,309,0,1,1,eneheuvel,26-09-11
2006,25KV00,312,0,1,1,eneheuvel,26-09-11
2006,25KV00,9999,4,0,4,eneheuvel,26-09-11
2006,26AB00,103,1,0,1,eneheuvel,26-09-11
2006,26AB00,206,0,1,1,eneheuvel,26-09-11
2006,26AB00,207,1,0,1,eneheuvel,26-09-11
2006,26AB00,208,0,1,1,eneheuvel,26-09-11
2006,26AB00,209,1,0,1,eneheuvel,26-09-11
2006,26AB00,301,0,1,1,eneheuvel,26-09-11
2006,26AB00,302,16,16,32,eneheuvel,26-09-11
2006,26AB00,303,201,194,395,eneheuvel,26-09-11
2006,26AB00,304,5,2,7,eneheuvel,26-09-11
2006,26AB00,305,1,1,2,eneheuvel,26-09-11
2006,26AB00,306,3,1,4,eneheuvel,26-09-11
2006,26AB00,308,1,1,2,eneheuvel,26-09-11
2006,26AB00,309,3,1,4,eneheuvel,26-09-11
2006,26AB00,310,1,0,1,eneheuvel,26-09-11
2006,26AB00,311,5,4,9,eneheuvel,26-09-11
2006,26AB00,312,0,1,1,eneheuvel,26-09-11
2006,26AB00,313,3,3,6,eneheuvel,26-09-11
2006,26AB00,9999,2,2,4,eneheuvel,26-09-11
2006,26AC00,101,0,1,1,eneheuvel,26-09-11
2006,26AC00,102,1,0,1,eneheuvel,26-09-11
2006,26AC00,107,1,2,3,eneheuvel,26-09-11
2006,26AC00,109,20,6,26,eneheuvel,26-09-11
2006,26AC00,201,0,1,1,eneheuvel,26-09-11
2006,26AC00,202,1,0,1,eneheuvel,26-09-11
2006,26AC00,203,0,1,1,eneheuvel,26-09-11
2006,26AC00,204,1,0,1,eneheuvel,26-09-11
2006,26AC00,206,2,0,2,eneheuvel,26-09-11
2006,26AC00,208,0,1,1,eneheuvel,26-09-11
2006,26AC00,209,1,0,1,eneheuvel,26-09-11
2006,26AC00,211,6,5,11,eneheuvel,26-09-11
2006,26AC00,212,15,19,34,eneheuvel,26-09-11
2006,26AC00,213,16,24,40,eneheuvel,26-09-11
2006,26AC00,214,490,329,819,eneheuvel,26-09-11
2006,26AC00,215,1,0,1,eneheuvel,26-09-11
2006,26AC00,301,1,0,1,eneheuvel,26-09-11
2006,26AC00,302,2,0,2,eneheuvel,26-09-11
2006,26AC00,305,1,0,1,eneheuvel,26-09-11
2006,26AC00,306,3,0,3,eneheuvel,26-09-11
2006,26AC00,307,4,0,4,eneheuvel,26-09-11
2006,26AC00,308,0,1,1,eneheuvel,26-09-11
2006,26AC00,311,2,2,4,eneheuvel,26-09-11
2006,26AC00,312,2,2,4,eneheuvel,26-09-11
2006,26AC00,9999,2,0,2,eneheuvel,26-09-11
2006,26AD00,108,1,0,1,eneheuvel,26-09-11
2006,26AD00,203,0,1,1,eneheuvel,26-09-11
2006,26AD00,205,0,1,1,eneheuvel,26-09-11
2006,26AD00,207,0,1,1,eneheuvel,26-09-11
2006,26AD00,208,1,0,1,eneheuvel,26-09-11
2006,26AD00,214,1,0,1,eneheuvel,26-09-11
2006,26AD00,301,0,1,1,eneheuvel,26-09-11
2006,26AD00,302,97,73,170,eneheuvel,26-09-11
2006,26AD00,303,37,21,58,eneheuvel,26-09-11
2006,26AD00,305,3,1,4,eneheuvel,26-09-11
2006,26AD00,306,3,1,4,eneheuvel,26-09-11
2006,26AD00,307,0,2,2,eneheuvel,26-09-11
2006,26AD00,308,1,0,1,eneheuvel,26-09-11
2006,26AD00,309,65,38,103,eneheuvel,26-09-11
2006,26AD00,310,14,5,19,eneheuvel,26-09-11
2006,26AD00,311,52,40,92,eneheuvel,26-09-11
2006,26AD00,312,8,2,10,eneheuvel,26-09-11
2006,26AD00,313,6,6,12,eneheuvel,26-09-11
2006,26AD00,502,1,2,3,eneheuvel,26-09-11
2006,26AD00,9999,1,1,2,eneheuvel,26-09-11
2006,26PD00,104,1,0,1,eneheuvel,26-09-11
2006,26PD00,203,1,1,2,eneheuvel,26-09-11
2006,26PD00,204,1,1,2,eneheuvel,26-09-11
2006,26PD00,205,5,6,11,eneheuvel,26-09-11
2006,26PD00,207,178,221,399,eneheuvel,26-09-11
2006,26PD00,208,43,77,120,eneheuvel,26-09-11
2006,26PD00,210,1,0,1,eneheuvel,26-09-11
2006,26PD00,211,1,0,1,eneheuvel,26-09-11
2006,26PD00,212,0,3,3,eneheuvel,26-09-11
2006,26PD00,302,1,0,1,eneheuvel,26-09-11
2006,26PD00,306,0,2,2,eneheuvel,26-09-11
2006,26PD00,502,2,1,3,eneheuvel,26-09-11
2006,26PD00,9999,4,0,4,eneheuvel,26-09-11
2006,26PE00,201,1,0,1,eneheuvel,26-09-11
2006,26PE00,205,0,1,1,eneheuvel,26-09-11
2006,26PE00,210,1,0,1,eneheuvel,26-09-11
2006,26PE00,211,1,1,2,eneheuvel,26-09-11
2006,26PE00,213,1,0,1,eneheuvel,26-09-11
2006,26PE00,301,1,0,1,eneheuvel,26-09-11
2006,26PE00,302,263,240,503,eneheuvel,26-09-11
2006,26PE00,303,17,12,29,eneheuvel,26-09-11
2006,26PE00,304,0,1,1,eneheuvel,26-09-11
2006,26PE00,306,2,1,3,eneheuvel,26-09-11
2006,26PE00,307,0,1,1,eneheuvel,26-09-11
2006,26PE00,308,0,1,1,eneheuvel,26-09-11
2006,26PE00,309,2,1,3,eneheuvel,26-09-11
2006,26PE00,310,0,1,1,eneheuvel,26-09-11
2006,26PE00,311,2,7,9,eneheuvel,26-09-11
2006,26PE00,312,1,2,3,eneheuvel,26-09-11
2006,26PE00,9999,4,0,4,eneheuvel,26-09-11
2006,26PF00,102,0,1,1,eneheuvel,26-09-11
2006,26PF00,201,1,0,1,eneheuvel,26-09-11
2006,26PF00,202,1,2,3,eneheuvel,26-09-11
2006,26PF00,206,2,0,2,eneheuvel,26-09-11
2006,26PF00,207,0,1,1,eneheuvel,26-09-11
2006,26PF00,208,3,1,4,eneheuvel,26-09-11
2006,26PF00,209,1,1,2,eneheuvel,26-09-11
2006,26PF00,211,5,2,7,eneheuvel,26-09-11
2006,26PF00,212,5,5,10,eneheuvel,26-09-11
2006,26PF00,213,0,5,5,eneheuvel,26-09-11
2006,26PF00,214,203,183,386,eneheuvel,26-09-11
2006,26PF00,216,0,1,1,eneheuvel,26-09-11
2006,26PF00,302,0,1,1,eneheuvel,26-09-11
2006,26PF00,303,1,2,3,eneheuvel,26-09-11
2006,26PF00,308,1,0,1,eneheuvel,26-09-11
2006,26PF00,309,1,0,1,eneheuvel,26-09-11
2006,26PF00,311,1,0,1,eneheuvel,26-09-11
2006,26PF00,312,0,1,1,eneheuvel,26-09-11
2006,26PF00,9999,4,0,4,eneheuvel,26-09-11
2006,26PG00,108,1,0,1,eneheuvel,26-09-11
2006,26PG00,207,1,0,1,eneheuvel,26-09-11
2006,26PG00,209,0,1,1,eneheuvel,26-09-11
2006,26PG00,210,1,0,1,eneheuvel,26-09-11
2006,26PG00,211,0,1,1,eneheuvel,26-09-11
2006,26PG00,212,0,4,4,eneheuvel,26-09-11
2006,26PG00,213,1,0,1,eneheuvel,26-09-11
2006,26PG00,214,76,108,184,eneheuvel,26-09-11
2006,26PG00,304,0,1,1,eneheuvel,26-09-11
2006,26PG00,9999,4,0,4,eneheuvel,26-09-11
2006,26PH00,206,1,0,1,eneheuvel,26-09-11
2006,26PH00,208,1,0,1,eneheuvel,26-09-11
2006,26PH00,209,1,0,1,eneheuvel,26-09-11
2006,26PH00,211,1,0,1,eneheuvel,26-09-11
2006,26PH00,216,0,1,1,eneheuvel,26-09-11
2006,26PH00,302,28,9,37,eneheuvel,26-09-11
2006,26PH00,303,12,6,18,eneheuvel,26-09-11
2006,26PH00,305,2,1,3,eneheuvel,26-09-11
2006,26PH00,306,1,0,1,eneheuvel,26-09-11
2006,26PH00,307,2,1,3,eneheuvel,26-09-11
2006,26PH00,308,3,0,3,eneheuvel,26-09-11
2006,26PH00,309,46,19,65,eneheuvel,26-09-11
2006,26PH00,311,271,178,449,eneheuvel,26-09-11
2006,26PH00,312,13,6,19,eneheuvel,26-09-11
2006,26PH00,313,6,3,9,eneheuvel,26-09-11
2006,26PH00,9999,2,0,2,eneheuvel,26-09-11
2006,26PW00,208,3,0,3,eneheuvel,26-09-11
2006,26PW00,302,52,33,85,eneheuvel,26-09-11
2006,26PW00,303,40,16,56,eneheuvel,26-09-11
2006,26PW00,305,0,1,1,eneheuvel,26-09-11
2006,26PW00,307,1,1,2,eneheuvel,26-09-11
2006,26PW00,308,4,1,5,eneheuvel,26-09-11
2006,26PW00,309,41,21,62,eneheuvel,26-09-11
2006,26PW00,310,8,3,11,eneheuvel,26-09-11
2006,26PW00,311,28,26,54,eneheuvel,26-09-11
2006,26PW00,312,4,2,6,eneheuvel,26-09-11
2006,26PW00,313,6,1,7,eneheuvel,26-09-11
2006,26PW00,9999,2,0,2,eneheuvel,26-09-11
2006,26ZZ00,103,0,1,1,eneheuvel,26-09-11
2006,26ZZ00,105,1,0,1,eneheuvel,26-09-11
2006,26ZZ00,202,239,212,451,eneheuvel,26-09-11
2006,26ZZ00,203,15,6,21,eneheuvel,26-09-11
2006,26ZZ00,204,3,2,5,eneheuvel,26-09-11
2006,26ZZ00,205,1,0,1,eneheuvel,26-09-11
2006,26ZZ00,206,2,0,2,eneheuvel,26-09-11
2006,26ZZ00,208,3,5,8,eneheuvel,26-09-11
2006,26ZZ00,209,1,1,2,eneheuvel,26-09-11
2006,26ZZ00,210,3,1,4,eneheuvel,26-09-11
2006,26ZZ00,211,0,1,1,eneheuvel,26-09-11
2006,26ZZ00,214,1,2,3,eneheuvel,26-09-11
2006,26ZZ00,308,0,1,1,eneheuvel,26-09-11
2006,26ZZ00,309,0,1,1,eneheuvel,26-09-11
2006,26ZZ00,311,0,1,1,eneheuvel,26-09-11
2006,26ZZ00,312,1,0,1,eneheuvel,26-09-11
2006,26ZZ00,502,1,1,2,eneheuvel,26-09-11
2006,26ZZ00,9999,3,0,3,eneheuvel,26-09-11
2006,27AA00,106,0,1,1,eneheuvel,26-09-11
2006,27AA00,201,1,0,1,eneheuvel,26-09-11
2006,27AA00,202,1,1,2,eneheuvel,26-09-11
2006,27AA00,203,6,1,7,eneheuvel,26-09-11
2006,27AA00,204,15,6,21,eneheuvel,26-09-11
2006,27AA00,205,7,3,10,eneheuvel,26-09-11
2006,27AA00,206,1,0,1,eneheuvel,26-09-11
2006,27AA00,207,73,50,123,eneheuvel,26-09-11
2006,27AA00,208,173,149,322,eneheuvel,26-09-11
2006,27AA00,209,0,1,1,eneheuvel,26-09-11
2006,27AA00,210,2,0,2,eneheuvel,26-09-11
2006,27AA00,211,0,1,1,eneheuvel,26-09-11
2006,27AA00,212,0,2,2,eneheuvel,26-09-11
2006,27AA00,214,3,1,4,eneheuvel,26-09-11
2006,27AA00,303,1,0,1,eneheuvel,26-09-11
2006,27AA00,305,0,2,2,eneheuvel,26-09-11
2006,27AA00,306,0,1,1,eneheuvel,26-09-11
2006,27AA00,307,3,0,3,eneheuvel,26-09-11
2006,27AA00,308,2,1,3,eneheuvel,26-09-11
2006,27AA00,312,1,1,2,eneheuvel,26-09-11
2006,27AA00,9999,2,0,2,eneheuvel,26-09-11
2006,27NU00,108,1,0,1,eneheuvel,26-09-11
2006,27NU00,203,8,3,11,eneheuvel,26-09-11
2006,27NU00,204,1,3,4,eneheuvel,26-09-11
2006,27NU00,205,1,0,1,eneheuvel,26-09-11
2006,27NU00,206,1,0,1,eneheuvel,26-09-11
2006,27NU00,207,18,6,24,eneheuvel,26-09-11
2006,27NU00,208,170,89,259,eneheuvel,26-09-11
2006,27NU00,210,1,0,1,eneheuvel,26-09-11
2006,27NU00,211,1,0,1,eneheuvel,26-09-11
2006,27NU00,303,0,1,1,eneheuvel,26-09-11
2006,27NU00,309,1,0,1,eneheuvel,26-09-11
2006,27NU00,502,1,0,1,eneheuvel,26-09-11
2006,27UB00,201,0,1,1,eneheuvel,26-09-11
2006,27UB00,202,2,0,2,eneheuvel,26-09-11
2006,27UB00,203,3,1,4,eneheuvel,26-09-11
2006,27UB00,204,0,1,1,eneheuvel,26-09-11
2006,27UB00,207,4,0,4,eneheuvel,26-09-11
2006,27UB00,208,141,69,210,eneheuvel,26-09-11
2006,27UB00,211,2,0,2,eneheuvel,26-09-11
2006,27UB00,301,0,1,1,eneheuvel,26-09-11
2006,27UB00,303,1,0,1,eneheuvel,26-09-11
2006,27UB00,305,1,0,1,eneheuvel,26-09-11
2006,27UB00,306,3,1,4,eneheuvel,26-09-11
2006,27UB00,307,1,0,1,eneheuvel,26-09-11
2006,27UB00,309,1,1,2,eneheuvel,26-09-11
2006,27UB00,310,1,0,1,eneheuvel,26-09-11
2006,27UB00,311,1,0,1,eneheuvel,26-09-11
2006,27UB00,502,2,2,4,eneheuvel,26-09-11
2006,27UB00,9999,4,0,4,eneheuvel,26-09-11
2006,27XH00,206,1,2,3,eneheuvel,26-09-11
2006,27XH00,208,1,0,1,eneheuvel,26-09-11
2006,27XH00,209,1,1,2,eneheuvel,26-09-11
2006,27XH00,210,6,1,7,eneheuvel,26-09-11
2006,27XH00,211,1,0,1,eneheuvel,26-09-11
2006,27XH00,212,2,4,6,eneheuvel,26-09-11
2006,27XH00,214,4,0,4,eneheuvel,26-09-11
2006,27XH00,215,10,16,26,eneheuvel,26-09-11
2006,27XH00,216,41,38,79,eneheuvel,26-09-11
2006,27XJ00,201,1,0,1,eneheuvel,26-09-11
2006,27XJ00,206,1,0,1,eneheuvel,26-09-11
2006,27XJ00,216,1,0,1,eneheuvel,26-09-11
2006,27XJ00,302,10,1,11,eneheuvel,26-09-11
2006,27XJ00,303,5,0,5,eneheuvel,26-09-11
2006,27XJ00,305,0,1,1,eneheuvel,26-09-11
2006,27XJ00,306,2,0,2,eneheuvel,26-09-11
2006,27XJ00,307,1,0,1,eneheuvel,26-09-11
2006,27XJ00,308,0,1,1,eneheuvel,26-09-11
2006,27XJ00,309,1,1,2,eneheuvel,26-09-11
2006,27XJ00,310,1,0,1,eneheuvel,26-09-11
2006,27XJ00,311,17,0,17,eneheuvel,26-09-11
2006,27XJ00,312,57,24,81,eneheuvel,26-09-11
2006,27XJ00,313,4,5,9,eneheuvel,26-09-11
2006,27XJ00,502,1,3,4,eneheuvel,26-09-11
2006,27XJ00,9999,2,0,2,eneheuvel,26-09-11
2006,27YN00,109,1,0,1,eneheuvel,26-09-11
2006,27YN00,202,1,1,2,eneheuvel,26-09-11
2006,27YN00,203,0,1,1,eneheuvel,26-09-11
2006,27YN00,206,0,3,3,eneheuvel,26-09-11
2006,27YN00,210,0,2,2,eneheuvel,26-09-11
2006,27YN00,212,0,2,2,eneheuvel,26-09-11
2006,27YN00,215,2,0,2,eneheuvel,26-09-11
2006,27YN00,216,37,38,75,eneheuvel,26-09-11
2006,27YN00,302,1,0,1,eneheuvel,26-09-11
2006,27YN00,308,0,1,1,eneheuvel,26-09-11
2006,27YN00,309,0,3,3,eneheuvel,26-09-11
2006,28AM00,105,1,2,3,eneheuvel,26-09-11
2006,28AM00,106,1,0,1,eneheuvel,26-09-11
2006,28AM00,203,2,0,2,eneheuvel,26-09-11
2006,28AM00,204,0,1,1,eneheuvel,26-09-11
2006,28AM00,208,1,0,1,eneheuvel,26-09-11
2006,28AM00,211,0,2,2,eneheuvel,26-09-11
2006,28AM00,214,1,1,2,eneheuvel,26-09-11
2006,28AM00,302,2,1,3,eneheuvel,26-09-11
2006,28AM00,303,1,0,1,eneheuvel,26-09-11
2006,28AM00,309,2,0,2,eneheuvel,26-09-11
2006,28AM00,311,5,4,9,eneheuvel,26-09-11
2006,28AM00,312,56,53,109,eneheuvel,26-09-11
2006,28AM00,313,4,1,5,eneheuvel,26-09-11
2006,28BR00,201,1,0,1,eneheuvel,26-09-11
2006,28BR00,203,2,0,2,eneheuvel,26-09-11
2006,28BR00,207,0,1,1,eneheuvel,26-09-11
2006,28BR00,208,1,2,3,eneheuvel,26-09-11
2006,28BR00,211,2,3,5,eneheuvel,26-09-11
2006,28BR00,212,3,3,6,eneheuvel,26-09-11
2006,28BR00,213,1,0,1,eneheuvel,26-09-11
2006,28BR00,214,0,2,2,eneheuvel,26-09-11
2006,28BR00,301,1,1,2,eneheuvel,26-09-11
2006,28BR00,302,3,3,6,eneheuvel,26-09-11
2006,28BR00,303,4,1,5,eneheuvel,26-09-11
2006,28BR00,305,1,0,1,eneheuvel,26-09-11
2006,28BR00,306,2,0,2,eneheuvel,26-09-11
2006,28BR00,307,1,0,1,eneheuvel,26-09-11
2006,28BR00,308,1,1,2,eneheuvel,26-09-11
2006,28BR00,309,4,1,5,eneheuvel,26-09-11
2006,28BR00,311,11,5,16,eneheuvel,26-09-11
2006,28BR00,312,1,2,3,eneheuvel,26-09-11
2006,28BR00,9999,2,0,2,eneheuvel,26-09-11
2006,28DJ00,105,1,2,3,eneheuvel,26-09-11
2006,28DJ00,107,1,0,1,eneheuvel,26-09-11
2006,28DJ00,108,2,0,2,eneheuvel,26-09-11
2006,28DJ00,203,6,3,9,eneheuvel,26-09-11
2006,28DJ00,204,2,3,5,eneheuvel,26-09-11
2006,28DJ00,205,1,1,2,eneheuvel,26-09-11
2006,28DJ00,206,1,1,2,eneheuvel,26-09-11
2006,28DJ00,207,5,6,11,eneheuvel,26-09-11
2006,28DJ00,208,6,3,9,eneheuvel,26-09-11
2006,28DJ00,210,1,1,2,eneheuvel,26-09-11
2006,28DJ00,211,3,1,4,eneheuvel,26-09-11
2006,28DJ00,212,2,4,6,eneheuvel,26-09-11
2006,28DJ00,213,1,1,2,eneheuvel,26-09-11
2006,28DJ00,214,1,0,1,eneheuvel,26-09-11
2006,28DJ00,301,1,1,2,eneheuvel,26-09-11
2006,28DJ00,302,0,3,3,eneheuvel,26-09-11
2006,28DJ00,303,1,1,2,eneheuvel,26-09-11
2006,28DJ00,304,0,3,3,eneheuvel,26-09-11
2006,28DJ00,305,6,7,13,eneheuvel,26-09-11
2006,28DJ00,306,3,1,4,eneheuvel,26-09-11
2006,28DJ00,307,6,5,11,eneheuvel,26-09-11
2006,28DJ00,308,2,2,4,eneheuvel,26-09-11
2006,28DJ00,9999,1,0,1,eneheuvel,26-09-11
2007,06RM00,102,1,4,5,eneheuvel,26-09-11
2007,06RM00,103,4,0,4,eneheuvel,26-09-11
2007,06RM00,105,1,1,2,eneheuvel,26-09-11
2007,06RM00,106,2,0,2,eneheuvel,26-09-11
2007,06RM00,109,0,2,2,eneheuvel,26-09-11
2007,06RM00,202,4,9,13,eneheuvel,26-09-11
2007,06RM00,204,2,2,4,eneheuvel,26-09-11
2007,06RM00,206,1,7,8,eneheuvel,26-09-11
2007,06RM00,207,2,2,4,eneheuvel,26-09-11
2007,06RM00,208,1,1,2,eneheuvel,26-09-11
2007,06RM00,210,9,7,16,eneheuvel,26-09-11
2007,06RM00,211,10,6,16,eneheuvel,26-09-11
2007,06RM00,212,23,32,55,eneheuvel,26-09-11
2007,06RM00,213,9,7,16,eneheuvel,26-09-11
2007,06RM00,214,18,15,33,eneheuvel,26-09-11
2007,06RM00,215,2,2,4,eneheuvel,26-09-11
2007,06RM00,216,5,7,12,eneheuvel,26-09-11
2007,06RM00,302,4,4,8,eneheuvel,26-09-11
2007,06RM00,303,6,4,10,eneheuvel,26-09-11
2007,06RM00,304,3,1,4,eneheuvel,26-09-11
2007,06RM00,305,1,0,1,eneheuvel,26-09-11
2007,06RM00,306,2,1,3,eneheuvel,26-09-11
2007,06RM00,307,1,0,1,eneheuvel,26-09-11
2007,06RM00,309,1,3,4,eneheuvel,26-09-11
2007,06RM00,311,4,3,7,eneheuvel,26-09-11
2007,06RM00,312,3,2,5,eneheuvel,26-09-11
2007,06RM00,502,2,4,6,eneheuvel,26-09-11
2007,06RM00,9999,11,13,24,eneheuvel,26-09-11
2007,12HU00,103,1,1,2,eneheuvel,26-09-11
2007,12HU00,201,4,8,12,eneheuvel,26-09-11
2007,12HU00,202,3,1,4,eneheuvel,26-09-11
2007,12HU00,206,0,1,1,eneheuvel,26-09-11
2007,12HU00,209,3,1,4,eneheuvel,26-09-11
2007,12HU00,210,2,1,3,eneheuvel,26-09-11
2007,12HU00,211,53,54,107,eneheuvel,26-09-11
2007,12HU00,212,0,2,2,eneheuvel,26-09-11
2007,12HU00,213,0,2,2,eneheuvel,26-09-11
2007,12HU00,305,1,0,1,eneheuvel,26-09-11
2007,12HU00,9999,0,2,2,eneheuvel,26-09-11
2007,12PM00,101,15,2,17,eneheuvel,26-09-11
2007,12PM00,102,11,6,17,eneheuvel,26-09-11
2007,12PM00,103,37,33,70,eneheuvel,26-09-11
2007,12PM00,104,5,5,10,eneheuvel,26-09-11
2007,12PM00,106,2,4,6,eneheuvel,26-09-11
2007,12PM00,107,25,18,43,eneheuvel,26-09-11
2007,12PM00,108,17,15,32,eneheuvel,26-09-11
2007,12PM00,109,12,14,26,eneheuvel,26-09-11
2007,12PM00,110,0,1,1,eneheuvel,26-09-11
2007,12PM00,202,1,3,4,eneheuvel,26-09-11
2007,12PM00,211,0,1,1,eneheuvel,26-09-11
2007,12PM00,212,0,2,2,eneheuvel,26-09-11
2007,12PM00,214,1,0,1,eneheuvel,26-09-11
2007,12PM00,216,1,1,2,eneheuvel,26-09-11
2007,12PM00,303,1,0,1,eneheuvel,26-09-11
2007,12PM00,306,1,1,2,eneheuvel,26-09-11
2007,12PM00,309,1,0,1,eneheuvel,26-09-11
2007,12PM00,311,3,0,3,eneheuvel,26-09-11
2007,12QK00,104,0,1,1,eneheuvel,26-09-11
2007,12QK00,201,1,0,1,eneheuvel,26-09-11
2007,12QK00,202,2,0,2,eneheuvel,26-09-11
2007,12QK00,205,0,2,2,eneheuvel,26-09-11
2007,12QK00,206,105,105,210,eneheuvel,26-09-11
2007,12QK00,207,2,1,3,eneheuvel,26-09-11
2007,12QK00,208,2,5,7,eneheuvel,26-09-11
2007,12QK00,209,7,3,10,eneheuvel,26-09-11
2007,12QK00,210,9,7,16,eneheuvel,26-09-11
2007,12QK00,211,0,1,1,eneheuvel,26-09-11
2007,12QK00,212,1,0,1,eneheuvel,26-09-11
2007,12QK00,213,0,2,2,eneheuvel,26-09-11
2007,12QK00,214,2,2,4,eneheuvel,26-09-11
2007,12QK00,215,6,11,17,eneheuvel,26-09-11
2007,12QK00,303,0,1,1,eneheuvel,26-09-11
2007,12QK00,307,0,1,1,eneheuvel,26-09-11
2007,12QK00,309,0,1,1,eneheuvel,26-09-11
2007,12QK00,311,1,1,2,eneheuvel,26-09-11
2007,12QK00,312,0,3,3,eneheuvel,26-09-11
2007,12QK00,9999,0,2,2,eneheuvel,26-09-11
2007,12XA00,201,0,1,1,eneheuvel,26-09-11
2007,12XA00,204,0,1,1,eneheuvel,26-09-11
2007,12XA00,207,1,0,1,eneheuvel,26-09-11
2007,12XA00,208,0,1,1,eneheuvel,26-09-11
2007,12XA00,211,64,48,112,eneheuvel,26-09-11
2007,12XA00,213,1,1,2,eneheuvel,26-09-11
2007,12XA00,214,1,1,2,eneheuvel,26-09-11
2007,12XA00,303,1,0,1,eneheuvel,26-09-11
2007,12XA00,309,0,1,1,eneheuvel,26-09-11
2007,12XA00,9999,1,0,1,eneheuvel,26-09-11
2007,13CW00,102,0,1,1,eneheuvel,26-09-11
2007,13CW00,106,0,1,1,eneheuvel,26-09-11
2007,13CW00,201,3,1,4,eneheuvel,26-09-11
2007,13CW00,202,1,1,2,eneheuvel,26-09-11
2007,13CW00,203,1,0,1,eneheuvel,26-09-11
2007,13CW00,205,3,4,7,eneheuvel,26-09-11
2007,13CW00,206,65,61,126,eneheuvel,26-09-11
2007,13CW00,207,2,2,4,eneheuvel,26-09-11
2007,13CW00,208,1,1,2,eneheuvel,26-09-11
2007,13CW00,209,18,2,20,eneheuvel,26-09-11
2007,13CW00,210,8,7,15,eneheuvel,26-09-11
2007,13CW00,211,1,2,3,eneheuvel,26-09-11
2007,13CW00,212,1,0,1,eneheuvel,26-09-11
2007,13CW00,215,0,3,3,eneheuvel,26-09-11
2007,13CW00,216,1,0,1,eneheuvel,26-09-11
2007,13CW00,308,2,0,2,eneheuvel,26-09-11
2007,13IF00,105,0,1,1,eneheuvel,26-09-11
2007,13IF00,207,1,0,1,eneheuvel,26-09-11
2007,13IF00,208,1,1,2,eneheuvel,26-09-11
2007,13IF00,211,0,1,1,eneheuvel,26-09-11
2007,13IF00,301,12,9,21,eneheuvel,26-09-11
2007,13IF00,302,0,2,2,eneheuvel,26-09-11
2007,13IF00,303,10,14,24,eneheuvel,26-09-11
2007,13IF00,304,42,34,76,eneheuvel,26-09-11
2007,13IF00,305,9,11,20,eneheuvel,26-09-11
2007,13IF00,306,7,21,28,eneheuvel,26-09-11
2007,13IF00,307,1,3,4,eneheuvel,26-09-11
2007,13IF00,308,2,2,4,eneheuvel,26-09-11
2007,13IF00,309,1,2,3,eneheuvel,26-09-11
2007,13IF00,310,1,0,1,eneheuvel,26-09-11
2007,13IF00,311,0,1,1,eneheuvel,26-09-11
2007,13IU00,102,12,8,20,eneheuvel,26-09-11
2007,13IU00,103,9,3,12,eneheuvel,26-09-11
2007,13IU00,104,4,0,4,eneheuvel,26-09-11
2007,13IU00,105,1,5,6,eneheuvel,26-09-11
2007,13IU00,106,56,30,86,eneheuvel,26-09-11
2007,13IU00,107,5,3,8,eneheuvel,26-09-11
2007,13IU00,108,2,3,5,eneheuvel,26-09-11
2007,13IU00,109,2,2,4,eneheuvel,26-09-11
2007,13IU00,211,1,1,2,eneheuvel,26-09-11
2007,13IU00,212,1,1,2,eneheuvel,26-09-11
2007,13IU00,311,1,0,1,eneheuvel,26-09-11
2007,13IU00,9999,0,1,1,eneheuvel,26-09-11
2007,13NH00,101,5,2,7,eneheuvel,26-09-11
2007,13NH00,102,9,8,17,eneheuvel,26-09-11
2007,13NH00,103,2,2,4,eneheuvel,26-09-11
2007,13NH00,104,21,26,47,eneheuvel,26-09-11
2007,13NH00,105,64,62,126,eneheuvel,26-09-11
2007,13NH00,106,4,10,14,eneheuvel,26-09-11
2007,13NH00,107,3,3,6,eneheuvel,26-09-11
2007,13NH00,109,0,2,2,eneheuvel,26-09-11
2007,13NH00,110,2,3,5,eneheuvel,26-09-11
2007,13NH00,202,0,1,1,eneheuvel,26-09-11
2007,13NH00,212,1,1,2,eneheuvel,26-09-11
2007,13NH00,213,1,0,1,eneheuvel,26-09-11
2007,13NH00,502,1,0,1,eneheuvel,26-09-11
2007,13NH00,9999,1,0,1,eneheuvel,26-09-11
2007,13NU00,201,1,0,1,eneheuvel,26-09-11
2007,13NU00,202,1,0,1,eneheuvel,26-09-11
2007,13NU00,207,0,1,1,eneheuvel,26-09-11
2007,13NU00,212,1,1,2,eneheuvel,26-09-11
2007,13NU00,214,1,0,1,eneheuvel,26-09-11
2007,13NU00,301,11,6,17,eneheuvel,26-09-11
2007,13NU00,302,1,0,1,eneheuvel,26-09-11
2007,13NU00,303,34,44,78,eneheuvel,26-09-11
2007,13NU00,304,70,61,131,eneheuvel,26-09-11
2007,13NU00,305,15,18,33,eneheuvel,26-09-11
2007,13NU00,306,14,14,28,eneheuvel,26-09-11
2007,13NU00,307,2,3,5,eneheuvel,26-09-11
2007,13NU00,308,4,7,11,eneheuvel,26-09-11
2007,13NU00,309,2,3,5,eneheuvel,26-09-11
2007,13NU00,310,1,1,2,eneheuvel,26-09-11
2007,13NU00,311,0,1,1,eneheuvel,26-09-11
2007,13NU00,312,0,1,1,eneheuvel,26-09-11
2007,13NU00,502,0,1,1,eneheuvel,26-09-11
2007,13NU00,9999,0,1,1,eneheuvel,26-09-11
2007,14QC00,104,0,2,2,eneheuvel,26-09-11
2007,14QC00,109,2,1,3,eneheuvel,26-09-11
2007,14QC00,201,1,0,1,eneheuvel,26-09-11
2007,14QC00,202,53,65,118,eneheuvel,26-09-11
2007,14QC00,203,44,41,85,eneheuvel,26-09-11
2007,14QC00,204,22,29,51,eneheuvel,26-09-11
2007,14QC00,205,18,12,30,eneheuvel,26-09-11
2007,14QC00,206,19,6,25,eneheuvel,26-09-11
2007,14QC00,207,14,7,21,eneheuvel,26-09-11
2007,14QC00,208,20,19,39,eneheuvel,26-09-11
2007,14QC00,210,7,2,9,eneheuvel,26-09-11
2007,14QC00,211,6,1,7,eneheuvel,26-09-11
2007,14QC00,212,2,7,9,eneheuvel,26-09-11
2007,14QC00,213,4,1,5,eneheuvel,26-09-11
2007,14QC00,214,2,5,7,eneheuvel,26-09-11
2007,14QC00,215,1,0,1,eneheuvel,26-09-11
2007,14QC00,216,1,1,2,eneheuvel,26-09-11
2007,14QC00,302,6,3,9,eneheuvel,26-09-11
2007,14QC00,303,9,1,10,eneheuvel,26-09-11
2007,14QC00,304,2,2,4,eneheuvel,26-09-11
2007,14QC00,306,1,0,1,eneheuvel,26-09-11
2007,14QC00,307,2,1,3,eneheuvel,26-09-11
2007,14QC00,309,3,2,5,eneheuvel,26-09-11
2007,14QC00,311,6,2,8,eneheuvel,26-09-11
2007,14QC00,312,3,1,4,eneheuvel,26-09-11
2007,14QC00,313,2,0,2,eneheuvel,26-09-11
2007,14QC00,502,15,11,26,eneheuvel,26-09-11
2007,14QC00,9999,1,3,4,eneheuvel,26-09-11
2007,15SJ00,101,1,3,4,eneheuvel,26-09-11
2007,15SJ00,102,1,3,4,eneheuvel,26-09-11
2007,15SJ00,103,2,8,10,eneheuvel,26-09-11
2007,15SJ00,104,0,3,3,eneheuvel,26-09-11
2007,15SJ00,106,0,4,4,eneheuvel,26-09-11
2007,15SJ00,108,0,4,4,eneheuvel,26-09-11
2007,15SJ00,201,0,3,3,eneheuvel,26-09-11
2007,15SJ00,202,2,7,9,eneheuvel,26-09-11
2007,15SJ00,203,3,7,10,eneheuvel,26-09-11
2007,15SJ00,204,0,12,12,eneheuvel,26-09-11
2007,15SJ00,205,0,6,6,eneheuvel,26-09-11
2007,15SJ00,206,2,20,22,eneheuvel,26-09-11
2007,15SJ00,207,6,10,16,eneheuvel,26-09-11
2007,15SJ00,208,1,12,13,eneheuvel,26-09-11
2007,15SJ00,209,3,6,9,eneheuvel,26-09-11
2007,15SJ00,210,3,18,21,eneheuvel,26-09-11
2007,15SJ00,211,3,18,21,eneheuvel,26-09-11
2007,15SJ00,212,3,15,18,eneheuvel,26-09-11
2007,15SJ00,213,1,6,7,eneheuvel,26-09-11
2007,15SJ00,214,5,9,14,eneheuvel,26-09-11
2007,15SJ00,216,0,1,1,eneheuvel,26-09-11
2007,15SJ00,301,0,4,4,eneheuvel,26-09-11
2007,15SJ00,302,2,10,12,eneheuvel,26-09-11
2007,15SJ00,303,1,9,10,eneheuvel,26-09-11
2007,15SJ00,304,3,8,11,eneheuvel,26-09-11
2007,15SJ00,305,1,4,5,eneheuvel,26-09-11
2007,15SJ00,306,2,8,10,eneheuvel,26-09-11
2007,15SJ00,307,1,10,11,eneheuvel,26-09-11
2007,15SJ00,308,2,2,4,eneheuvel,26-09-11
2007,15SJ00,309,3,5,8,eneheuvel,26-09-11
2007,15SJ00,311,1,4,5,eneheuvel,26-09-11
2007,15SJ00,312,0,2,2,eneheuvel,26-09-11
2007,15SJ00,313,0,1,1,eneheuvel,26-09-11
2007,15SJ00,9999,1,3,4,eneheuvel,26-09-11
2007,15ZL00,103,0,1,1,eneheuvel,26-09-11
2007,15ZL00,107,0,1,1,eneheuvel,26-09-11
2007,15ZL00,108,0,1,1,eneheuvel,26-09-11
2007,15ZL00,203,1,0,1,eneheuvel,26-09-11
2007,15ZL00,204,1,2,3,eneheuvel,26-09-11
2007,15ZL00,205,1,1,2,eneheuvel,26-09-11
2007,15ZL00,206,2,0,2,eneheuvel,26-09-11
2007,15ZL00,207,0,1,1,eneheuvel,26-09-11
2007,15ZL00,208,1,1,2,eneheuvel,26-09-11
2007,15ZL00,210,0,3,3,eneheuvel,26-09-11
2007,15ZL00,214,1,1,2,eneheuvel,26-09-11
2007,15ZL00,302,1,6,7,eneheuvel,26-09-11
2007,15ZL00,303,3,4,7,eneheuvel,26-09-11
2007,15ZL00,304,1,3,4,eneheuvel,26-09-11
2007,15ZL00,305,61,53,114,eneheuvel,26-09-11
2007,15ZL00,306,6,9,15,eneheuvel,26-09-11
2007,15ZL00,307,1,7,8,eneheuvel,26-09-11
2007,15ZL00,308,6,3,9,eneheuvel,26-09-11
2007,15ZL00,309,5,6,11,eneheuvel,26-09-11
2007,15ZL00,311,3,0,3,eneheuvel,26-09-11
2007,15ZL00,313,0,1,1,eneheuvel,26-09-11
2007,15ZL00,9999,1,1,2,eneheuvel,26-09-11
2007,15ZL01,206,1,2,3,eneheuvel,26-09-11
2007,15ZL01,209,6,5,11,eneheuvel,26-09-11
2007,15ZL01,210,75,66,141,eneheuvel,26-09-11
2007,15ZL01,212,0,3,3,eneheuvel,26-09-11
2007,15ZL01,214,0,1,1,eneheuvel,26-09-11
2007,15ZL01,215,1,3,4,eneheuvel,26-09-11
2007,15ZL01,216,0,1,1,eneheuvel,26-09-11
2007,15ZL01,9999,1,0,1,eneheuvel,26-09-11
2007,16KK00,101,16,11,27,eneheuvel,26-09-11
2007,16KK00,102,46,42,88,eneheuvel,26-09-11
2007,16KK00,103,63,53,116,eneheuvel,26-09-11
2007,16KK00,104,2,1,3,eneheuvel,26-09-11
2007,16KK00,105,2,1,3,eneheuvel,26-09-11
2007,16KK00,106,5,5,10,eneheuvel,26-09-11
2007,16KK00,107,17,11,28,eneheuvel,26-09-11
2007,16KK00,108,28,28,56,eneheuvel,26-09-11
2007,16KK00,109,20,15,35,eneheuvel,26-09-11
2007,16KK00,201,0,1,1,eneheuvel,26-09-11
2007,16KK00,202,2,0,2,eneheuvel,26-09-11
2007,16KK00,203,0,1,1,eneheuvel,26-09-11
2007,16KK00,204,1,1,2,eneheuvel,26-09-11
2007,16KK00,206,0,1,1,eneheuvel,26-09-11
2007,16KK00,207,2,1,3,eneheuvel,26-09-11
2007,16KK00,208,0,1,1,eneheuvel,26-09-11
2007,16KK00,209,0,1,1,eneheuvel,26-09-11
2007,16KK00,210,3,1,4,eneheuvel,26-09-11
2007,16KK00,211,3,1,4,eneheuvel,26-09-11
2007,16KK00,212,1,1,2,eneheuvel,26-09-11
2007,16KK00,213,3,1,4,eneheuvel,26-09-11
2007,16KK00,214,1,4,5,eneheuvel,26-09-11
2007,16KK00,307,1,0,1,eneheuvel,26-09-11
2007,16KK00,311,0,2,2,eneheuvel,26-09-11
2007,16KK00,502,2,1,3,eneheuvel,26-09-11
2007,16KK00,9999,4,0,4,eneheuvel,26-09-11
2007,16LJ00,101,1,0,1,eneheuvel,26-09-11
2007,16LJ00,102,4,3,7,eneheuvel,26-09-11
2007,16LJ00,104,2,4,6,eneheuvel,26-09-11
2007,16LJ00,105,1,2,3,eneheuvel,26-09-11
2007,16LJ00,106,55,45,100,eneheuvel,26-09-11
2007,16LJ00,107,5,6,11,eneheuvel,26-09-11
2007,16LJ00,108,1,5,6,eneheuvel,26-09-11
2007,16LJ00,109,1,1,2,eneheuvel,26-09-11
2007,16LJ00,202,0,1,1,eneheuvel,26-09-11
2007,16LJ00,203,2,0,2,eneheuvel,26-09-11
2007,16LJ00,208,1,1,2,eneheuvel,26-09-11
2007,16LJ00,209,0,1,1,eneheuvel,26-09-11
2007,16LJ00,210,0,1,1,eneheuvel,26-09-11
2007,16LJ00,214,0,1,1,eneheuvel,26-09-11
2007,16LJ00,216,1,0,1,eneheuvel,26-09-11
2007,16LJ00,302,0,1,1,eneheuvel,26-09-11
2007,16LJ00,306,1,0,1,eneheuvel,26-09-11
2007,16LJ00,307,1,0,1,eneheuvel,26-09-11
2007,16LJ00,308,0,3,3,eneheuvel,26-09-11
2007,16LJ00,309,0,1,1,eneheuvel,26-09-11
2007,16LJ00,311,0,2,2,eneheuvel,26-09-11
2007,16LJ00,312,1,0,1,eneheuvel,26-09-11
2007,16LJ00,9999,2,1,3,eneheuvel,26-09-11
2007,16ML00,101,7,10,17,eneheuvel,26-09-11
2007,16ML00,102,33,18,51,eneheuvel,26-09-11
2007,16ML00,103,2,0,2,eneheuvel,26-09-11
2007,16ML00,104,56,65,121,eneheuvel,26-09-11
2007,16ML00,105,27,25,52,eneheuvel,26-09-11
2007,16ML00,106,3,4,7,eneheuvel,26-09-11
2007,16ML00,107,2,2,4,eneheuvel,26-09-11
2007,16ML00,108,1,5,6,eneheuvel,26-09-11
2007,16ML00,109,3,5,8,eneheuvel,26-09-11
2007,16ML00,110,0,2,2,eneheuvel,26-09-11
2007,16ML00,203,1,3,4,eneheuvel,26-09-11
2007,16ML00,205,0,3,3,eneheuvel,26-09-11
2007,16ML00,209,0,1,1,eneheuvel,26-09-11
2007,16ML00,210,1,2,3,eneheuvel,26-09-11
2007,16ML00,212,2,1,3,eneheuvel,26-09-11
2007,16ML00,213,1,0,1,eneheuvel,26-09-11
2007,16ML00,214,2,0,2,eneheuvel,26-09-11
2007,16ML00,303,1,1,2,eneheuvel,26-09-11
2007,16ML00,306,0,1,1,eneheuvel,26-09-11
2007,16ML00,502,2,2,4,eneheuvel,26-09-11
2007,16ML00,9999,1,0,1,eneheuvel,26-09-11
2007,16OC00,101,1,1,2,eneheuvel,26-09-11
2007,16OC00,102,1,2,3,eneheuvel,26-09-11
2007,16OC00,103,4,7,11,eneheuvel,26-09-11
2007,16OC00,104,2,1,3,eneheuvel,26-09-11
2007,16OC00,105,1,1,2,eneheuvel,26-09-11
2007,16OC00,106,0,1,1,eneheuvel,26-09-11
2007,16OC00,107,63,76,139,eneheuvel,26-09-11
2007,16OC00,108,11,21,32,eneheuvel,26-09-11
2007,16OC00,109,37,47,84,eneheuvel,26-09-11
2007,16OC00,201,1,0,1,eneheuvel,26-09-11
2007,16OC00,203,1,1,2,eneheuvel,26-09-11
2007,16OC00,204,1,0,1,eneheuvel,26-09-11
2007,16OC00,205,1,0,1,eneheuvel,26-09-11
2007,16OC00,208,0,2,2,eneheuvel,26-09-11
2007,16OC00,210,0,2,2,eneheuvel,26-09-11
2007,16OC00,211,0,1,1,eneheuvel,26-09-11
2007,16OC00,212,0,2,2,eneheuvel,26-09-11
2007,16OC00,214,2,3,5,eneheuvel,26-09-11
2007,16OC00,303,0,1,1,eneheuvel,26-09-11
2007,16OC00,308,0,1,1,eneheuvel,26-09-11
2007,16OC00,309,1,1,2,eneheuvel,26-09-11
2007,16UK00,102,0,1,1,eneheuvel,26-09-11
2007,16UK00,103,7,14,21,eneheuvel,26-09-11
2007,16UK00,108,73,75,148,eneheuvel,26-09-11
2007,16UK00,109,1,1,2,eneheuvel,26-09-11
2007,16UK00,210,0,1,1,eneheuvel,26-09-11
2007,16UK00,212,0,1,1,eneheuvel,26-09-11
2007,16UK00,305,1,1,2,eneheuvel,26-09-11
2007,16UK00,306,0,1,1,eneheuvel,26-09-11
2007,16UK00,9999,1,0,1,eneheuvel,26-09-11
2007,16WV00,201,6,2,8,eneheuvel,26-09-11
2007,16WV00,202,1,0,1,eneheuvel,26-09-11
2007,16WV00,207,0,2,2,eneheuvel,26-09-11
2007,16WV00,209,15,19,34,eneheuvel,26-09-11
2007,16WV00,210,1,1,2,eneheuvel,26-09-11
2007,16WV00,211,66,54,120,eneheuvel,26-09-11
2007,16WV00,214,0,1,1,eneheuvel,26-09-11
2007,16WV00,216,0,1,1,eneheuvel,26-09-11
2007,16WV00,301,2,0,2,eneheuvel,26-09-11
2007,16WV00,306,0,2,2,eneheuvel,26-09-11
2007,16WV00,9999,1,1,2,eneheuvel,26-09-11
2007,16YS00,108,0,1,1,eneheuvel,26-09-11
2007,16YS00,201,12,7,19,eneheuvel,26-09-11
2007,16YS00,203,1,0,1,eneheuvel,26-09-11
2007,16YS00,208,0,1,1,eneheuvel,26-09-11
2007,16YS00,209,1,0,1,eneheuvel,26-09-11
2007,16YS00,210,1,0,1,eneheuvel,26-09-11
2007,16YS00,211,94,72,166,eneheuvel,26-09-11
2007,16YS00,212,0,2,2,eneheuvel,26-09-11
2007,16YS00,213,2,0,2,eneheuvel,26-09-11
2007,16YS00,214,1,2,3,eneheuvel,26-09-11
2007,16YS00,309,0,1,1,eneheuvel,26-09-11
2007,16YS00,9999,2,2,4,eneheuvel,26-09-11
2007,16ZG00,102,0,1,1,eneheuvel,26-09-11
2007,16ZG00,202,1,0,1,eneheuvel,26-09-11
2007,16ZG00,206,0,1,1,eneheuvel,26-09-11
2007,16ZG00,211,84,70,154,eneheuvel,26-09-11
2007,16ZG00,212,1,0,1,eneheuvel,26-09-11
2007,16ZG00,213,0,2,2,eneheuvel,26-09-11
2007,16ZG00,214,2,4,6,eneheuvel,26-09-11
2007,16ZG00,308,0,1,1,eneheuvel,26-09-11
2007,16ZG00,309,0,1,1,eneheuvel,26-09-11
2007,16ZX00,201,1,1,2,eneheuvel,26-09-11
2007,16ZX00,203,0,1,1,eneheuvel,26-09-11
2007,16ZX00,206,14,32,46,eneheuvel,26-09-11
2007,16ZX00,209,36,40,76,eneheuvel,26-09-11
2007,16ZX00,210,1,1,2,eneheuvel,26-09-11
2007,16ZX00,211,0,1,1,eneheuvel,26-09-11
2007,16ZX00,308,1,0,1,eneheuvel,26-09-11
2007,16ZX00,9999,1,0,1,eneheuvel,26-09-11
2007,17AK00,202,0,1,1,eneheuvel,26-09-11
2007,17AK00,203,0,2,2,eneheuvel,26-09-11
2007,17AK00,205,1,3,4,eneheuvel,26-09-11
2007,17AK00,206,64,58,122,eneheuvel,26-09-11
2007,17AK00,207,1,0,1,eneheuvel,26-09-11
2007,17AK00,209,5,1,6,eneheuvel,26-09-11
2007,17AK00,210,4,3,7,eneheuvel,26-09-11
2007,17AK00,211,0,1,1,eneheuvel,26-09-11
2007,17AK00,304,1,1,2,eneheuvel,26-09-11
2007,17AK00,305,2,3,5,eneheuvel,26-09-11
2007,17AK00,306,1,0,1,eneheuvel,26-09-11
2007,17AK00,307,0,2,2,eneheuvel,26-09-11
2007,17AK00,309,1,1,2,eneheuvel,26-09-11
2007,17AV00,101,1,0,1,eneheuvel,26-09-11
2007,17AV00,108,0,1,1,eneheuvel,26-09-11
2007,17AV00,204,0,2,2,eneheuvel,26-09-11
2007,17AV00,205,1,0,1,eneheuvel,26-09-11
2007,17AV00,206,65,85,150,eneheuvel,26-09-11
2007,17AV00,207,1,0,1,eneheuvel,26-09-11
2007,17AV00,208,0,1,1,eneheuvel,26-09-11
2007,17AV00,209,3,0,3,eneheuvel,26-09-11
2007,17AV00,210,0,3,3,eneheuvel,26-09-11
2007,17AV00,211,1,0,1,eneheuvel,26-09-11
2007,17AV00,311,1,1,2,eneheuvel,26-09-11
2007,17AV00,9999,0,2,2,eneheuvel,26-09-11
2007,17BP00,201,0,4,4,eneheuvel,26-09-11
2007,17BP00,208,1,2,3,eneheuvel,26-09-11
2007,17BP00,211,52,60,112,eneheuvel,26-09-11
2007,17BP00,212,3,3,6,eneheuvel,26-09-11
2007,17BP00,213,75,81,156,eneheuvel,26-09-11
2007,17BP00,214,3,4,7,eneheuvel,26-09-11
2007,17BP00,309,1,1,2,eneheuvel,26-09-11
2007,17BP00,312,1,0,1,eneheuvel,26-09-11
2007,17DA00,102,0,1,1,eneheuvel,26-09-11
2007,17DA00,202,1,0,1,eneheuvel,26-09-11
2007,17DA00,209,13,9,22,eneheuvel,26-09-11
2007,17DA00,210,55,50,105,eneheuvel,26-09-11
2007,17DA00,302,2,1,3,eneheuvel,26-09-11
2007,17DA00,303,0,1,1,eneheuvel,26-09-11
2007,17DA00,307,1,1,2,eneheuvel,26-09-11
2007,17DK00,201,0,1,1,eneheuvel,26-09-11
2007,17DK00,206,0,1,1,eneheuvel,26-09-11
2007,17DK00,207,1,0,1,eneheuvel,26-09-11
2007,17DK00,208,0,1,1,eneheuvel,26-09-11
2007,17DK00,301,4,6,10,eneheuvel,26-09-11
2007,17DK00,302,1,2,3,eneheuvel,26-09-11
2007,17DK00,303,1,1,2,eneheuvel,26-09-11
2007,17DK00,304,23,47,70,eneheuvel,26-09-11
2007,17DK00,305,1,1,2,eneheuvel,26-09-11
2007,17DK00,306,0,1,1,eneheuvel,26-09-11
2007,17DK00,308,3,0,3,eneheuvel,26-09-11
2007,17DK00,309,2,1,3,eneheuvel,26-09-11
2007,17DV00,106,0,1,1,eneheuvel,26-09-11
2007,17DV00,108,0,1,1,eneheuvel,26-09-11
2007,17DV00,202,0,1,1,eneheuvel,26-09-11
2007,17DV00,203,0,1,1,eneheuvel,26-09-11
2007,17DV00,204,0,2,2,eneheuvel,26-09-11
2007,17DV00,207,1,0,1,eneheuvel,26-09-11
2007,17DV00,209,1,1,2,eneheuvel,26-09-11
2007,17DV00,211,2,1,3,eneheuvel,26-09-11
2007,17DV00,212,0,1,1,eneheuvel,26-09-11
2007,17DV00,214,0,1,1,eneheuvel,26-09-11
2007,17DV00,216,1,2,3,eneheuvel,26-09-11
2007,17DV00,301,15,7,22,eneheuvel,26-09-11
2007,17DV00,302,1,7,8,eneheuvel,26-09-11
2007,17DV00,303,30,27,57,eneheuvel,26-09-11
2007,17DV00,304,39,46,85,eneheuvel,26-09-11
2007,17DV00,305,9,6,15,eneheuvel,26-09-11
2007,17DV00,306,13,10,23,eneheuvel,26-09-11
2007,17DV00,307,10,12,22,eneheuvel,26-09-11
2007,17DV00,308,12,12,24,eneheuvel,26-09-11
2007,17DV00,309,13,17,30,eneheuvel,26-09-11
2007,17DV00,310,2,1,3,eneheuvel,26-09-11
2007,17DV00,311,5,4,9,eneheuvel,26-09-11
2007,17DV00,312,0,1,1,eneheuvel,26-09-11
2007,17DV00,502,1,1,2,eneheuvel,26-09-11
2007,17DV00,9999,1,0,1,eneheuvel,26-09-11
2007,17FI00,101,0,1,1,eneheuvel,26-09-11
2007,17FI00,102,2,3,5,eneheuvel,26-09-11
2007,17FI00,103,3,5,8,eneheuvel,26-09-11
2007,17FI00,105,0,2,2,eneheuvel,26-09-11
2007,17FI00,106,3,2,5,eneheuvel,26-09-11
2007,17FI00,107,0,1,1,eneheuvel,26-09-11
2007,17FI00,108,3,4,7,eneheuvel,26-09-11
2007,17FI00,109,0,1,1,eneheuvel,26-09-11
2007,17FI00,201,3,2,5,eneheuvel,26-09-11
2007,17FI00,202,6,23,29,eneheuvel,26-09-11
2007,17FI00,203,10,8,18,eneheuvel,26-09-11
2007,17FI00,204,5,8,13,eneheuvel,26-09-11
2007,17FI00,205,1,7,8,eneheuvel,26-09-11
2007,17FI00,206,4,6,10,eneheuvel,26-09-11
2007,17FI00,207,5,4,9,eneheuvel,26-09-11
2007,17FI00,208,5,7,12,eneheuvel,26-09-11
2007,17FI00,209,0,1,1,eneheuvel,26-09-11
2007,17FI00,210,6,9,15,eneheuvel,26-09-11
2007,17FI00,211,4,5,9,eneheuvel,26-09-11
2007,17FI00,212,3,6,9,eneheuvel,26-09-11
2007,17FI00,213,3,5,8,eneheuvel,26-09-11
2007,17FI00,214,2,5,7,eneheuvel,26-09-11
2007,17FI00,216,1,2,3,eneheuvel,26-09-11
2007,17FI00,301,0,1,1,eneheuvel,26-09-11
2007,17FI00,302,3,2,5,eneheuvel,26-09-11
2007,17FI00,303,4,4,8,eneheuvel,26-09-11
2007,17FI00,304,4,5,9,eneheuvel,26-09-11
2007,17FI00,305,3,10,13,eneheuvel,26-09-11
2007,17FI00,306,1,3,4,eneheuvel,26-09-11
2007,17FI00,307,6,4,10,eneheuvel,26-09-11
2007,17FI00,308,0,3,3,eneheuvel,26-09-11
2007,17FI00,309,4,2,6,eneheuvel,26-09-11
2007,17FI00,310,0,1,1,eneheuvel,26-09-11
2007,17FI00,311,1,2,3,eneheuvel,26-09-11
2007,17FI00,312,2,1,3,eneheuvel,26-09-11
2007,17FI00,502,1,1,2,eneheuvel,26-09-11
2007,17FI00,9999,0,2,2,eneheuvel,26-09-11
2007,17LP00,203,0,1,1,eneheuvel,26-09-11
2007,17LP00,301,1,0,1,eneheuvel,26-09-11
2007,17LP00,304,3,0,3,eneheuvel,26-09-11
2007,17LP00,305,48,39,87,eneheuvel,26-09-11
2007,17LP00,306,7,3,10,eneheuvel,26-09-11
2007,17LP00,307,0,1,1,eneheuvel,26-09-11
2007,17LP00,308,0,1,1,eneheuvel,26-09-11
2007,17LP00,309,0,1,1,eneheuvel,26-09-11
2007,17LP00,9999,1,0,1,eneheuvel,26-09-11
2007,17MH00,202,2,0,2,eneheuvel,26-09-11
2007,17MH00,207,0,1,1,eneheuvel,26-09-11
2007,17MH00,210,0,3,3,eneheuvel,26-09-11
2007,17MH00,212,1,0,1,eneheuvel,26-09-11
2007,17MH00,216,0,1,1,eneheuvel,26-09-11
2007,17MH00,302,1,3,4,eneheuvel,26-09-11
2007,17MH00,303,0,2,2,eneheuvel,26-09-11
2007,17MH00,304,0,2,2,eneheuvel,26-09-11
2007,17MH00,305,64,56,120,eneheuvel,26-09-11
2007,17MH00,306,4,1,5,eneheuvel,26-09-11
2007,17MH00,311,0,1,1,eneheuvel,26-09-11
2007,21KO00,106,0,1,1,eneheuvel,26-09-11
2007,21KO00,202,0,1,1,eneheuvel,26-09-11
2007,21KO00,205,1,1,2,eneheuvel,26-09-11
2007,21KO00,209,1,5,6,eneheuvel,26-09-11
2007,21KO00,210,83,112,195,eneheuvel,26-09-11
2007,21KO00,211,2,0,2,eneheuvel,26-09-11
2007,21KO00,212,1,2,3,eneheuvel,26-09-11
2007,21KO00,213,0,1,1,eneheuvel,26-09-11
2007,21KO00,216,0,1,1,eneheuvel,26-09-11
2007,21KO00,309,0,2,2,eneheuvel,26-09-11
2007,21KO00,9999,0,1,1,eneheuvel,26-09-11
2007,21NC00,103,0,1,1,eneheuvel,26-09-11
2007,21NC00,110,2,0,2,eneheuvel,26-09-11
2007,21NC00,208,0,1,1,eneheuvel,26-09-11
2007,21NC00,210,1,0,1,eneheuvel,26-09-11
2007,21NC00,211,5,0,5,eneheuvel,26-09-11
2007,21NC00,212,5,3,8,eneheuvel,26-09-11
2007,21NC00,213,48,50,98,eneheuvel,26-09-11
2007,21NC00,214,4,3,7,eneheuvel,26-09-11
2007,21NC00,303,1,0,1,eneheuvel,26-09-11
2007,21NC00,305,1,0,1,eneheuvel,26-09-11
2007,21ND00,201,0,1,1,eneheuvel,26-09-11
2007,21ND00,209,1,0,1,eneheuvel,26-09-11
2007,21ND00,210,1,1,2,eneheuvel,26-09-11
2007,21ND00,211,10,9,19,eneheuvel,26-09-11
2007,21ND00,212,3,5,8,eneheuvel,26-09-11
2007,21ND00,213,84,105,189,eneheuvel,26-09-11
2007,21ND00,214,0,5,5,eneheuvel,26-09-11
2007,21ND00,302,0,1,1,eneheuvel,26-09-11
2007,21ND00,304,0,1,1,eneheuvel,26-09-11
2007,21ND00,312,2,1,3,eneheuvel,26-09-11
2007,21ND00,9999,0,1,1,eneheuvel,26-09-11
2007,22KP00,206,1,0,1,eneheuvel,26-09-11
2007,22KP00,207,0,2,2,eneheuvel,26-09-11
2007,22KP00,211,0,1,1,eneheuvel,26-09-11
2007,22KP00,301,2,2,4,eneheuvel,26-09-11
2007,22KP00,302,5,3,8,eneheuvel,26-09-11
2007,22KP00,303,3,3,6,eneheuvel,26-09-11
2007,22KP00,304,2,5,7,eneheuvel,26-09-11
2007,22KP00,306,2,1,3,eneheuvel,26-09-11
2007,22KP00,308,3,7,10,eneheuvel,26-09-11
2007,22KP00,309,135,151,286,eneheuvel,26-09-11
2007,22KP00,310,4,2,6,eneheuvel,26-09-11
2007,22KP00,311,14,19,33,eneheuvel,26-09-11
2007,22KP00,312,0,3,3,eneheuvel,26-09-11
2007,22KQ00,205,1,1,2,eneheuvel,26-09-11
2007,22KQ00,206,1,0,1,eneheuvel,26-09-11
2007,22KQ00,208,1,1,2,eneheuvel,26-09-11
2007,22KQ00,209,0,2,2,eneheuvel,26-09-11
2007,22KQ00,210,73,115,188,eneheuvel,26-09-11
2007,22KQ00,211,0,1,1,eneheuvel,26-09-11
2007,22KQ00,212,0,1,1,eneheuvel,26-09-11
2007,22KQ00,214,2,2,4,eneheuvel,26-09-11
2007,22KQ00,215,0,1,1,eneheuvel,26-09-11
2007,22KQ00,216,3,2,5,eneheuvel,26-09-11
2007,22KQ00,307,1,0,1,eneheuvel,26-09-11
2007,23EP00,202,0,2,2,eneheuvel,26-09-11
2007,23EP00,204,0,1,1,eneheuvel,26-09-11
2007,23EP00,212,34,52,86,eneheuvel,26-09-11
2007,23EP00,213,8,8,16,eneheuvel,26-09-11
2007,23EP00,214,1,2,3,eneheuvel,26-09-11
2007,23EP00,9999,1,1,2,eneheuvel,26-09-11
2007,23ER00,201,1,0,1,eneheuvel,26-09-11
2007,23ER00,210,0,2,2,eneheuvel,26-09-11
2007,23ER00,211,0,1,1,eneheuvel,26-09-11
2007,23ER00,212,83,99,182,eneheuvel,26-09-11
2007,23ER00,213,1,2,3,eneheuvel,26-09-11
2007,23ER00,214,2,5,7,eneheuvel,26-09-11
2007,23ER00,303,0,1,1,eneheuvel,26-09-11
2007,23ER00,9999,0,1,1,eneheuvel,26-09-11
2007,23ET00,201,1,0,1,eneheuvel,26-09-11
2007,23ET00,202,0,1,1,eneheuvel,26-09-11
2007,23ET00,203,1,0,1,eneheuvel,26-09-11
2007,23ET00,208,1,1,2,eneheuvel,26-09-11
2007,23ET00,210,0,1,1,eneheuvel,26-09-11
2007,23ET00,211,1,2,3,eneheuvel,26-09-11
2007,23ET00,212,1,0,1,eneheuvel,26-09-11
2007,23ET00,214,0,1,1,eneheuvel,26-09-11
2007,23ET00,301,0,1,1,eneheuvel,26-09-11
2007,23ET00,302,1,2,3,eneheuvel,26-09-11
2007,23ET00,304,1,1,2,eneheuvel,26-09-11
2007,23ET00,305,0,1,1,eneheuvel,26-09-11
2007,23ET00,306,3,7,10,eneheuvel,26-09-11
2007,23ET00,307,8,7,15,eneheuvel,26-09-11
2007,23ET00,308,64,104,168,eneheuvel,26-09-11
2007,23ET00,309,8,4,12,eneheuvel,26-09-11
2007,23ET00,310,0,1,1,eneheuvel,26-09-11
2007,23ET00,311,2,2,4,eneheuvel,26-09-11
2007,23ET00,312,3,2,5,eneheuvel,26-09-11
2007,23EU00,102,0,1,1,eneheuvel,26-09-11
2007,23EU00,105,0,1,1,eneheuvel,26-09-11
2007,23EU00,207,2,0,2,eneheuvel,26-09-11
2007,23EU00,208,0,2,2,eneheuvel,26-09-11
2007,23EU00,301,1,1,2,eneheuvel,26-09-11
2007,23EU00,305,5,7,12,eneheuvel,26-09-11
2007,23EU00,306,109,115,224,eneheuvel,26-09-11
2007,23EU00,307,6,5,11,eneheuvel,26-09-11
2007,23EU00,309,2,1,3,eneheuvel,26-09-11
2007,23EU00,310,1,0,1,eneheuvel,26-09-11
2007,23EU00,311,0,1,1,eneheuvel,26-09-11
2007,23EU00,313,0,1,1,eneheuvel,26-09-11
2007,23EU00,9999,1,0,1,eneheuvel,26-09-11
2007,23EV00,102,0,1,1,eneheuvel,26-09-11
2007,23EV00,201,1,0,1,eneheuvel,26-09-11
2007,23EV00,203,1,1,2,eneheuvel,26-09-11
2007,23EV00,206,1,0,1,eneheuvel,26-09-11
2007,23EV00,207,1,1,2,eneheuvel,26-09-11
2007,23EV00,208,1,1,2,eneheuvel,26-09-11
2007,23EV00,209,1,2,3,eneheuvel,26-09-11
2007,23EV00,210,12,7,19,eneheuvel,26-09-11
2007,23EV00,211,15,10,25,eneheuvel,26-09-11
2007,23EV00,212,117,127,244,eneheuvel,26-09-11
2007,23EV00,213,29,31,60,eneheuvel,26-09-11
2007,23EV00,214,4,4,8,eneheuvel,26-09-11
2007,23EV00,216,1,4,5,eneheuvel,26-09-11
2007,23EV00,302,2,0,2,eneheuvel,26-09-11
2007,23EV00,304,0,1,1,eneheuvel,26-09-11
2007,23EV00,307,2,0,2,eneheuvel,26-09-11
2007,23EV00,9999,2,0,2,eneheuvel,26-09-11
2007,23EY00,103,1,0,1,eneheuvel,26-09-11
2007,23EY00,201,4,1,5,eneheuvel,26-09-11
2007,23EY00,204,0,1,1,eneheuvel,26-09-11
2007,23EY00,206,1,2,3,eneheuvel,26-09-11
2007,23EY00,208,2,1,3,eneheuvel,26-09-11
2007,23EY00,209,2,1,3,eneheuvel,26-09-11
2007,23EY00,210,8,7,15,eneheuvel,26-09-11
2007,23EY00,211,11,6,17,eneheuvel,26-09-11
2007,23EY00,212,125,135,260,eneheuvel,26-09-11
2007,23EY00,213,31,21,52,eneheuvel,26-09-11
2007,23EY00,214,4,4,8,eneheuvel,26-09-11
2007,23EY00,215,2,0,2,eneheuvel,26-09-11
2007,23EY00,304,1,0,1,eneheuvel,26-09-11
2007,23EY00,305,1,0,1,eneheuvel,26-09-11
2007,23EY00,312,0,1,1,eneheuvel,26-09-11
2007,23EY00,502,0,1,1,eneheuvel,26-09-11
2007,23EY00,9999,2,3,5,eneheuvel,26-09-11
2007,23ZU00,202,81,90,171,eneheuvel,26-09-11
2007,23ZU00,203,5,6,11,eneheuvel,26-09-11
2007,23ZU00,204,45,57,102,eneheuvel,26-09-11
2007,23ZU00,205,100,97,197,eneheuvel,26-09-11
2007,23ZU00,206,2,2,4,eneheuvel,26-09-11
2007,23ZU00,207,22,12,34,eneheuvel,26-09-11
2007,23ZU00,208,17,20,37,eneheuvel,26-09-11
2007,23ZU00,210,1,0,1,eneheuvel,26-09-11
2007,23ZU00,211,1,6,7,eneheuvel,26-09-11
2007,23ZU00,212,0,2,2,eneheuvel,26-09-11
2007,23ZU00,213,1,0,1,eneheuvel,26-09-11
2007,23ZU00,214,1,2,3,eneheuvel,26-09-11
2007,23ZU00,215,1,2,3,eneheuvel,26-09-11
2007,23ZU00,216,1,0,1,eneheuvel,26-09-11
2007,23ZU00,302,1,3,4,eneheuvel,26-09-11
2007,23ZU00,303,1,4,5,eneheuvel,26-09-11
2007,23ZU00,306,2,0,2,eneheuvel,26-09-11
2007,23ZU00,308,0,1,1,eneheuvel,26-09-11
2007,23ZU00,309,1,0,1,eneheuvel,26-09-11
2007,23ZU00,311,0,1,1,eneheuvel,26-09-11
2007,23ZU00,502,1,3,4,eneheuvel,26-09-11
2007,23ZU00,9999,0,2,2,eneheuvel,26-09-11
2007,23ZV00,107,2,1,3,eneheuvel,26-09-11
2007,23ZV00,201,2,2,4,eneheuvel,26-09-11
2007,23ZV00,202,38,45,83,eneheuvel,26-09-11
2007,23ZV00,203,5,7,12,eneheuvel,26-09-11
2007,23ZV00,204,23,44,67,eneheuvel,26-09-11
2007,23ZV00,205,37,75,112,eneheuvel,26-09-11
2007,23ZV00,207,12,10,22,eneheuvel,26-09-11
2007,23ZV00,208,8,7,15,eneheuvel,26-09-11
2007,23ZV00,209,1,0,1,eneheuvel,26-09-11
2007,23ZV00,210,1,0,1,eneheuvel,26-09-11
2007,23ZV00,211,1,1,2,eneheuvel,26-09-11
2007,23ZV00,216,1,0,1,eneheuvel,26-09-11
2007,23ZV00,308,2,0,2,eneheuvel,26-09-11
2007,23ZV00,312,2,1,3,eneheuvel,26-09-11
2007,23ZW00,202,0,2,2,eneheuvel,26-09-11
2007,23ZW00,207,1,2,3,eneheuvel,26-09-11
2007,23ZW00,208,0,4,4,eneheuvel,26-09-11
2007,23ZW00,210,1,0,1,eneheuvel,26-09-11
2007,23ZW00,211,0,1,1,eneheuvel,26-09-11
2007,23ZW00,301,3,0,3,eneheuvel,26-09-11
2007,23ZW00,302,4,0,4,eneheuvel,26-09-11
2007,23ZW00,303,3,6,9,eneheuvel,26-09-11
2007,23ZW00,304,3,2,5,eneheuvel,26-09-11
2007,23ZW00,305,3,1,4,eneheuvel,26-09-11
2007,23ZW00,306,30,36,66,eneheuvel,26-09-11
2007,23ZW00,307,88,70,158,eneheuvel,26-09-11
2007,23ZW00,308,101,90,191,eneheuvel,26-09-11
2007,23ZW00,309,8,3,11,eneheuvel,26-09-11
2007,23ZW00,310,1,1,2,eneheuvel,26-09-11
2007,23ZW00,311,1,1,2,eneheuvel,26-09-11
2007,23ZW00,312,3,5,8,eneheuvel,26-09-11
2007,23ZW00,313,0,1,1,eneheuvel,26-09-11
2007,23ZW00,502,3,2,5,eneheuvel,26-09-11
2007,23ZW00,9999,1,2,3,eneheuvel,26-09-11
2007,23ZX00,102,0,1,1,eneheuvel,26-09-11
2007,23ZX00,105,0,1,1,eneheuvel,26-09-11
2007,23ZX00,110,0,2,2,eneheuvel,26-09-11
2007,23ZX00,201,8,7,15,eneheuvel,26-09-11
2007,23ZX00,202,122,128,250,eneheuvel,26-09-11
2007,23ZX00,203,2,0,2,eneheuvel,26-09-11
2007,23ZX00,204,4,6,10,eneheuvel,26-09-11
2007,23ZX00,205,4,5,9,eneheuvel,26-09-11
2007,23ZX00,206,0,1,1,eneheuvel,26-09-11
2007,23ZX00,207,2,2,4,eneheuvel,26-09-11
2007,23ZX00,208,5,6,11,eneheuvel,26-09-11
2007,23ZX00,209,2,0,2,eneheuvel,26-09-11
2007,23ZX00,211,2,4,6,eneheuvel,26-09-11
2007,23ZX00,304,0,2,2,eneheuvel,26-09-11
2007,23ZX00,305,1,0,1,eneheuvel,26-09-11
2007,23ZX00,306,0,1,1,eneheuvel,26-09-11
2007,23ZY00,105,1,0,1,eneheuvel,26-09-11
2007,23ZY00,109,0,2,2,eneheuvel,26-09-11
2007,23ZY00,206,1,2,3,eneheuvel,26-09-11
2007,23ZY00,210,2,0,2,eneheuvel,26-09-11
2007,23ZY00,211,3,3,6,eneheuvel,26-09-11
2007,23ZY00,212,170,206,376,eneheuvel,26-09-11
2007,23ZY00,213,0,1,1,eneheuvel,26-09-11
2007,23ZY00,214,1,0,1,eneheuvel,26-09-11
2007,23ZY00,302,0,1,1,eneheuvel,26-09-11
2007,23ZY00,306,1,0,1,eneheuvel,26-09-11
2007,23ZY00,9999,0,1,1,eneheuvel,26-09-11
2007,24EJ00,101,2,0,2,eneheuvel,26-09-11
2007,24EJ00,102,3,7,10,eneheuvel,26-09-11
2007,24EJ00,106,1,3,4,eneheuvel,26-09-11
2007,24EJ00,107,3,0,3,eneheuvel,26-09-11
2007,24EJ00,108,3,1,4,eneheuvel,26-09-11
2007,24EJ00,201,2,0,2,eneheuvel,26-09-11
2007,24EJ00,202,5,5,10,eneheuvel,26-09-11
2007,24EJ00,203,0,3,3,eneheuvel,26-09-11
2007,24EJ00,204,5,5,10,eneheuvel,26-09-11
2007,24EJ00,205,0,1,1,eneheuvel,26-09-11
2007,24EJ00,206,2,4,6,eneheuvel,26-09-11
2007,24EJ00,207,1,4,5,eneheuvel,26-09-11
2007,24EJ00,208,6,9,15,eneheuvel,26-09-11
2007,24EJ00,209,18,10,28,eneheuvel,26-09-11
2007,24EJ00,210,24,13,37,eneheuvel,26-09-11
2007,24EJ00,211,30,23,53,eneheuvel,26-09-11
2007,24EJ00,212,8,7,15,eneheuvel,26-09-11
2007,24EJ00,213,5,7,12,eneheuvel,26-09-11
2007,24EJ00,214,3,7,10,eneheuvel,26-09-11
2007,24EJ00,303,1,1,2,eneheuvel,26-09-11
2007,24EJ00,308,0,2,2,eneheuvel,26-09-11
2007,24EJ00,309,1,1,2,eneheuvel,26-09-11
2007,24EJ00,9999,3,1,4,eneheuvel,26-09-11
2007,24FT00,102,1,1,2,eneheuvel,26-09-11
2007,24FT00,103,0,1,1,eneheuvel,26-09-11
2007,24FT00,105,0,5,5,eneheuvel,26-09-11
2007,24FT00,106,0,2,2,eneheuvel,26-09-11
2007,24FT00,202,1,1,2,eneheuvel,26-09-11
2007,24FT00,203,0,2,2,eneheuvel,26-09-11
2007,24FT00,204,1,4,5,eneheuvel,26-09-11
2007,24FT00,205,1,3,4,eneheuvel,26-09-11
2007,24FT00,206,0,7,7,eneheuvel,26-09-11
2007,24FT00,207,0,2,2,eneheuvel,26-09-11
2007,24FT00,208,2,11,13,eneheuvel,26-09-11
2007,24FT00,209,0,1,1,eneheuvel,26-09-11
2007,24FT00,210,0,3,3,eneheuvel,26-09-11
2007,24FT00,211,4,9,13,eneheuvel,26-09-11
2007,24FT00,212,4,16,20,eneheuvel,26-09-11
2007,24FT00,213,3,6,9,eneheuvel,26-09-11
2007,24FT00,214,4,16,20,eneheuvel,26-09-11
2007,24FT00,302,0,12,12,eneheuvel,26-09-11
2007,24FT00,303,0,11,11,eneheuvel,26-09-11
2007,24FT00,304,0,6,6,eneheuvel,26-09-11
2007,24FT00,305,0,2,2,eneheuvel,26-09-11
2007,24FT00,306,4,2,6,eneheuvel,26-09-11
2007,24FT00,307,1,4,5,eneheuvel,26-09-11
2007,24FT00,308,3,9,12,eneheuvel,26-09-11
2007,24FT00,309,0,7,7,eneheuvel,26-09-11
2007,24FT00,311,2,11,13,eneheuvel,26-09-11
2007,24FT00,312,2,11,13,eneheuvel,26-09-11
2007,24FT00,502,0,2,2,eneheuvel,26-09-11
2007,24FT00,9999,2,1,3,eneheuvel,26-09-11
2007,24MR00,201,1,1,2,eneheuvel,26-09-11
2007,24MR00,204,0,1,1,eneheuvel,26-09-11
2007,24MR00,207,0,1,1,eneheuvel,26-09-11
2007,24MR00,208,1,2,3,eneheuvel,26-09-11
2007,24MR00,210,1,0,1,eneheuvel,26-09-11
2007,24MR00,301,1,0,1,eneheuvel,26-09-11
2007,24MR00,305,1,0,1,eneheuvel,26-09-11
2007,24MR00,306,11,17,28,eneheuvel,26-09-11
2007,24MR00,307,122,167,289,eneheuvel,26-09-11
2007,24MR00,308,3,11,14,eneheuvel,26-09-11
2007,24MR00,310,0,1,1,eneheuvel,26-09-11
2007,24MR00,311,0,1,1,eneheuvel,26-09-11
2007,24MR00,502,0,2,2,eneheuvel,26-09-11
2007,24MR00,9999,3,0,3,eneheuvel,26-09-11
2007,24RK00,108,0,1,1,eneheuvel,26-09-11
2007,24RK00,202,16,21,37,eneheuvel,26-09-11
2007,24RK00,203,12,10,22,eneheuvel,26-09-11
2007,24RK00,204,13,12,25,eneheuvel,26-09-11
2007,24RK00,205,4,7,11,eneheuvel,26-09-11
2007,24RK00,206,3,0,3,eneheuvel,26-09-11
2007,24RK00,207,7,3,10,eneheuvel,26-09-11
2007,24RK00,208,3,3,6,eneheuvel,26-09-11
2007,24RK00,210,0,3,3,eneheuvel,26-09-11
2007,24RK00,212,2,0,2,eneheuvel,26-09-11
2007,24RK00,213,2,1,3,eneheuvel,26-09-11
2007,24RK00,214,3,1,4,eneheuvel,26-09-11
2007,24RK00,216,0,2,2,eneheuvel,26-09-11
2007,24RK00,301,0,1,1,eneheuvel,26-09-11
2007,24RK00,302,4,2,6,eneheuvel,26-09-11
2007,24RK00,303,8,2,10,eneheuvel,26-09-11
2007,24RK00,304,3,5,8,eneheuvel,26-09-11
2007,24RK00,305,0,3,3,eneheuvel,26-09-11
2007,24RK00,306,3,4,7,eneheuvel,26-09-11
2007,24RK00,307,5,1,6,eneheuvel,26-09-11
2007,24RK00,308,6,5,11,eneheuvel,26-09-11
2007,24RK00,309,2,2,4,eneheuvel,26-09-11
2007,24RK00,312,1,0,1,eneheuvel,26-09-11
2007,24RK00,9999,1,1,2,eneheuvel,26-09-11
2007,24UN00,201,1,0,1,eneheuvel,26-09-11
2007,24UN00,202,1,0,1,eneheuvel,26-09-11
2007,24UN00,204,0,1,1,eneheuvel,26-09-11
2007,24UN00,208,0,1,1,eneheuvel,26-09-11
2007,24UN00,302,1,0,1,eneheuvel,26-09-11
2007,24UN00,303,2,2,4,eneheuvel,26-09-11
2007,24UN00,304,0,1,1,eneheuvel,26-09-11
2007,24UN00,306,29,30,59,eneheuvel,26-09-11
2007,24UN00,307,60,42,102,eneheuvel,26-09-11
2007,24UN00,308,53,56,109,eneheuvel,26-09-11
2007,24UN00,309,17,16,33,eneheuvel,26-09-11
2007,24UN00,311,3,5,8,eneheuvel,26-09-11
2007,24UN00,313,1,0,1,eneheuvel,26-09-11
2007,24UN00,9999,1,0,1,eneheuvel,26-09-11
2007,25CF00,202,4,5,9,eneheuvel,26-09-11
2007,25CF00,203,6,8,14,eneheuvel,26-09-11
2007,25CF00,204,58,91,149,eneheuvel,26-09-11
2007,25CF00,205,25,49,74,eneheuvel,26-09-11
2007,25CF00,206,0,1,1,eneheuvel,26-09-11
2007,25CF00,207,3,7,10,eneheuvel,26-09-11
2007,25CF00,208,3,7,10,eneheuvel,26-09-11
2007,25CF00,210,1,1,2,eneheuvel,26-09-11
2007,25CF00,211,1,0,1,eneheuvel,26-09-11
2007,25CF00,212,1,0,1,eneheuvel,26-09-11
2007,25CF00,303,0,1,1,eneheuvel,26-09-11
2007,25CF00,309,1,0,1,eneheuvel,26-09-11
2007,25CF00,312,0,1,1,eneheuvel,26-09-11
2007,25CF00,9999,0,1,1,eneheuvel,26-09-11
2007,25KT00,107,0,1,1,eneheuvel,26-09-11
2007,25KT00,201,1,0,1,eneheuvel,26-09-11
2007,25KT00,202,48,61,109,eneheuvel,26-09-11
2007,25KT00,203,112,79,191,eneheuvel,26-09-11
2007,25KT00,204,86,82,168,eneheuvel,26-09-11
2007,25KT00,205,6,6,12,eneheuvel,26-09-11
2007,25KT00,207,25,3,28,eneheuvel,26-09-11
2007,25KT00,208,43,34,77,eneheuvel,26-09-11
2007,25KT00,211,1,0,1,eneheuvel,26-09-11
2007,25KT00,212,0,1,1,eneheuvel,26-09-11
2007,25KT00,306,2,0,2,eneheuvel,26-09-11
2007,25KT00,312,0,1,1,eneheuvel,26-09-11
2007,25KT00,502,9,13,22,eneheuvel,26-09-11
2007,25KT00,9999,3,1,4,eneheuvel,26-09-11
2007,25KU00,109,1,1,2,eneheuvel,26-09-11
2007,25KU00,110,2,0,2,eneheuvel,26-09-11
2007,25KU00,201,0,1,1,eneheuvel,26-09-11
2007,25KU00,202,25,28,53,eneheuvel,26-09-11
2007,25KU00,203,78,41,119,eneheuvel,26-09-11
2007,25KU00,204,75,73,148,eneheuvel,26-09-11
2007,25KU00,205,2,2,4,eneheuvel,26-09-11
2007,25KU00,206,1,0,1,eneheuvel,26-09-11
2007,25KU00,207,13,6,19,eneheuvel,26-09-11
2007,25KU00,208,23,34,57,eneheuvel,26-09-11
2007,25KU00,211,1,0,1,eneheuvel,26-09-11
2007,25KU00,216,2,0,2,eneheuvel,26-09-11
2007,25KU00,303,1,0,1,eneheuvel,26-09-11
2007,25KU00,304,1,0,1,eneheuvel,26-09-11
2007,25KU00,308,1,0,1,eneheuvel,26-09-11
2007,25KU00,309,1,0,1,eneheuvel,26-09-11
2007,25KU00,313,1,0,1,eneheuvel,26-09-11
2007,25KU00,502,5,11,16,eneheuvel,26-09-11
2007,25KV00,101,2,0,2,eneheuvel,26-09-11
2007,25KV00,108,2,0,2,eneheuvel,26-09-11
2007,25KV00,201,1,2,3,eneheuvel,26-09-11
2007,25KV00,202,2,5,7,eneheuvel,26-09-11
2007,25KV00,203,189,185,374,eneheuvel,26-09-11
2007,25KV00,204,5,12,17,eneheuvel,26-09-11
2007,25KV00,205,1,2,3,eneheuvel,26-09-11
2007,25KV00,206,1,0,1,eneheuvel,26-09-11
2007,25KV00,207,1,1,2,eneheuvel,26-09-11
2007,25KV00,208,3,11,14,eneheuvel,26-09-11
2007,25KV00,209,1,0,1,eneheuvel,26-09-11
2007,25KV00,211,1,1,2,eneheuvel,26-09-11
2007,25KV00,214,0,1,1,eneheuvel,26-09-11
2007,25KV00,302,0,1,1,eneheuvel,26-09-11
2007,25KV00,309,0,1,1,eneheuvel,26-09-11
2007,25KV00,310,1,0,1,eneheuvel,26-09-11
2007,25KV00,311,1,1,2,eneheuvel,26-09-11
2007,26AB00,103,1,0,1,eneheuvel,26-09-11
2007,26AB00,202,1,1,2,eneheuvel,26-09-11
2007,26AB00,205,1,0,1,eneheuvel,26-09-11
2007,26AB00,208,1,0,1,eneheuvel,26-09-11
2007,26AB00,211,0,2,2,eneheuvel,26-09-11
2007,26AB00,214,1,0,1,eneheuvel,26-09-11
2007,26AB00,302,17,19,36,eneheuvel,26-09-11
2007,26AB00,303,181,184,365,eneheuvel,26-09-11
2007,26AB00,304,2,3,5,eneheuvel,26-09-11
2007,26AB00,305,1,0,1,eneheuvel,26-09-11
2007,26AB00,306,1,3,4,eneheuvel,26-09-11
2007,26AB00,308,0,2,2,eneheuvel,26-09-11
2007,26AB00,309,2,3,5,eneheuvel,26-09-11
2007,26AB00,310,1,0,1,eneheuvel,26-09-11
2007,26AB00,311,5,6,11,eneheuvel,26-09-11
2007,26AB00,312,0,1,1,eneheuvel,26-09-11
2007,26AB00,313,5,4,9,eneheuvel,26-09-11
2007,26AB00,9999,2,1,3,eneheuvel,26-09-11
2007,26AC00,102,1,0,1,eneheuvel,26-09-11
2007,26AC00,107,1,1,2,eneheuvel,26-09-11
2007,26AC00,109,22,9,31,eneheuvel,26-09-11
2007,26AC00,201,1,1,2,eneheuvel,26-09-11
2007,26AC00,203,2,1,3,eneheuvel,26-09-11
2007,26AC00,204,0,1,1,eneheuvel,26-09-11
2007,26AC00,206,1,0,1,eneheuvel,26-09-11
2007,26AC00,208,0,1,1,eneheuvel,26-09-11
2007,26AC00,210,1,0,1,eneheuvel,26-09-11
2007,26AC00,211,6,6,12,eneheuvel,26-09-11
2007,26AC00,212,14,16,30,eneheuvel,26-09-11
2007,26AC00,213,17,18,35,eneheuvel,26-09-11
2007,26AC00,214,485,377,862,eneheuvel,26-09-11
2007,26AC00,215,0,1,1,eneheuvel,26-09-11
2007,26AC00,216,1,0,1,eneheuvel,26-09-11
2007,26AC00,301,1,0,1,eneheuvel,26-09-11
2007,26AC00,302,0,1,1,eneheuvel,26-09-11
2007,26AC00,303,0,1,1,eneheuvel,26-09-11
2007,26AC00,311,3,0,3,eneheuvel,26-09-11
2007,26AC00,312,1,1,2,eneheuvel,26-09-11
2007,26AC00,9999,1,3,4,eneheuvel,26-09-11
2007,26AD00,201,1,1,2,eneheuvel,26-09-11
2007,26AD00,202,1,0,1,eneheuvel,26-09-11
2007,26AD00,203,0,1,1,eneheuvel,26-09-11
2007,26AD00,207,0,1,1,eneheuvel,26-09-11
2007,26AD00,208,1,0,1,eneheuvel,26-09-11
2007,26AD00,214,1,1,2,eneheuvel,26-09-11
2007,26AD00,301,0,1,1,eneheuvel,26-09-11
2007,26AD00,302,104,71,175,eneheuvel,26-09-11
2007,26AD00,303,43,22,65,eneheuvel,26-09-11
2007,26AD00,305,3,2,5,eneheuvel,26-09-11
2007,26AD00,306,1,2,3,eneheuvel,26-09-11
2007,26AD00,307,0,2,2,eneheuvel,26-09-11
2007,26AD00,308,3,2,5,eneheuvel,26-09-11
2007,26AD00,309,74,36,110,eneheuvel,26-09-11
2007,26AD00,310,16,7,23,eneheuvel,26-09-11
2007,26AD00,311,43,42,85,eneheuvel,26-09-11
2007,26AD00,312,5,1,6,eneheuvel,26-09-11
2007,26AD00,313,7,7,14,eneheuvel,26-09-11
2007,26AD00,502,1,1,2,eneheuvel,26-09-11
2007,26AD00,9999,1,1,2,eneheuvel,26-09-11
2007,26PD00,104,1,0,1,eneheuvel,26-09-11
2007,26PD00,201,1,1,2,eneheuvel,26-09-11
2007,26PD00,204,2,2,4,eneheuvel,26-09-11
2007,26PD00,205,4,4,8,eneheuvel,26-09-11
2007,26PD00,207,159,207,366,eneheuvel,26-09-11
2007,26PD00,208,41,69,110,eneheuvel,26-09-11
2007,26PD00,210,1,1,2,eneheuvel,26-09-11
2007,26PD00,211,0,1,1,eneheuvel,26-09-11
2007,26PD00,212,0,3,3,eneheuvel,26-09-11
2007,26PD00,312,0,1,1,eneheuvel,26-09-11
2007,26PD00,502,2,2,4,eneheuvel,26-09-11
2007,26PD00,9999,1,2,3,eneheuvel,26-09-11
2007,26PE00,201,1,1,2,eneheuvel,26-09-11
2007,26PE00,203,1,0,1,eneheuvel,26-09-11
2007,26PE00,209,1,0,1,eneheuvel,26-09-11
2007,26PE00,302,268,260,528,eneheuvel,26-09-11
2007,26PE00,303,20,16,36,eneheuvel,26-09-11
2007,26PE00,304,0,1,1,eneheuvel,26-09-11
2007,26PE00,306,1,1,2,eneheuvel,26-09-11
2007,26PE00,309,4,1,5,eneheuvel,26-09-11
2007,26PE00,310,0,1,1,eneheuvel,26-09-11
2007,26PE00,311,3,9,12,eneheuvel,26-09-11
2007,26PE00,312,3,0,3,eneheuvel,26-09-11
2007,26PE00,313,6,3,9,eneheuvel,26-09-11
2007,26PE00,9999,2,2,4,eneheuvel,26-09-11
2007,26PF00,103,1,0,1,eneheuvel,26-09-11
2007,26PF00,201,4,0,4,eneheuvel,26-09-11
2007,26PF00,202,1,1,2,eneheuvel,26-09-11
2007,26PF00,203,1,0,1,eneheuvel,26-09-11
2007,26PF00,206,3,0,3,eneheuvel,26-09-11
2007,26PF00,208,0,1,1,eneheuvel,26-09-11
2007,26PF00,209,0,1,1,eneheuvel,26-09-11
2007,26PF00,210,1,0,1,eneheuvel,26-09-11
2007,26PF00,211,5,6,11,eneheuvel,26-09-11
2007,26PF00,212,8,4,12,eneheuvel,26-09-11
2007,26PF00,213,3,3,6,eneheuvel,26-09-11
2007,26PF00,214,189,202,391,eneheuvel,26-09-11
2007,26PF00,216,1,0,1,eneheuvel,26-09-11
2007,26PF00,302,1,3,4,eneheuvel,26-09-11
2007,26PF00,308,1,0,1,eneheuvel,26-09-11
2007,26PF00,309,2,1,3,eneheuvel,26-09-11
2007,26PF00,311,1,0,1,eneheuvel,26-09-11
2007,26PF00,312,0,2,2,eneheuvel,26-09-11
2007,26PF00,9999,3,1,4,eneheuvel,26-09-11
2007,26PG00,103,0,1,1,eneheuvel,26-09-11
2007,26PG00,108,1,0,1,eneheuvel,26-09-11
2007,26PG00,207,2,0,2,eneheuvel,26-09-11
2007,26PG00,209,0,1,1,eneheuvel,26-09-11
2007,26PG00,210,1,0,1,eneheuvel,26-09-11
2007,26PG00,211,2,0,2,eneheuvel,26-09-11
2007,26PG00,212,0,2,2,eneheuvel,26-09-11
2007,26PG00,213,2,0,2,eneheuvel,26-09-11
2007,26PG00,214,71,103,174,eneheuvel,26-09-11
2007,26PG00,9999,2,1,3,eneheuvel,26-09-11
2007,26PH00,201,0,1,1,eneheuvel,26-09-11
2007,26PH00,211,1,0,1,eneheuvel,26-09-11
2007,26PH00,212,1,0,1,eneheuvel,26-09-11
2007,26PH00,216,0,1,1,eneheuvel,26-09-11
2007,26PH00,302,30,13,43,eneheuvel,26-09-11
2007,26PH00,303,9,6,15,eneheuvel,26-09-11
2007,26PH00,304,3,0,3,eneheuvel,26-09-11
2007,26PH00,305,2,0,2,eneheuvel,26-09-11
2007,26PH00,306,2,1,3,eneheuvel,26-09-11
2007,26PH00,307,1,2,3,eneheuvel,26-09-11
2007,26PH00,308,2,1,3,eneheuvel,26-09-11
2007,26PH00,309,53,24,77,eneheuvel,26-09-11
2007,26PH00,311,257,184,441,eneheuvel,26-09-11
2007,26PH00,312,11,10,21,eneheuvel,26-09-11
2007,26PH00,313,5,5,10,eneheuvel,26-09-11
2007,26PH00,9999,6,2,8,eneheuvel,26-09-11
2007,26PW00,302,41,37,78,eneheuvel,26-09-11
2007,26PW00,303,41,22,63,eneheuvel,26-09-11
2007,26PW00,306,1,0,1,eneheuvel,26-09-11
2007,26PW00,307,0,2,2,eneheuvel,26-09-11
2007,26PW00,308,3,2,5,eneheuvel,26-09-11
2007,26PW00,309,45,31,76,eneheuvel,26-09-11
2007,26PW00,310,9,4,13,eneheuvel,26-09-11
2007,26PW00,311,27,16,43,eneheuvel,26-09-11
2007,26PW00,312,3,2,5,eneheuvel,26-09-11
2007,26PW00,313,3,3,6,eneheuvel,26-09-11
2007,26ZZ00,202,250,216,466,eneheuvel,26-09-11
2007,26ZZ00,203,11,11,22,eneheuvel,26-09-11
2007,26ZZ00,204,4,4,8,eneheuvel,26-09-11
2007,26ZZ00,205,0,1,1,eneheuvel,26-09-11
2007,26ZZ00,206,1,0,1,eneheuvel,26-09-11
2007,26ZZ00,207,0,1,1,eneheuvel,26-09-11
2007,26ZZ00,208,4,4,8,eneheuvel,26-09-11
2007,26ZZ00,209,0,1,1,eneheuvel,26-09-11
2007,26ZZ00,210,1,1,2,eneheuvel,26-09-11
2007,26ZZ00,211,1,0,1,eneheuvel,26-09-11
2007,26ZZ00,214,0,1,1,eneheuvel,26-09-11
2007,26ZZ00,309,0,2,2,eneheuvel,26-09-11
2007,26ZZ00,312,1,0,1,eneheuvel,26-09-11
2007,26ZZ00,313,1,0,1,eneheuvel,26-09-11
2007,26ZZ00,502,1,1,2,eneheuvel,26-09-11
2007,26ZZ00,9999,1,0,1,eneheuvel,26-09-11
2007,27AA00,106,0,1,1,eneheuvel,26-09-11
2007,27AA00,201,1,0,1,eneheuvel,26-09-11
2007,27AA00,202,1,0,1,eneheuvel,26-09-11
2007,27AA00,203,6,1,7,eneheuvel,26-09-11
2007,27AA00,204,14,10,24,eneheuvel,26-09-11
2007,27AA00,205,5,4,9,eneheuvel,26-09-11
2007,27AA00,206,0,1,1,eneheuvel,26-09-11
2007,27AA00,207,75,61,136,eneheuvel,26-09-11
2007,27AA00,208,195,155,350,eneheuvel,26-09-11
2007,27AA00,209,0,1,1,eneheuvel,26-09-11
2007,27AA00,210,3,0,3,eneheuvel,26-09-11
2007,27AA00,211,0,1,1,eneheuvel,26-09-11
2007,27AA00,212,0,1,1,eneheuvel,26-09-11
2007,27AA00,214,1,2,3,eneheuvel,26-09-11
2007,27AA00,216,0,1,1,eneheuvel,26-09-11
2007,27AA00,301,0,1,1,eneheuvel,26-09-11
2007,27AA00,302,0,1,1,eneheuvel,26-09-11
2007,27AA00,303,2,1,3,eneheuvel,26-09-11
2007,27AA00,305,0,1,1,eneheuvel,26-09-11
2007,27AA00,307,2,3,5,eneheuvel,26-09-11
2007,27AA00,308,1,0,1,eneheuvel,26-09-11
2007,27AA00,309,0,3,3,eneheuvel,26-09-11
2007,27AA00,311,1,0,1,eneheuvel,26-09-11
2007,27AA00,312,1,1,2,eneheuvel,26-09-11
2007,27AA00,9999,2,1,3,eneheuvel,26-09-11
2007,27NU00,103,1,0,1,eneheuvel,26-09-11
2007,27NU00,108,1,0,1,eneheuvel,26-09-11
2007,27NU00,201,2,0,2,eneheuvel,26-09-11
2007,27NU00,203,7,3,10,eneheuvel,26-09-11
2007,27NU00,204,4,1,5,eneheuvel,26-09-11
2007,27NU00,205,2,0,2,eneheuvel,26-09-11
2007,27NU00,206,1,0,1,eneheuvel,26-09-11
2007,27NU00,207,18,12,30,eneheuvel,26-09-11
2007,27NU00,208,168,97,265,eneheuvel,26-09-11
2007,27NU00,209,1,0,1,eneheuvel,26-09-11
2007,27NU00,210,2,1,3,eneheuvel,26-09-11
2007,27NU00,302,2,1,3,eneheuvel,26-09-11
2007,27NU00,305,1,1,2,eneheuvel,26-09-11
2007,27NU00,311,0,1,1,eneheuvel,26-09-11
2007,27NU00,502,0,2,2,eneheuvel,26-09-11
2007,27NU00,9999,2,2,4,eneheuvel,26-09-11
2007,27UB00,202,0,1,1,eneheuvel,26-09-11
2007,27UB00,203,6,3,9,eneheuvel,26-09-11
2007,27UB00,204,2,1,3,eneheuvel,26-09-11
2007,27UB00,205,1,0,1,eneheuvel,26-09-11
2007,27UB00,207,8,2,10,eneheuvel,26-09-11
2007,27UB00,208,164,82,246,eneheuvel,26-09-11
2007,27UB00,211,2,0,2,eneheuvel,26-09-11
2007,27UB00,213,0,1,1,eneheuvel,26-09-11
2007,27UB00,301,0,1,1,eneheuvel,26-09-11
2007,27UB00,302,1,0,1,eneheuvel,26-09-11
2007,27UB00,305,1,0,1,eneheuvel,26-09-11
2007,27UB00,306,1,2,3,eneheuvel,26-09-11
2007,27UB00,307,2,0,2,eneheuvel,26-09-11
2007,27UB00,309,1,1,2,eneheuvel,26-09-11
2007,27UB00,310,1,0,1,eneheuvel,26-09-11
2007,27UB00,311,4,1,5,eneheuvel,26-09-11
2007,27UB00,502,3,2,5,eneheuvel,26-09-11
2007,27XH00,202,2,1,3,eneheuvel,26-09-11
2007,27XH00,206,1,4,5,eneheuvel,26-09-11
2007,27XH00,209,2,1,3,eneheuvel,26-09-11
2007,27XH00,210,9,5,14,eneheuvel,26-09-11
2007,27XH00,211,1,0,1,eneheuvel,26-09-11
2007,27XH00,212,3,4,7,eneheuvel,26-09-11
2007,27XH00,214,11,3,14,eneheuvel,26-09-11
2007,27XH00,215,18,24,42,eneheuvel,26-09-11
2007,27XH00,216,72,51,123,eneheuvel,26-09-11
2007,27XH00,302,1,0,1,eneheuvel,26-09-11
2007,27XH00,303,1,0,1,eneheuvel,26-09-11
2007,27XH00,307,0,1,1,eneheuvel,26-09-11
2007,27XH00,311,2,1,3,eneheuvel,26-09-11
2007,27XJ00,201,1,0,1,eneheuvel,26-09-11
2007,27XJ00,202,0,1,1,eneheuvel,26-09-11
2007,27XJ00,203,2,0,2,eneheuvel,26-09-11
2007,27XJ00,205,1,1,2,eneheuvel,26-09-11
2007,27XJ00,207,1,0,1,eneheuvel,26-09-11
2007,27XJ00,208,3,0,3,eneheuvel,26-09-11
2007,27XJ00,212,1,1,2,eneheuvel,26-09-11
2007,27XJ00,302,16,0,16,eneheuvel,26-09-11
2007,27XJ00,303,5,0,5,eneheuvel,26-09-11
2007,27XJ00,304,1,0,1,eneheuvel,26-09-11
2007,27XJ00,305,0,1,1,eneheuvel,26-09-11
2007,27XJ00,306,2,0,2,eneheuvel,26-09-11
2007,27XJ00,307,1,0,1,eneheuvel,26-09-11
2007,27XJ00,308,0,1,1,eneheuvel,26-09-11
2007,27XJ00,309,2,1,3,eneheuvel,26-09-11
2007,27XJ00,311,18,2,20,eneheuvel,26-09-11
2007,27XJ00,312,104,34,138,eneheuvel,26-09-11
2007,27XJ00,313,25,8,33,eneheuvel,26-09-11
2007,27XJ00,502,1,2,3,eneheuvel,26-09-11
2007,27XJ00,9999,3,2,5,eneheuvel,26-09-11
2007,27YN00,109,1,0,1,eneheuvel,26-09-11
2007,27YN00,202,0,1,1,eneheuvel,26-09-11
2007,27YN00,206,0,2,2,eneheuvel,26-09-11
2007,27YN00,207,1,0,1,eneheuvel,26-09-11
2007,27YN00,210,2,2,4,eneheuvel,26-09-11
2007,27YN00,211,0,2,2,eneheuvel,26-09-11
2007,27YN00,212,2,5,7,eneheuvel,26-09-11
2007,27YN00,214,1,0,1,eneheuvel,26-09-11
2007,27YN00,215,3,3,6,eneheuvel,26-09-11
2007,27YN00,216,67,52,119,eneheuvel,26-09-11
2007,27YN00,302,1,1,2,eneheuvel,26-09-11
2007,27YN00,308,0,1,1,eneheuvel,26-09-11
2007,27YN00,309,3,0,3,eneheuvel,26-09-11
2007,27YN00,311,2,0,2,eneheuvel,26-09-11
2007,27YN00,9999,2,1,3,eneheuvel,26-09-11
2007,28AM00,105,1,1,2,eneheuvel,26-09-11
2007,28AM00,201,0,1,1,eneheuvel,26-09-11
2007,28AM00,203,1,0,1,eneheuvel,26-09-11
2007,28AM00,211,0,1,1,eneheuvel,26-09-11
2007,28AM00,214,1,0,1,eneheuvel,26-09-11
2007,28AM00,301,1,0,1,eneheuvel,26-09-11
2007,28AM00,302,3,0,3,eneheuvel,26-09-11
2007,28AM00,307,2,0,2,eneheuvel,26-09-11
2007,28AM00,308,1,1,2,eneheuvel,26-09-11
2007,28AM00,309,2,1,3,eneheuvel,26-09-11
2007,28AM00,311,10,3,13,eneheuvel,26-09-11
2007,28AM00,312,124,100,224,eneheuvel,26-09-11
2007,28AM00,313,4,3,7,eneheuvel,26-09-11
2007,28AM00,9999,1,0,1,eneheuvel,26-09-11
2007,28BR00,108,0,1,1,eneheuvel,26-09-11
2007,28BR00,203,2,0,2,eneheuvel,26-09-11
2007,28BR00,207,0,1,1,eneheuvel,26-09-11
2007,28BR00,208,1,1,2,eneheuvel,26-09-11
2007,28BR00,211,1,3,4,eneheuvel,26-09-11
2007,28BR00,212,4,4,8,eneheuvel,26-09-11
2007,28BR00,213,1,0,1,eneheuvel,26-09-11
2007,28BR00,301,1,3,4,eneheuvel,26-09-11
2007,28BR00,302,5,4,9,eneheuvel,26-09-11
2007,28BR00,303,1,3,4,eneheuvel,26-09-11
2007,28BR00,304,1,1,2,eneheuvel,26-09-11
2007,28BR00,305,1,1,2,eneheuvel,26-09-11
2007,28BR00,306,1,0,1,eneheuvel,26-09-11
2007,28BR00,307,1,0,1,eneheuvel,26-09-11
2007,28BR00,308,1,1,2,eneheuvel,26-09-11
2007,28BR00,309,3,2,5,eneheuvel,26-09-11
2007,28BR00,311,13,8,21,eneheuvel,26-09-11
2007,28BR00,312,0,1,1,eneheuvel,26-09-11
2007,28BR00,9999,0,1,1,eneheuvel,26-09-11
2007,28DJ00,103,0,2,2,eneheuvel,26-09-11
2007,28DJ00,105,1,2,3,eneheuvel,26-09-11
2007,28DJ00,107,2,0,2,eneheuvel,26-09-11
2007,28DJ00,108,2,1,3,eneheuvel,26-09-11
2007,28DJ00,202,2,0,2,eneheuvel,26-09-11
2007,28DJ00,203,8,2,10,eneheuvel,26-09-11
2007,28DJ00,204,2,3,5,eneheuvel,26-09-11
2007,28DJ00,205,3,1,4,eneheuvel,26-09-11
2007,28DJ00,206,1,1,2,eneheuvel,26-09-11
2007,28DJ00,207,6,7,13,eneheuvel,26-09-11
2007,28DJ00,208,9,9,18,eneheuvel,26-09-11
2007,28DJ00,210,4,3,7,eneheuvel,26-09-11
2007,28DJ00,211,5,1,6,eneheuvel,26-09-11
2007,28DJ00,212,2,5,7,eneheuvel,26-09-11
2007,28DJ00,213,1,2,3,eneheuvel,26-09-11
2007,28DJ00,214,2,1,3,eneheuvel,26-09-11
2007,28DJ00,216,1,0,1,eneheuvel,26-09-11
2007,28DJ00,301,1,2,3,eneheuvel,26-09-11
2007,28DJ00,302,1,2,3,eneheuvel,26-09-11
2007,28DJ00,303,2,1,3,eneheuvel,26-09-11
2007,28DJ00,304,1,3,4,eneheuvel,26-09-11
2007,28DJ00,305,7,8,15,eneheuvel,26-09-11
2007,28DJ00,306,4,2,6,eneheuvel,26-09-11
2007,28DJ00,307,5,4,9,eneheuvel,26-09-11
2007,28DJ00,308,2,1,3,eneheuvel,26-09-11
2007,28DJ00,9999,0,1,1,eneheuvel,26-09-11
2007,29UB00,202,0,1,1,eneheuvel,26-09-11
2007,29UB00,311,0,1,1,eneheuvel,26-09-11
2007,29UN00,211,1,0,1,eneheuvel,26-09-11
2007,29UN00,213,2,0,2,eneheuvel,26-09-11
2007,29UN00,304,2,0,2,eneheuvel,26-09-11
2007,29UN00,308,1,0,1,eneheuvel,26-09-11
2007,29UN00,309,0,1,1,eneheuvel,26-09-11
2007,29UN00,311,1,1,2,eneheuvel,26-09-11
2007,29UN00,312,1,0,1,eneheuvel,26-09-11
2008,06RM00,102,1,4,5,eneheuvel,26-09-11
2008,06RM00,103,4,1,5,eneheuvel,26-09-11
2008,06RM00,104,0,2,2,eneheuvel,26-09-11
2008,06RM00,105,1,1,2,eneheuvel,26-09-11
2008,06RM00,106,2,0,2,eneheuvel,26-09-11
2008,06RM00,109,0,2,2,eneheuvel,26-09-11
2008,06RM00,202,7,7,14,eneheuvel,26-09-11
2008,06RM00,204,3,3,6,eneheuvel,26-09-11
2008,06RM00,206,2,5,7,eneheuvel,26-09-11
2008,06RM00,207,2,0,2,eneheuvel,26-09-11
2008,06RM00,208,1,1,2,eneheuvel,26-09-11
2008,06RM00,210,6,10,16,eneheuvel,26-09-11
2008,06RM00,211,6,9,15,eneheuvel,26-09-11
2008,06RM00,212,20,34,54,eneheuvel,26-09-11
2008,06RM00,213,7,6,13,eneheuvel,26-09-11
2008,06RM00,214,17,10,27,eneheuvel,26-09-11
2008,06RM00,215,2,1,3,eneheuvel,26-09-11
2008,06RM00,216,3,6,9,eneheuvel,26-09-11
2008,06RM00,302,5,4,9,eneheuvel,26-09-11
2008,06RM00,303,3,2,5,eneheuvel,26-09-11
2008,06RM00,304,1,1,2,eneheuvel,26-09-11
2008,06RM00,305,1,0,1,eneheuvel,26-09-11
2008,06RM00,306,1,1,2,eneheuvel,26-09-11
2008,06RM00,307,1,0,1,eneheuvel,26-09-11
2008,06RM00,308,1,0,1,eneheuvel,26-09-11
2008,06RM00,309,0,4,4,eneheuvel,26-09-11
2008,06RM00,311,6,1,7,eneheuvel,26-09-11
2008,06RM00,312,4,2,6,eneheuvel,26-09-11
2008,06RM00,402,0,1,1,eneheuvel,26-09-11
2008,06RM00,502,0,6,6,eneheuvel,26-09-11
2008,06RM00,9999,11,10,21,eneheuvel,26-09-11
2008,12HU00,103,1,2,3,eneheuvel,26-09-11
2008,12HU00,201,5,3,8,eneheuvel,26-09-11
2008,12HU00,202,2,0,2,eneheuvel,26-09-11
2008,12HU00,207,1,0,1,eneheuvel,26-09-11
2008,12HU00,208,0,1,1,eneheuvel,26-09-11
2008,12HU00,209,4,0,4,eneheuvel,26-09-11
2008,12HU00,210,2,2,4,eneheuvel,26-09-11
2008,12HU00,211,53,47,100,eneheuvel,26-09-11
2008,12HU00,212,0,1,1,eneheuvel,26-09-11
2008,12PM00,101,9,5,14,eneheuvel,26-09-11
2008,12PM00,102,11,3,14,eneheuvel,26-09-11
2008,12PM00,103,38,37,75,eneheuvel,26-09-11
2008,12PM00,104,4,5,9,eneheuvel,26-09-11
2008,12PM00,106,4,3,7,eneheuvel,26-09-11
2008,12PM00,107,25,17,42,eneheuvel,26-09-11
2008,12PM00,108,16,16,32,eneheuvel,26-09-11
2008,12PM00,109,9,10,19,eneheuvel,26-09-11
2008,12PM00,202,2,2,4,eneheuvel,26-09-11
2008,12PM00,211,1,1,2,eneheuvel,26-09-11
2008,12PM00,212,0,2,2,eneheuvel,26-09-11
2008,12PM00,216,0,2,2,eneheuvel,26-09-11
2008,12PM00,303,1,1,2,eneheuvel,26-09-11
2008,12PM00,306,1,1,2,eneheuvel,26-09-11
2008,12PM00,311,2,0,2,eneheuvel,26-09-11
2008,12PM00,9999,2,0,2,eneheuvel,26-09-11
2008,12QK00,201,1,0,1,eneheuvel,26-09-11
2008,12QK00,202,1,1,2,eneheuvel,26-09-11
2008,12QK00,203,1,0,1,eneheuvel,26-09-11
2008,12QK00,205,0,1,1,eneheuvel,26-09-11
2008,12QK00,206,111,99,210,eneheuvel,26-09-11
2008,12QK00,207,0,2,2,eneheuvel,26-09-11
2008,12QK00,208,2,3,5,eneheuvel,26-09-11
2008,12QK00,209,5,4,9,eneheuvel,26-09-11
2008,12QK00,210,8,10,18,eneheuvel,26-09-11
2008,12QK00,211,0,2,2,eneheuvel,26-09-11
2008,12QK00,212,1,1,2,eneheuvel,26-09-11
2008,12QK00,213,0,1,1,eneheuvel,26-09-11
2008,12QK00,215,1,5,6,eneheuvel,26-09-11
2008,12QK00,302,1,1,2,eneheuvel,26-09-11
2008,12QK00,307,0,1,1,eneheuvel,26-09-11
2008,12QK00,312,0,2,2,eneheuvel,26-09-11
2008,12QK00,9999,1,0,1,eneheuvel,26-09-11
2008,12XA00,201,0,1,1,eneheuvel,26-09-11
2008,12XA00,208,0,1,1,eneheuvel,26-09-11
2008,12XA00,211,61,52,113,eneheuvel,26-09-11
2008,12XA00,213,0,2,2,eneheuvel,26-09-11
2008,12XA00,303,2,0,2,eneheuvel,26-09-11
2008,13CW00,102,0,1,1,eneheuvel,26-09-11
2008,13CW00,201,2,2,4,eneheuvel,26-09-11
2008,13CW00,203,0,2,2,eneheuvel,26-09-11
2008,13CW00,205,1,2,3,eneheuvel,26-09-11
2008,13CW00,206,67,62,129,eneheuvel,26-09-11
2008,13CW00,207,2,2,4,eneheuvel,26-09-11
2008,13CW00,208,1,1,2,eneheuvel,26-09-11
2008,13CW00,209,19,4,23,eneheuvel,26-09-11
2008,13CW00,210,7,7,14,eneheuvel,26-09-11
2008,13CW00,212,2,0,2,eneheuvel,26-09-11
2008,13CW00,214,1,0,1,eneheuvel,26-09-11
2008,13CW00,215,0,2,2,eneheuvel,26-09-11
2008,13CW00,216,1,0,1,eneheuvel,26-09-11
2008,13CW00,305,1,0,1,eneheuvel,26-09-11
2008,13CW00,308,2,0,2,eneheuvel,26-09-11
2008,13CW00,9999,1,0,1,eneheuvel,26-09-11
2008,13IF00,105,0,1,1,eneheuvel,26-09-11
2008,13IF00,207,1,0,1,eneheuvel,26-09-11
2008,13IF00,208,1,1,2,eneheuvel,26-09-11
2008,13IF00,214,0,2,2,eneheuvel,26-09-11
2008,13IF00,301,9,7,16,eneheuvel,26-09-11
2008,13IF00,302,1,3,4,eneheuvel,26-09-11
2008,13IF00,303,5,19,24,eneheuvel,26-09-11
2008,13IF00,304,32,32,64,eneheuvel,26-09-11
2008,13IF00,305,5,9,14,eneheuvel,26-09-11
2008,13IF00,306,7,22,29,eneheuvel,26-09-11
2008,13IF00,307,3,5,8,eneheuvel,26-09-11
2008,13IF00,308,3,3,6,eneheuvel,26-09-11
2008,13IF00,309,1,2,3,eneheuvel,26-09-11
2008,13IF00,310,1,0,1,eneheuvel,26-09-11
2008,13IF00,311,0,1,1,eneheuvel,26-09-11
2008,13IF00,9999,1,0,1,eneheuvel,26-09-11
2008,13IU00,101,1,1,2,eneheuvel,26-09-11
2008,13IU00,102,12,5,17,eneheuvel,26-09-11
2008,13IU00,103,8,5,13,eneheuvel,26-09-11
2008,13IU00,104,4,1,5,eneheuvel,26-09-11
2008,13IU00,105,3,6,9,eneheuvel,26-09-11
2008,13IU00,106,52,40,92,eneheuvel,26-09-11
2008,13IU00,107,5,2,7,eneheuvel,26-09-11
2008,13IU00,108,2,2,4,eneheuvel,26-09-11
2008,13IU00,109,2,3,5,eneheuvel,26-09-11
2008,13IU00,211,0,1,1,eneheuvel,26-09-11
2008,13IU00,212,1,1,2,eneheuvel,26-09-11
2008,13IU00,311,1,0,1,eneheuvel,26-09-11
2008,13IU00,9999,1,0,1,eneheuvel,26-09-11
2008,13NH00,101,3,3,6,eneheuvel,26-09-11
2008,13NH00,102,10,7,17,eneheuvel,26-09-11
2008,13NH00,103,2,1,3,eneheuvel,26-09-11
2008,13NH00,104,18,26,44,eneheuvel,26-09-11
2008,13NH00,105,64,62,126,eneheuvel,26-09-11
2008,13NH00,106,7,10,17,eneheuvel,26-09-11
2008,13NH00,107,1,2,3,eneheuvel,26-09-11
2008,13NH00,109,2,1,3,eneheuvel,26-09-11
2008,13NH00,110,6,5,11,eneheuvel,26-09-11
2008,13NH00,203,1,0,1,eneheuvel,26-09-11
2008,13NH00,208,0,1,1,eneheuvel,26-09-11
2008,13NH00,213,1,0,1,eneheuvel,26-09-11
2008,13NH00,214,1,0,1,eneheuvel,26-09-11
2008,13NH00,308,1,0,1,eneheuvel,26-09-11
2008,13NH00,502,0,1,1,eneheuvel,26-09-11
2008,13NH00,9999,0,1,1,eneheuvel,26-09-11
2008,13NU00,206,1,0,1,eneheuvel,26-09-11
2008,13NU00,207,0,1,1,eneheuvel,26-09-11
2008,13NU00,208,0,3,3,eneheuvel,26-09-11
2008,13NU00,211,0,1,1,eneheuvel,26-09-11
2008,13NU00,301,9,7,16,eneheuvel,26-09-11
2008,13NU00,302,1,0,1,eneheuvel,26-09-11
2008,13NU00,303,40,42,82,eneheuvel,26-09-11
2008,13NU00,304,69,53,122,eneheuvel,26-09-11
2008,13NU00,305,18,18,36,eneheuvel,26-09-11
2008,13NU00,306,12,22,34,eneheuvel,26-09-11
2008,13NU00,307,2,2,4,eneheuvel,26-09-11
2008,13NU00,308,3,6,9,eneheuvel,26-09-11
2008,13NU00,309,1,1,2,eneheuvel,26-09-11
2008,13NU00,310,1,0,1,eneheuvel,26-09-11
2008,13NU00,311,0,1,1,eneheuvel,26-09-11
2008,13NU00,312,1,1,2,eneheuvel,26-09-11
2008,13NU00,9999,2,1,3,eneheuvel,26-09-11
2008,14QC00,109,1,3,4,eneheuvel,26-09-11
2008,14QC00,110,1,0,1,eneheuvel,26-09-11
2008,14QC00,201,4,0,4,eneheuvel,26-09-11
2008,14QC00,202,52,54,106,eneheuvel,26-09-11
2008,14QC00,203,42,41,83,eneheuvel,26-09-11
2008,14QC00,204,32,24,56,eneheuvel,26-09-11
2008,14QC00,205,23,17,40,eneheuvel,26-09-11
2008,14QC00,206,21,9,30,eneheuvel,26-09-11
2008,14QC00,207,13,5,18,eneheuvel,26-09-11
2008,14QC00,208,23,21,44,eneheuvel,26-09-11
2008,14QC00,209,3,0,3,eneheuvel,26-09-11
2008,14QC00,210,7,7,14,eneheuvel,26-09-11
2008,14QC00,211,7,4,11,eneheuvel,26-09-11
2008,14QC00,212,3,5,8,eneheuvel,26-09-11
2008,14QC00,213,4,3,7,eneheuvel,26-09-11
2008,14QC00,214,2,4,6,eneheuvel,26-09-11
2008,14QC00,215,2,2,4,eneheuvel,26-09-11
2008,14QC00,216,4,1,5,eneheuvel,26-09-11
2008,14QC00,302,4,3,7,eneheuvel,26-09-11
2008,14QC00,303,12,1,13,eneheuvel,26-09-11
2008,14QC00,304,2,3,5,eneheuvel,26-09-11
2008,14QC00,306,4,1,5,eneheuvel,26-09-11
2008,14QC00,307,2,1,3,eneheuvel,26-09-11
2008,14QC00,309,0,1,1,eneheuvel,26-09-11
2008,14QC00,311,9,3,12,eneheuvel,26-09-11
2008,14QC00,312,5,2,7,eneheuvel,26-09-11
2008,14QC00,313,0,1,1,eneheuvel,26-09-11
2008,14QC00,502,15,12,27,eneheuvel,26-09-11
2008,14QC00,9999,3,0,3,eneheuvel,26-09-11
2008,15SJ00,101,1,1,2,eneheuvel,26-09-11
2008,15SJ00,102,1,3,4,eneheuvel,26-09-11
2008,15SJ00,103,1,6,7,eneheuvel,26-09-11
2008,15SJ00,104,0,3,3,eneheuvel,26-09-11
2008,15SJ00,106,0,5,5,eneheuvel,26-09-11
2008,15SJ00,108,0,4,4,eneheuvel,26-09-11
2008,15SJ00,201,2,5,7,eneheuvel,26-09-11
2008,15SJ00,202,2,7,9,eneheuvel,26-09-11
2008,15SJ00,203,3,7,10,eneheuvel,26-09-11
2008,15SJ00,204,0,8,8,eneheuvel,26-09-11
2008,15SJ00,205,1,5,6,eneheuvel,26-09-11
2008,15SJ00,206,2,18,20,eneheuvel,26-09-11
2008,15SJ00,207,3,13,16,eneheuvel,26-09-11
2008,15SJ00,208,2,9,11,eneheuvel,26-09-11
2008,15SJ00,209,4,7,11,eneheuvel,26-09-11
2008,15SJ00,210,7,20,27,eneheuvel,26-09-11
2008,15SJ00,211,6,20,26,eneheuvel,26-09-11
2008,15SJ00,212,1,17,18,eneheuvel,26-09-11
2008,15SJ00,213,2,7,9,eneheuvel,26-09-11
2008,15SJ00,214,3,7,10,eneheuvel,26-09-11
2008,15SJ00,216,0,1,1,eneheuvel,26-09-11
2008,15SJ00,301,2,5,7,eneheuvel,26-09-11
2008,15SJ00,302,3,6,9,eneheuvel,26-09-11
2008,15SJ00,303,2,6,8,eneheuvel,26-09-11
2008,15SJ00,304,1,6,7,eneheuvel,26-09-11
2008,15SJ00,305,1,6,7,eneheuvel,26-09-11
2008,15SJ00,306,3,7,10,eneheuvel,26-09-11
2008,15SJ00,307,3,4,7,eneheuvel,26-09-11
2008,15SJ00,308,2,7,9,eneheuvel,26-09-11
2008,15SJ00,309,4,6,10,eneheuvel,26-09-11
2008,15SJ00,311,4,2,6,eneheuvel,26-09-11
2008,15SJ00,312,1,3,4,eneheuvel,26-09-11
2008,15SJ00,313,0,1,1,eneheuvel,26-09-11
2008,15SJ00,9999,0,2,2,eneheuvel,26-09-11
2008,15ZL00,203,1,0,1,eneheuvel,26-09-11
2008,15ZL00,204,1,2,3,eneheuvel,26-09-11
2008,15ZL00,205,1,1,2,eneheuvel,26-09-11
2008,15ZL00,206,3,1,4,eneheuvel,26-09-11
2008,15ZL00,208,1,0,1,eneheuvel,26-09-11
2008,15ZL00,210,0,1,1,eneheuvel,26-09-11
2008,15ZL00,214,1,1,2,eneheuvel,26-09-11
2008,15ZL00,216,1,1,2,eneheuvel,26-09-11
2008,15ZL00,302,4,4,8,eneheuvel,26-09-11
2008,15ZL00,303,3,4,7,eneheuvel,26-09-11
2008,15ZL00,304,0,4,4,eneheuvel,26-09-11
2008,15ZL00,305,53,60,113,eneheuvel,26-09-11
2008,15ZL00,306,4,10,14,eneheuvel,26-09-11
2008,15ZL00,307,3,5,8,eneheuvel,26-09-11
2008,15ZL00,308,4,4,8,eneheuvel,26-09-11
2008,15ZL00,309,8,4,12,eneheuvel,26-09-11
2008,15ZL00,311,6,0,6,eneheuvel,26-09-11
2008,15ZL00,312,2,3,5,eneheuvel,26-09-11
2008,15ZL00,313,0,1,1,eneheuvel,26-09-11
2008,15ZL00,502,1,0,1,eneheuvel,26-09-11
2008,15ZL01,109,1,0,1,eneheuvel,26-09-11
2008,15ZL01,206,1,2,3,eneheuvel,26-09-11
2008,15ZL01,207,1,0,1,eneheuvel,26-09-11
2008,15ZL01,209,8,7,15,eneheuvel,26-09-11
2008,15ZL01,210,75,61,136,eneheuvel,26-09-11
2008,15ZL01,211,1,0,1,eneheuvel,26-09-11
2008,15ZL01,212,2,1,3,eneheuvel,26-09-11
2008,15ZL01,214,0,1,1,eneheuvel,26-09-11
2008,15ZL01,215,2,3,5,eneheuvel,26-09-11
2008,15ZL01,216,1,3,4,eneheuvel,26-09-11
2008,15ZL01,306,0,1,1,eneheuvel,26-09-11
2008,15ZL01,307,0,1,1,eneheuvel,26-09-11
2008,15ZL01,308,0,1,1,eneheuvel,26-09-11
2008,15ZL01,9999,2,2,4,eneheuvel,26-09-11
2008,16KK00,101,17,11,28,eneheuvel,26-09-11
2008,16KK00,102,40,39,79,eneheuvel,26-09-11
2008,16KK00,103,62,59,121,eneheuvel,26-09-11
2008,16KK00,104,3,0,3,eneheuvel,26-09-11
2008,16KK00,105,1,2,3,eneheuvel,26-09-11
2008,16KK00,106,5,6,11,eneheuvel,26-09-11
2008,16KK00,107,18,8,26,eneheuvel,26-09-11
2008,16KK00,108,21,28,49,eneheuvel,26-09-11
2008,16KK00,109,14,10,24,eneheuvel,26-09-11
2008,16KK00,110,1,0,1,eneheuvel,26-09-11
2008,16KK00,202,3,0,3,eneheuvel,26-09-11
2008,16KK00,203,0,1,1,eneheuvel,26-09-11
2008,16KK00,204,0,1,1,eneheuvel,26-09-11
2008,16KK00,206,0,1,1,eneheuvel,26-09-11
2008,16KK00,207,1,3,4,eneheuvel,26-09-11
2008,16KK00,208,1,0,1,eneheuvel,26-09-11
2008,16KK00,209,0,1,1,eneheuvel,26-09-11
2008,16KK00,210,0,1,1,eneheuvel,26-09-11
2008,16KK00,211,3,2,5,eneheuvel,26-09-11
2008,16KK00,212,0,1,1,eneheuvel,26-09-11
2008,16KK00,213,1,1,2,eneheuvel,26-09-11
2008,16KK00,214,0,3,3,eneheuvel,26-09-11
2008,16KK00,216,0,1,1,eneheuvel,26-09-11
2008,16KK00,302,1,0,1,eneheuvel,26-09-11
2008,16KK00,303,1,0,1,eneheuvel,26-09-11
2008,16KK00,309,3,1,4,eneheuvel,26-09-11
2008,16KK00,311,1,2,3,eneheuvel,26-09-11
2008,16KK00,502,3,1,4,eneheuvel,26-09-11
2008,16KK00,9999,2,1,3,eneheuvel,26-09-11
2008,16LJ00,101,3,2,5,eneheuvel,26-09-11
2008,16LJ00,102,5,4,9,eneheuvel,26-09-11
2008,16LJ00,103,1,0,1,eneheuvel,26-09-11
2008,16LJ00,104,2,0,2,eneheuvel,26-09-11
2008,16LJ00,105,0,2,2,eneheuvel,26-09-11
2008,16LJ00,106,47,46,93,eneheuvel,26-09-11
2008,16LJ00,107,1,8,9,eneheuvel,26-09-11
2008,16LJ00,108,1,5,6,eneheuvel,26-09-11
2008,16LJ00,109,0,2,2,eneheuvel,26-09-11
2008,16LJ00,201,0,1,1,eneheuvel,26-09-11
2008,16LJ00,203,3,2,5,eneheuvel,26-09-11
2008,16LJ00,204,0,1,1,eneheuvel,26-09-11
2008,16LJ00,208,1,0,1,eneheuvel,26-09-11
2008,16LJ00,210,0,1,1,eneheuvel,26-09-11
2008,16LJ00,212,0,2,2,eneheuvel,26-09-11
2008,16LJ00,213,0,1,1,eneheuvel,26-09-11
2008,16LJ00,214,0,1,1,eneheuvel,26-09-11
2008,16LJ00,303,0,1,1,eneheuvel,26-09-11
2008,16LJ00,304,0,1,1,eneheuvel,26-09-11
2008,16LJ00,306,1,0,1,eneheuvel,26-09-11
2008,16LJ00,308,0,1,1,eneheuvel,26-09-11
2008,16LJ00,311,0,1,1,eneheuvel,26-09-11
2008,16LJ00,9999,0,2,2,eneheuvel,26-09-11
2008,16ML00,101,4,9,13,eneheuvel,26-09-11
2008,16ML00,102,33,27,60,eneheuvel,26-09-11
2008,16ML00,103,4,2,6,eneheuvel,26-09-11
2008,16ML00,104,55,59,114,eneheuvel,26-09-11
2008,16ML00,105,26,30,56,eneheuvel,26-09-11
2008,16ML00,106,3,4,7,eneheuvel,26-09-11
2008,16ML00,107,2,4,6,eneheuvel,26-09-11
2008,16ML00,108,0,6,6,eneheuvel,26-09-11
2008,16ML00,109,4,5,9,eneheuvel,26-09-11
2008,16ML00,110,2,5,7,eneheuvel,26-09-11
2008,16ML00,201,0,1,1,eneheuvel,26-09-11
2008,16ML00,202,1,0,1,eneheuvel,26-09-11
2008,16ML00,203,1,2,3,eneheuvel,26-09-11
2008,16ML00,205,1,3,4,eneheuvel,26-09-11
2008,16ML00,209,0,1,1,eneheuvel,26-09-11
2008,16ML00,210,0,2,2,eneheuvel,26-09-11
2008,16ML00,211,1,0,1,eneheuvel,26-09-11
2008,16ML00,212,1,2,3,eneheuvel,26-09-11
2008,16ML00,213,0,1,1,eneheuvel,26-09-11
2008,16ML00,214,0,2,2,eneheuvel,26-09-11
2008,16ML00,303,1,2,3,eneheuvel,26-09-11
2008,16ML00,306,1,2,3,eneheuvel,26-09-11
2008,16ML00,308,1,0,1,eneheuvel,26-09-11
2008,16ML00,311,1,0,1,eneheuvel,26-09-11
2008,16ML00,312,0,2,2,eneheuvel,26-09-11
2008,16ML00,502,3,1,4,eneheuvel,26-09-11
2008,16ML00,9999,1,0,1,eneheuvel,26-09-11
2008,16OC00,101,1,2,3,eneheuvel,26-09-11
2008,16OC00,102,0,4,4,eneheuvel,26-09-11
2008,16OC00,103,4,10,14,eneheuvel,26-09-11
2008,16OC00,104,0,1,1,eneheuvel,26-09-11
2008,16OC00,105,0,1,1,eneheuvel,26-09-11
2008,16OC00,106,0,1,1,eneheuvel,26-09-11
2008,16OC00,107,67,81,148,eneheuvel,26-09-11
2008,16OC00,108,13,22,35,eneheuvel,26-09-11
2008,16OC00,109,44,51,95,eneheuvel,26-09-11
2008,16OC00,201,4,2,6,eneheuvel,26-09-11
2008,16OC00,202,6,1,7,eneheuvel,26-09-11
2008,16OC00,204,0,1,1,eneheuvel,26-09-11
2008,16OC00,206,0,4,4,eneheuvel,26-09-11
2008,16OC00,207,3,0,3,eneheuvel,26-09-11
2008,16OC00,208,0,5,5,eneheuvel,26-09-11
2008,16OC00,209,0,1,1,eneheuvel,26-09-11
2008,16OC00,210,2,3,5,eneheuvel,26-09-11
2008,16OC00,211,0,2,2,eneheuvel,26-09-11
2008,16OC00,212,1,0,1,eneheuvel,26-09-11
2008,16OC00,213,0,3,3,eneheuvel,26-09-11
2008,16OC00,214,2,6,8,eneheuvel,26-09-11
2008,16OC00,216,1,1,2,eneheuvel,26-09-11
2008,16OC00,301,1,0,1,eneheuvel,26-09-11
2008,16OC00,302,3,1,4,eneheuvel,26-09-11
2008,16OC00,303,1,4,5,eneheuvel,26-09-11
2008,16OC00,304,3,0,3,eneheuvel,26-09-11
2008,16OC00,306,1,0,1,eneheuvel,26-09-11
2008,16OC00,308,1,0,1,eneheuvel,26-09-11
2008,16OC00,309,5,0,5,eneheuvel,26-09-11
2008,16OC00,311,0,1,1,eneheuvel,26-09-11
2008,16OC00,313,1,1,2,eneheuvel,26-09-11
2008,16OC00,502,1,0,1,eneheuvel,26-09-11
2008,16OC00,9999,2,0,2,eneheuvel,26-09-11
2008,16UK00,103,6,11,17,eneheuvel,26-09-11
2008,16UK00,107,1,1,2,eneheuvel,26-09-11
2008,16UK00,108,72,80,152,eneheuvel,26-09-11
2008,16UK00,109,0,1,1,eneheuvel,26-09-11
2008,16UK00,201,0,1,1,eneheuvel,26-09-11
2008,16UK00,212,0,1,1,eneheuvel,26-09-11
2008,16WV00,201,5,0,5,eneheuvel,26-09-11
2008,16WV00,202,1,0,1,eneheuvel,26-09-11
2008,16WV00,209,17,9,26,eneheuvel,26-09-11
2008,16WV00,210,0,1,1,eneheuvel,26-09-11
2008,16WV00,211,64,51,115,eneheuvel,26-09-11
2008,16WV00,214,2,1,3,eneheuvel,26-09-11
2008,16WV00,216,0,1,1,eneheuvel,26-09-11
2008,16WV00,306,0,1,1,eneheuvel,26-09-11
2008,16WV00,9999,1,1,2,eneheuvel,26-09-11
2008,16YS00,201,11,6,17,eneheuvel,26-09-11
2008,16YS00,203,1,0,1,eneheuvel,26-09-11
2008,16YS00,206,0,1,1,eneheuvel,26-09-11
2008,16YS00,208,0,1,1,eneheuvel,26-09-11
2008,16YS00,209,2,1,3,eneheuvel,26-09-11
2008,16YS00,210,1,0,1,eneheuvel,26-09-11
2008,16YS00,211,89,73,162,eneheuvel,26-09-11
2008,16YS00,212,1,0,1,eneheuvel,26-09-11
2008,16YS00,213,2,0,2,eneheuvel,26-09-11
2008,16YS00,309,0,1,1,eneheuvel,26-09-11
2008,16YS00,312,1,0,1,eneheuvel,26-09-11
2008,16ZG00,108,1,0,1,eneheuvel,26-09-11
2008,16ZG00,201,0,1,1,eneheuvel,26-09-11
2008,16ZG00,202,2,0,2,eneheuvel,26-09-11
2008,16ZG00,203,0,1,1,eneheuvel,26-09-11
2008,16ZG00,211,84,60,144,eneheuvel,26-09-11
2008,16ZG00,212,1,1,2,eneheuvel,26-09-11
2008,16ZG00,213,0,2,2,eneheuvel,26-09-11
2008,16ZG00,214,0,2,2,eneheuvel,26-09-11
2008,16ZG00,301,1,0,1,eneheuvel,26-09-11
2008,16ZG00,309,0,1,1,eneheuvel,26-09-11
2008,16ZG00,312,0,1,1,eneheuvel,26-09-11
2008,16ZG00,9999,2,1,3,eneheuvel,26-09-11
2008,16ZX00,201,1,2,3,eneheuvel,26-09-11
2008,16ZX00,206,13,25,38,eneheuvel,26-09-11
2008,16ZX00,207,0,1,1,eneheuvel,26-09-11
2008,16ZX00,209,37,31,68,eneheuvel,26-09-11
2008,16ZX00,210,1,1,2,eneheuvel,26-09-11
2008,16ZX00,211,0,1,1,eneheuvel,26-09-11
2008,16ZX00,305,0,1,1,eneheuvel,26-09-11
2008,16ZX00,308,1,0,1,eneheuvel,26-09-11
2008,16ZX00,311,0,1,1,eneheuvel,26-09-11
2008,16ZX00,9999,1,1,2,eneheuvel,26-09-11
2008,17AK00,202,1,0,1,eneheuvel,26-09-11
2008,17AK00,204,1,1,2,eneheuvel,26-09-11
2008,17AK00,205,1,0,1,eneheuvel,26-09-11
2008,17AK00,206,54,58,112,eneheuvel,26-09-11
2008,17AK00,207,0,2,2,eneheuvel,26-09-11
2008,17AK00,209,4,1,5,eneheuvel,26-09-11
2008,17AK00,210,1,5,6,eneheuvel,26-09-11
2008,17AK00,211,0,1,1,eneheuvel,26-09-11
2008,17AK00,303,1,0,1,eneheuvel,26-09-11
2008,17AK00,304,2,0,2,eneheuvel,26-09-11
2008,17AK00,305,1,4,5,eneheuvel,26-09-11
2008,17AK00,306,1,0,1,eneheuvel,26-09-11
2008,17AK00,307,0,1,1,eneheuvel,26-09-11
2008,17AK00,309,0,1,1,eneheuvel,26-09-11
2008,17AK00,9999,1,1,2,eneheuvel,26-09-11
2008,17AV00,202,0,1,1,eneheuvel,26-09-11
2008,17AV00,204,1,2,3,eneheuvel,26-09-11
2008,17AV00,205,1,0,1,eneheuvel,26-09-11
2008,17AV00,206,66,84,150,eneheuvel,26-09-11
2008,17AV00,207,1,0,1,eneheuvel,26-09-11
2008,17AV00,208,1,1,2,eneheuvel,26-09-11
2008,17AV00,209,3,0,3,eneheuvel,26-09-11
2008,17AV00,210,1,0,1,eneheuvel,26-09-11
2008,17AV00,211,1,0,1,eneheuvel,26-09-11
2008,17AV00,214,1,1,2,eneheuvel,26-09-11
2008,17AV00,215,1,0,1,eneheuvel,26-09-11
2008,17AV00,9999,0,2,2,eneheuvel,26-09-11
2008,17BP00,108,0,1,1,eneheuvel,26-09-11
2008,17BP00,201,0,1,1,eneheuvel,26-09-11
2008,17BP00,208,1,1,2,eneheuvel,26-09-11
2008,17BP00,209,1,0,1,eneheuvel,26-09-11
2008,17BP00,210,2,1,3,eneheuvel,26-09-11
2008,17BP00,211,53,57,110,eneheuvel,26-09-11
2008,17BP00,212,4,6,10,eneheuvel,26-09-11
2008,17BP00,213,66,76,142,eneheuvel,26-09-11
2008,17BP00,214,3,1,4,eneheuvel,26-09-11
2008,17BP00,309,0,1,1,eneheuvel,26-09-11
2008,17BP00,312,0,1,1,eneheuvel,26-09-11
2008,17DA00,102,0,1,1,eneheuvel,26-09-11
2008,17DA00,209,9,7,16,eneheuvel,26-09-11
2008,17DA00,210,47,49,96,eneheuvel,26-09-11
2008,17DA00,211,1,1,2,eneheuvel,26-09-11
2008,17DA00,302,0,3,3,eneheuvel,26-09-11
2008,17DA00,303,0,1,1,eneheuvel,26-09-11
2008,17DA00,307,0,2,2,eneheuvel,26-09-11
2008,17DK00,202,1,1,2,eneheuvel,26-09-11
2008,17DK00,203,0,1,1,eneheuvel,26-09-11
2008,17DK00,206,0,1,1,eneheuvel,26-09-11
2008,17DK00,207,2,0,2,eneheuvel,26-09-11
2008,17DK00,301,3,5,8,eneheuvel,26-09-11
2008,17DK00,302,1,2,3,eneheuvel,26-09-11
2008,17DK00,303,0,2,2,eneheuvel,26-09-11
2008,17DK00,304,31,42,73,eneheuvel,26-09-11
2008,17DK00,305,1,3,4,eneheuvel,26-09-11
2008,17DK00,306,0,1,1,eneheuvel,26-09-11
2008,17DK00,308,3,0,3,eneheuvel,26-09-11
2008,17DK00,309,3,1,4,eneheuvel,26-09-11
2008,17DV00,106,0,1,1,eneheuvel,26-09-11
2008,17DV00,108,0,1,1,eneheuvel,26-09-11
2008,17DV00,202,0,1,1,eneheuvel,26-09-11
2008,17DV00,203,0,1,1,eneheuvel,26-09-11
2008,17DV00,204,1,3,4,eneheuvel,26-09-11
2008,17DV00,206,0,2,2,eneheuvel,26-09-11
2008,17DV00,207,2,0,2,eneheuvel,26-09-11
2008,17DV00,211,1,0,1,eneheuvel,26-09-11
2008,17DV00,212,0,1,1,eneheuvel,26-09-11
2008,17DV00,214,0,1,1,eneheuvel,26-09-11
2008,17DV00,216,1,1,2,eneheuvel,26-09-11
2008,17DV00,301,20,5,25,eneheuvel,26-09-11
2008,17DV00,302,2,6,8,eneheuvel,26-09-11
2008,17DV00,303,33,26,59,eneheuvel,26-09-11
2008,17DV00,304,39,41,80,eneheuvel,26-09-11
2008,17DV00,305,9,4,13,eneheuvel,26-09-11
2008,17DV00,306,12,6,18,eneheuvel,26-09-11
2008,17DV00,307,6,12,18,eneheuvel,26-09-11
2008,17DV00,308,10,13,23,eneheuvel,26-09-11
2008,17DV00,309,13,18,31,eneheuvel,26-09-11
2008,17DV00,310,0,2,2,eneheuvel,26-09-11
2008,17DV00,311,6,4,10,eneheuvel,26-09-11
2008,17DV00,312,0,2,2,eneheuvel,26-09-11
2008,17DV00,502,1,1,2,eneheuvel,26-09-11
2008,17DV00,9999,1,2,3,eneheuvel,26-09-11
2008,17FI00,101,0,1,1,eneheuvel,26-09-11
2008,17FI00,102,1,1,2,eneheuvel,26-09-11
2008,17FI00,103,4,3,7,eneheuvel,26-09-11
2008,17FI00,104,2,0,2,eneheuvel,26-09-11
2008,17FI00,105,2,1,3,eneheuvel,26-09-11
2008,17FI00,106,1,1,2,eneheuvel,26-09-11
2008,17FI00,108,2,2,4,eneheuvel,26-09-11
2008,17FI00,201,1,1,2,eneheuvel,26-09-11
2008,17FI00,202,3,25,28,eneheuvel,26-09-11
2008,17FI00,203,8,11,19,eneheuvel,26-09-11
2008,17FI00,204,6,6,12,eneheuvel,26-09-11
2008,17FI00,205,1,9,10,eneheuvel,26-09-11
2008,17FI00,206,9,5,14,eneheuvel,26-09-11
2008,17FI00,207,4,5,9,eneheuvel,26-09-11
2008,17FI00,208,4,11,15,eneheuvel,26-09-11
2008,17FI00,209,2,1,3,eneheuvel,26-09-11
2008,17FI00,210,4,5,9,eneheuvel,26-09-11
2008,17FI00,211,10,6,16,eneheuvel,26-09-11
2008,17FI00,212,2,7,9,eneheuvel,26-09-11
2008,17FI00,213,4,4,8,eneheuvel,26-09-11
2008,17FI00,214,1,5,6,eneheuvel,26-09-11
2008,17FI00,216,2,0,2,eneheuvel,26-09-11
2008,17FI00,302,1,3,4,eneheuvel,26-09-11
2008,17FI00,303,4,3,7,eneheuvel,26-09-11
2008,17FI00,304,6,4,10,eneheuvel,26-09-11
2008,17FI00,305,1,7,8,eneheuvel,26-09-11
2008,17FI00,306,2,1,3,eneheuvel,26-09-11
2008,17FI00,307,4,6,10,eneheuvel,26-09-11
2008,17FI00,308,2,1,3,eneheuvel,26-09-11
2008,17FI00,309,6,1,7,eneheuvel,26-09-11
2008,17FI00,310,0,2,2,eneheuvel,26-09-11
2008,17FI00,311,2,4,6,eneheuvel,26-09-11
2008,17FI00,312,1,1,2,eneheuvel,26-09-11
2008,17FI00,313,1,0,1,eneheuvel,26-09-11
2008,17FI00,402,1,0,1,eneheuvel,26-09-11
2008,17FI00,502,1,0,1,eneheuvel,26-09-11
2008,17FI00,9999,0,1,1,eneheuvel,26-09-11
2008,17LP00,209,0,2,2,eneheuvel,26-09-11
2008,17LP00,211,0,1,1,eneheuvel,26-09-11
2008,17LP00,301,1,0,1,eneheuvel,26-09-11
2008,17LP00,302,2,0,2,eneheuvel,26-09-11
2008,17LP00,305,54,46,100,eneheuvel,26-09-11
2008,17LP00,306,7,3,10,eneheuvel,26-09-11
2008,17LP00,308,1,1,2,eneheuvel,26-09-11
2008,17LP00,309,3,1,4,eneheuvel,26-09-11
2008,17LP00,9999,1,0,1,eneheuvel,26-09-11
2008,17MH00,202,1,1,2,eneheuvel,26-09-11
2008,17MH00,203,1,0,1,eneheuvel,26-09-11
2008,17MH00,206,0,1,1,eneheuvel,26-09-11
2008,17MH00,210,0,3,3,eneheuvel,26-09-11
2008,17MH00,212,1,0,1,eneheuvel,26-09-11
2008,17MH00,216,0,1,1,eneheuvel,26-09-11
2008,17MH00,302,0,2,2,eneheuvel,26-09-11
2008,17MH00,303,0,1,1,eneheuvel,26-09-11
2008,17MH00,304,0,1,1,eneheuvel,26-09-11
2008,17MH00,305,60,66,126,eneheuvel,26-09-11
2008,17MH00,306,4,1,5,eneheuvel,26-09-11
2008,17MH00,311,0,1,1,eneheuvel,26-09-11
2008,21KO00,106,0,1,1,eneheuvel,26-09-11
2008,21KO00,202,1,0,1,eneheuvel,26-09-11
2008,21KO00,206,1,0,1,eneheuvel,26-09-11
2008,21KO00,209,2,5,7,eneheuvel,26-09-11
2008,21KO00,210,91,89,180,eneheuvel,26-09-11
2008,21KO00,211,2,0,2,eneheuvel,26-09-11
2008,21KO00,212,1,0,1,eneheuvel,26-09-11
2008,21KO00,213,0,1,1,eneheuvel,26-09-11
2008,21KO00,214,0,2,2,eneheuvel,26-09-11
2008,21KO00,216,0,2,2,eneheuvel,26-09-11
2008,21KO00,309,0,1,1,eneheuvel,26-09-11
2008,21KO00,9999,0,2,2,eneheuvel,26-09-11
2008,21NC00,103,0,1,1,eneheuvel,26-09-11
2008,21NC00,104,1,0,1,eneheuvel,26-09-11
2008,21NC00,110,2,0,2,eneheuvel,26-09-11
2008,21NC00,208,0,1,1,eneheuvel,26-09-11
2008,21NC00,211,7,0,7,eneheuvel,26-09-11
2008,21NC00,212,5,6,11,eneheuvel,26-09-11
2008,21NC00,213,54,58,112,eneheuvel,26-09-11
2008,21NC00,214,5,6,11,eneheuvel,26-09-11
2008,21NC00,303,1,0,1,eneheuvel,26-09-11
2008,21NC00,309,0,1,1,eneheuvel,26-09-11
2008,21NC00,9999,2,1,3,eneheuvel,26-09-11
2008,21ND00,102,1,1,2,eneheuvel,26-09-11
2008,21ND00,201,0,1,1,eneheuvel,26-09-11
2008,21ND00,202,2,0,2,eneheuvel,26-09-11
2008,21ND00,208,0,1,1,eneheuvel,26-09-11
2008,21ND00,209,1,0,1,eneheuvel,26-09-11
2008,21ND00,211,11,13,24,eneheuvel,26-09-11
2008,21ND00,212,3,5,8,eneheuvel,26-09-11
2008,21ND00,213,64,83,147,eneheuvel,26-09-11
2008,21ND00,302,0,1,1,eneheuvel,26-09-11
2008,21ND00,304,0,1,1,eneheuvel,26-09-11
2008,21ND00,312,0,1,1,eneheuvel,26-09-11
2008,21ND00,402,1,0,1,eneheuvel,26-09-11
2008,22KP00,202,2,0,2,eneheuvel,26-09-11
2008,22KP00,203,1,1,2,eneheuvel,26-09-11
2008,22KP00,204,2,0,2,eneheuvel,26-09-11
2008,22KP00,207,1,3,4,eneheuvel,26-09-11
2008,22KP00,208,1,0,1,eneheuvel,26-09-11
2008,22KP00,210,2,0,2,eneheuvel,26-09-11
2008,22KP00,211,2,0,2,eneheuvel,26-09-11
2008,22KP00,301,1,1,2,eneheuvel,26-09-11
2008,22KP00,302,3,5,8,eneheuvel,26-09-11
2008,22KP00,303,3,3,6,eneheuvel,26-09-11
2008,22KP00,304,2,5,7,eneheuvel,26-09-11
2008,22KP00,306,0,3,3,eneheuvel,26-09-11
2008,22KP00,307,0,1,1,eneheuvel,26-09-11
2008,22KP00,308,3,8,11,eneheuvel,26-09-11
2008,22KP00,309,117,153,270,eneheuvel,26-09-11
2008,22KP00,310,5,5,10,eneheuvel,26-09-11
2008,22KP00,311,13,21,34,eneheuvel,26-09-11
2008,22KP00,312,4,3,7,eneheuvel,26-09-11
2008,22KP00,9999,2,2,4,eneheuvel,26-09-11
2008,22KQ00,201,2,0,2,eneheuvel,26-09-11
2008,22KQ00,205,0,2,2,eneheuvel,26-09-11
2008,22KQ00,206,1,0,1,eneheuvel,26-09-11
2008,22KQ00,209,0,2,2,eneheuvel,26-09-11
2008,22KQ00,210,63,106,169,eneheuvel,26-09-11
2008,22KQ00,211,0,2,2,eneheuvel,26-09-11
2008,22KQ00,212,1,0,1,eneheuvel,26-09-11
2008,22KQ00,214,0,2,2,eneheuvel,26-09-11
2008,22KQ00,215,0,1,1,eneheuvel,26-09-11
2008,22KQ00,216,0,2,2,eneheuvel,26-09-11
2008,22KQ00,307,0,1,1,eneheuvel,26-09-11
2008,22KQ00,312,1,0,1,eneheuvel,26-09-11
2008,23EP00,202,0,2,2,eneheuvel,26-09-11
2008,23EP00,212,24,41,65,eneheuvel,26-09-11
2008,23EP00,213,6,8,14,eneheuvel,26-09-11
2008,23EP00,214,1,2,3,eneheuvel,26-09-11
2008,23EP00,216,0,1,1,eneheuvel,26-09-11
2008,23EP00,303,0,1,1,eneheuvel,26-09-11
2008,23ER00,108,0,1,1,eneheuvel,26-09-11
2008,23ER00,201,1,0,1,eneheuvel,26-09-11
2008,23ER00,203,0,1,1,eneheuvel,26-09-11
2008,23ER00,210,1,0,1,eneheuvel,26-09-11
2008,23ER00,212,72,92,164,eneheuvel,26-09-11
2008,23ER00,213,2,0,2,eneheuvel,26-09-11
2008,23ER00,214,3,3,6,eneheuvel,26-09-11
2008,23ER00,303,0,1,1,eneheuvel,26-09-11
2008,23ET00,201,1,0,1,eneheuvel,26-09-11
2008,23ET00,203,1,0,1,eneheuvel,26-09-11
2008,23ET00,204,1,0,1,eneheuvel,26-09-11
2008,23ET00,208,0,2,2,eneheuvel,26-09-11
2008,23ET00,210,0,1,1,eneheuvel,26-09-11
2008,23ET00,214,1,1,2,eneheuvel,26-09-11
2008,23ET00,301,0,1,1,eneheuvel,26-09-11
2008,23ET00,302,0,2,2,eneheuvel,26-09-11
2008,23ET00,304,0,1,1,eneheuvel,26-09-11
2008,23ET00,306,2,7,9,eneheuvel,26-09-11
2008,23ET00,307,4,8,12,eneheuvel,26-09-11
2008,23ET00,308,61,90,151,eneheuvel,26-09-11
2008,23ET00,309,7,7,14,eneheuvel,26-09-11
2008,23ET00,310,0,1,1,eneheuvel,26-09-11
2008,23ET00,311,2,2,4,eneheuvel,26-09-11
2008,23ET00,312,6,3,9,eneheuvel,26-09-11
2008,23ET00,9999,1,0,1,eneheuvel,26-09-11
2008,23EU00,105,0,1,1,eneheuvel,26-09-11
2008,23EU00,207,2,0,2,eneheuvel,26-09-11
2008,23EU00,208,0,1,1,eneheuvel,26-09-11
2008,23EU00,301,0,2,2,eneheuvel,26-09-11
2008,23EU00,303,1,1,2,eneheuvel,26-09-11
2008,23EU00,305,0,6,6,eneheuvel,26-09-11
2008,23EU00,306,102,96,198,eneheuvel,26-09-11
2008,23EU00,307,6,6,12,eneheuvel,26-09-11
2008,23EU00,308,1,2,3,eneheuvel,26-09-11
2008,23EU00,309,2,0,2,eneheuvel,26-09-11
2008,23EU00,310,0,1,1,eneheuvel,26-09-11
2008,23EU00,311,0,1,1,eneheuvel,26-09-11
2008,23EU00,313,0,1,1,eneheuvel,26-09-11
2008,23EU00,402,0,1,1,eneheuvel,26-09-11
2008,23EU00,9999,1,2,3,eneheuvel,26-09-11
2008,23EV00,102,0,1,1,eneheuvel,26-09-11
2008,23EV00,201,0,1,1,eneheuvel,26-09-11
2008,23EV00,203,0,1,1,eneheuvel,26-09-11
2008,23EV00,207,1,1,2,eneheuvel,26-09-11
2008,23EV00,208,0,1,1,eneheuvel,26-09-11
2008,23EV00,209,1,0,1,eneheuvel,26-09-11
2008,23EV00,210,12,8,20,eneheuvel,26-09-11
2008,23EV00,211,9,9,18,eneheuvel,26-09-11
2008,23EV00,212,109,127,236,eneheuvel,26-09-11
2008,23EV00,213,28,25,53,eneheuvel,26-09-11
2008,23EV00,214,2,2,4,eneheuvel,26-09-11
2008,23EV00,216,0,2,2,eneheuvel,26-09-11
2008,23EV00,302,1,0,1,eneheuvel,26-09-11
2008,23EV00,304,0,1,1,eneheuvel,26-09-11
2008,23EV00,307,1,1,2,eneheuvel,26-09-11
2008,23EV00,9999,1,0,1,eneheuvel,26-09-11
2008,23EY00,103,1,0,1,eneheuvel,26-09-11
2008,23EY00,201,1,1,2,eneheuvel,26-09-11
2008,23EY00,206,1,1,2,eneheuvel,26-09-11
2008,23EY00,208,2,1,3,eneheuvel,26-09-11
2008,23EY00,209,2,2,4,eneheuvel,26-09-11
2008,23EY00,210,8,9,17,eneheuvel,26-09-11
2008,23EY00,211,15,9,24,eneheuvel,26-09-11
2008,23EY00,212,114,135,249,eneheuvel,26-09-11
2008,23EY00,213,31,21,52,eneheuvel,26-09-11
2008,23EY00,214,4,2,6,eneheuvel,26-09-11
2008,23EY00,215,2,0,2,eneheuvel,26-09-11
2008,23EY00,216,0,1,1,eneheuvel,26-09-11
2008,23EY00,302,1,0,1,eneheuvel,26-09-11
2008,23EY00,304,0,1,1,eneheuvel,26-09-11
2008,23EY00,305,1,0,1,eneheuvel,26-09-11
2008,23EY00,502,0,1,1,eneheuvel,26-09-11
2008,23EY00,9999,4,1,5,eneheuvel,26-09-11
2008,23ZU00,110,1,0,1,eneheuvel,26-09-11
2008,23ZU00,202,74,79,153,eneheuvel,26-09-11
2008,23ZU00,203,5,8,13,eneheuvel,26-09-11
2008,23ZU00,204,52,53,105,eneheuvel,26-09-11
2008,23ZU00,205,93,97,190,eneheuvel,26-09-11
2008,23ZU00,206,2,1,3,eneheuvel,26-09-11
2008,23ZU00,207,30,14,44,eneheuvel,26-09-11
2008,23ZU00,208,16,22,38,eneheuvel,26-09-11
2008,23ZU00,209,1,0,1,eneheuvel,26-09-11
2008,23ZU00,210,2,2,4,eneheuvel,26-09-11
2008,23ZU00,211,1,3,4,eneheuvel,26-09-11
2008,23ZU00,212,0,2,2,eneheuvel,26-09-11
2008,23ZU00,213,1,0,1,eneheuvel,26-09-11
2008,23ZU00,214,0,2,2,eneheuvel,26-09-11
2008,23ZU00,215,0,2,2,eneheuvel,26-09-11
2008,23ZU00,216,4,1,5,eneheuvel,26-09-11
2008,23ZU00,302,0,1,1,eneheuvel,26-09-11
2008,23ZU00,303,0,5,5,eneheuvel,26-09-11
2008,23ZU00,306,2,0,2,eneheuvel,26-09-11
2008,23ZU00,307,0,1,1,eneheuvel,26-09-11
2008,23ZU00,309,1,1,2,eneheuvel,26-09-11
2008,23ZU00,311,2,1,3,eneheuvel,26-09-11
2008,23ZU00,502,1,2,3,eneheuvel,26-09-11
2008,23ZU00,9999,0,1,1,eneheuvel,26-09-11
2008,23ZV00,107,2,1,3,eneheuvel,26-09-11
2008,23ZV00,201,4,1,5,eneheuvel,26-09-11
2008,23ZV00,202,35,43,78,eneheuvel,26-09-11
2008,23ZV00,203,3,7,10,eneheuvel,26-09-11
2008,23ZV00,204,24,32,56,eneheuvel,26-09-11
2008,23ZV00,205,43,66,109,eneheuvel,26-09-11
2008,23ZV00,206,0,1,1,eneheuvel,26-09-11
2008,23ZV00,207,6,13,19,eneheuvel,26-09-11
2008,23ZV00,208,6,9,15,eneheuvel,26-09-11
2008,23ZV00,210,0,1,1,eneheuvel,26-09-11
2008,23ZV00,211,0,3,3,eneheuvel,26-09-11
2008,23ZV00,302,0,1,1,eneheuvel,26-09-11
2008,23ZV00,308,2,0,2,eneheuvel,26-09-11
2008,23ZV00,309,1,0,1,eneheuvel,26-09-11
2008,23ZV00,402,1,1,2,eneheuvel,26-09-11
2008,23ZW00,201,0,1,1,eneheuvel,26-09-11
2008,23ZW00,206,1,0,1,eneheuvel,26-09-11
2008,23ZW00,207,0,2,2,eneheuvel,26-09-11
2008,23ZW00,208,2,4,6,eneheuvel,26-09-11
2008,23ZW00,211,1,1,2,eneheuvel,26-09-11
2008,23ZW00,301,4,0,4,eneheuvel,26-09-11
2008,23ZW00,302,6,0,6,eneheuvel,26-09-11
2008,23ZW00,303,3,3,6,eneheuvel,26-09-11
2008,23ZW00,304,2,2,4,eneheuvel,26-09-11
2008,23ZW00,305,3,2,5,eneheuvel,26-09-11
2008,23ZW00,306,26,37,63,eneheuvel,26-09-11
2008,23ZW00,307,80,86,166,eneheuvel,26-09-11
2008,23ZW00,308,99,81,180,eneheuvel,26-09-11
2008,23ZW00,309,8,5,13,eneheuvel,26-09-11
2008,23ZW00,310,3,1,4,eneheuvel,26-09-11
2008,23ZW00,311,1,0,1,eneheuvel,26-09-11
2008,23ZW00,312,3,4,7,eneheuvel,26-09-11
2008,23ZW00,313,0,1,1,eneheuvel,26-09-11
2008,23ZW00,502,3,2,5,eneheuvel,26-09-11
2008,23ZW00,9999,1,3,4,eneheuvel,26-09-11
2008,23ZX00,110,0,1,1,eneheuvel,26-09-11
2008,23ZX00,201,7,3,10,eneheuvel,26-09-11
2008,23ZX00,202,124,137,261,eneheuvel,26-09-11
2008,23ZX00,203,2,1,3,eneheuvel,26-09-11
2008,23ZX00,204,4,3,7,eneheuvel,26-09-11
2008,23ZX00,205,3,8,11,eneheuvel,26-09-11
2008,23ZX00,206,0,1,1,eneheuvel,26-09-11
2008,23ZX00,207,1,7,8,eneheuvel,26-09-11
2008,23ZX00,208,8,11,19,eneheuvel,26-09-11
2008,23ZX00,209,2,0,2,eneheuvel,26-09-11
2008,23ZX00,210,1,1,2,eneheuvel,26-09-11
2008,23ZX00,211,3,3,6,eneheuvel,26-09-11
2008,23ZX00,306,1,2,3,eneheuvel,26-09-11
2008,23ZX00,307,0,1,1,eneheuvel,26-09-11
2008,23ZX00,9999,0,1,1,eneheuvel,26-09-11
2008,23ZY00,107,0,1,1,eneheuvel,26-09-11
2008,23ZY00,109,0,1,1,eneheuvel,26-09-11
2008,23ZY00,203,1,0,1,eneheuvel,26-09-11
2008,23ZY00,206,1,1,2,eneheuvel,26-09-11
2008,23ZY00,210,2,0,2,eneheuvel,26-09-11
2008,23ZY00,211,2,1,3,eneheuvel,26-09-11
2008,23ZY00,212,167,188,355,eneheuvel,26-09-11
2008,23ZY00,213,4,0,4,eneheuvel,26-09-11
2008,23ZY00,214,1,1,2,eneheuvel,26-09-11
2008,23ZY00,215,0,1,1,eneheuvel,26-09-11
2008,23ZY00,216,0,1,1,eneheuvel,26-09-11
2008,23ZY00,302,0,1,1,eneheuvel,26-09-11
2008,23ZY00,9999,1,1,2,eneheuvel,26-09-11
2008,24EJ00,101,1,0,1,eneheuvel,26-09-11
2008,24EJ00,102,3,3,6,eneheuvel,26-09-11
2008,24EJ00,103,1,0,1,eneheuvel,26-09-11
2008,24EJ00,106,1,2,3,eneheuvel,26-09-11
2008,24EJ00,107,3,0,3,eneheuvel,26-09-11
2008,24EJ00,108,3,1,4,eneheuvel,26-09-11
2008,24EJ00,201,3,0,3,eneheuvel,26-09-11
2008,24EJ00,202,4,4,8,eneheuvel,26-09-11
2008,24EJ00,203,0,2,2,eneheuvel,26-09-11
2008,24EJ00,204,7,5,12,eneheuvel,26-09-11
2008,24EJ00,205,1,4,5,eneheuvel,26-09-11
2008,24EJ00,206,1,2,3,eneheuvel,26-09-11
2008,24EJ00,207,3,2,5,eneheuvel,26-09-11
2008,24EJ00,208,2,9,11,eneheuvel,26-09-11
2008,24EJ00,209,17,10,27,eneheuvel,26-09-11
2008,24EJ00,210,21,19,40,eneheuvel,26-09-11
2008,24EJ00,211,36,27,63,eneheuvel,26-09-11
2008,24EJ00,212,10,9,19,eneheuvel,26-09-11
2008,24EJ00,213,5,4,9,eneheuvel,26-09-11
2008,24EJ00,214,4,5,9,eneheuvel,26-09-11
2008,24EJ00,303,1,1,2,eneheuvel,26-09-11
2008,24EJ00,308,1,0,1,eneheuvel,26-09-11
2008,24EJ00,309,0,1,1,eneheuvel,26-09-11
2008,24EJ00,9999,1,1,2,eneheuvel,26-09-11
2008,24FT00,102,1,0,1,eneheuvel,26-09-11
2008,24FT00,103,0,2,2,eneheuvel,26-09-11
2008,24FT00,105,0,2,2,eneheuvel,26-09-11
2008,24FT00,106,0,2,2,eneheuvel,26-09-11
2008,24FT00,108,0,1,1,eneheuvel,26-09-11
2008,24FT00,109,1,0,1,eneheuvel,26-09-11
2008,24FT00,203,1,4,5,eneheuvel,26-09-11
2008,24FT00,204,0,3,3,eneheuvel,26-09-11
2008,24FT00,205,0,2,2,eneheuvel,26-09-11
2008,24FT00,206,2,6,8,eneheuvel,26-09-11
2008,24FT00,207,0,2,2,eneheuvel,26-09-11
2008,24FT00,208,2,7,9,eneheuvel,26-09-11
2008,24FT00,209,1,1,2,eneheuvel,26-09-11
2008,24FT00,210,0,3,3,eneheuvel,26-09-11
2008,24FT00,211,5,5,10,eneheuvel,26-09-11
2008,24FT00,212,3,17,20,eneheuvel,26-09-11
2008,24FT00,213,4,5,9,eneheuvel,26-09-11
2008,24FT00,214,2,18,20,eneheuvel,26-09-11
2008,24FT00,301,2,0,2,eneheuvel,26-09-11
2008,24FT00,302,3,16,19,eneheuvel,26-09-11
2008,24FT00,303,1,15,16,eneheuvel,26-09-11
2008,24FT00,304,1,6,7,eneheuvel,26-09-11
2008,24FT00,305,0,4,4,eneheuvel,26-09-11
2008,24FT00,306,3,4,7,eneheuvel,26-09-11
2008,24FT00,307,1,7,8,eneheuvel,26-09-11
2008,24FT00,308,1,11,12,eneheuvel,26-09-11
2008,24FT00,309,0,5,5,eneheuvel,26-09-11
2008,24FT00,311,3,8,11,eneheuvel,26-09-11
2008,24FT00,312,4,12,16,eneheuvel,26-09-11
2008,24FT00,502,0,2,2,eneheuvel,26-09-11
2008,24FT00,9999,0,4,4,eneheuvel,26-09-11
2008,24MR00,108,0,1,1,eneheuvel,26-09-11
2008,24MR00,201,0,2,2,eneheuvel,26-09-11
2008,24MR00,207,1,0,1,eneheuvel,26-09-11
2008,24MR00,208,1,1,2,eneheuvel,26-09-11
2008,24MR00,301,1,0,1,eneheuvel,26-09-11
2008,24MR00,305,1,0,1,eneheuvel,26-09-11
2008,24MR00,306,10,17,27,eneheuvel,26-09-11
2008,24MR00,307,110,145,255,eneheuvel,26-09-11
2008,24MR00,308,5,10,15,eneheuvel,26-09-11
2008,24MR00,309,1,0,1,eneheuvel,26-09-11
2008,24MR00,311,1,1,2,eneheuvel,26-09-11
2008,24MR00,502,0,2,2,eneheuvel,26-09-11
2008,24RK00,108,0,1,1,eneheuvel,26-09-11
2008,24RK00,202,9,19,28,eneheuvel,26-09-11
2008,24RK00,203,12,10,22,eneheuvel,26-09-11
2008,24RK00,204,9,16,25,eneheuvel,26-09-11
2008,24RK00,205,7,7,14,eneheuvel,26-09-11
2008,24RK00,206,4,0,4,eneheuvel,26-09-11
2008,24RK00,207,7,3,10,eneheuvel,26-09-11
2008,24RK00,208,4,2,6,eneheuvel,26-09-11
2008,24RK00,210,0,2,2,eneheuvel,26-09-11
2008,24RK00,211,2,0,2,eneheuvel,26-09-11
2008,24RK00,212,2,0,2,eneheuvel,26-09-11
2008,24RK00,213,1,2,3,eneheuvel,26-09-11
2008,24RK00,214,1,1,2,eneheuvel,26-09-11
2008,24RK00,216,1,3,4,eneheuvel,26-09-11
2008,24RK00,301,1,1,2,eneheuvel,26-09-11
2008,24RK00,302,4,3,7,eneheuvel,26-09-11
2008,24RK00,303,8,3,11,eneheuvel,26-09-11
2008,24RK00,304,3,5,8,eneheuvel,26-09-11
2008,24RK00,305,0,2,2,eneheuvel,26-09-11
2008,24RK00,306,4,4,8,eneheuvel,26-09-11
2008,24RK00,307,6,3,9,eneheuvel,26-09-11
2008,24RK00,308,5,4,9,eneheuvel,26-09-11
2008,24RK00,309,3,2,5,eneheuvel,26-09-11
2008,24RK00,311,1,0,1,eneheuvel,26-09-11
2008,24RK00,312,1,0,1,eneheuvel,26-09-11
2008,24RK00,9999,0,2,2,eneheuvel,26-09-11
2008,24UN00,201,2,0,2,eneheuvel,26-09-11
2008,24UN00,202,2,0,2,eneheuvel,26-09-11
2008,24UN00,204,0,1,1,eneheuvel,26-09-11
2008,24UN00,302,1,0,1,eneheuvel,26-09-11
2008,24UN00,303,1,0,1,eneheuvel,26-09-11
2008,24UN00,305,1,0,1,eneheuvel,26-09-11
2008,24UN00,306,21,26,47,eneheuvel,26-09-11
2008,24UN00,307,38,42,80,eneheuvel,26-09-11
2008,24UN00,308,54,48,102,eneheuvel,26-09-11
2008,24UN00,309,16,14,30,eneheuvel,26-09-11
2008,24UN00,311,3,2,5,eneheuvel,26-09-11
2008,24UN00,313,1,0,1,eneheuvel,26-09-11
2008,24UN00,9999,2,0,2,eneheuvel,26-09-11
2008,25CF00,202,3,6,9,eneheuvel,26-09-11
2008,25CF00,203,2,3,5,eneheuvel,26-09-11
2008,25CF00,204,66,80,146,eneheuvel,26-09-11
2008,25CF00,205,16,51,67,eneheuvel,26-09-11
2008,25CF00,206,1,0,1,eneheuvel,26-09-11
2008,25CF00,207,2,5,7,eneheuvel,26-09-11
2008,25CF00,208,4,7,11,eneheuvel,26-09-11
2008,25CF00,212,1,0,1,eneheuvel,26-09-11
2008,25CF00,303,0,1,1,eneheuvel,26-09-11
2008,25CF00,309,1,0,1,eneheuvel,26-09-11
2008,25CF00,9999,1,1,2,eneheuvel,26-09-11
2008,25KT00,101,1,1,2,eneheuvel,26-09-11
2008,25KT00,107,1,1,2,eneheuvel,26-09-11
2008,25KT00,202,47,54,101,eneheuvel,26-09-11
2008,25KT00,203,99,83,182,eneheuvel,26-09-11
2008,25KT00,204,88,86,174,eneheuvel,26-09-11
2008,25KT00,205,3,7,10,eneheuvel,26-09-11
2008,25KT00,206,1,0,1,eneheuvel,26-09-11
2008,25KT00,207,20,8,28,eneheuvel,26-09-11
2008,25KT00,208,40,37,77,eneheuvel,26-09-11
2008,25KT00,211,1,0,1,eneheuvel,26-09-11
2008,25KT00,214,0,1,1,eneheuvel,26-09-11
2008,25KT00,302,2,0,2,eneheuvel,26-09-11
2008,25KT00,309,1,1,2,eneheuvel,26-09-11
2008,25KT00,502,3,13,16,eneheuvel,26-09-11
2008,25KT00,9999,1,0,1,eneheuvel,26-09-11
2008,25KU00,110,2,2,4,eneheuvel,26-09-11
2008,25KU00,201,0,1,1,eneheuvel,26-09-11
2008,25KU00,202,26,28,54,eneheuvel,26-09-11
2008,25KU00,203,77,59,136,eneheuvel,26-09-11
2008,25KU00,204,59,77,136,eneheuvel,26-09-11
2008,25KU00,205,3,3,6,eneheuvel,26-09-11
2008,25KU00,206,1,0,1,eneheuvel,26-09-11
2008,25KU00,207,11,6,17,eneheuvel,26-09-11
2008,25KU00,208,23,32,55,eneheuvel,26-09-11
2008,25KU00,211,1,1,2,eneheuvel,26-09-11
2008,25KU00,216,2,0,2,eneheuvel,26-09-11
2008,25KU00,303,1,0,1,eneheuvel,26-09-11
2008,25KU00,306,1,0,1,eneheuvel,26-09-11
2008,25KU00,308,1,0,1,eneheuvel,26-09-11
2008,25KU00,309,1,0,1,eneheuvel,26-09-11
2008,25KU00,312,1,0,1,eneheuvel,26-09-11
2008,25KU00,313,1,0,1,eneheuvel,26-09-11
2008,25KU00,502,3,13,16,eneheuvel,26-09-11
2008,25KU00,9999,1,3,4,eneheuvel,26-09-11
2008,25KV00,102,0,1,1,eneheuvel,26-09-11
2008,25KV00,104,1,0,1,eneheuvel,26-09-11
2008,25KV00,108,1,0,1,eneheuvel,26-09-11
2008,25KV00,201,0,1,1,eneheuvel,26-09-11
2008,25KV00,202,3,3,6,eneheuvel,26-09-11
2008,25KV00,203,167,191,358,eneheuvel,26-09-11
2008,25KV00,204,1,9,10,eneheuvel,26-09-11
2008,25KV00,205,0,1,1,eneheuvel,26-09-11
2008,25KV00,207,1,2,3,eneheuvel,26-09-11
2008,25KV00,208,1,6,7,eneheuvel,26-09-11
2008,25KV00,211,1,2,3,eneheuvel,26-09-11
2008,25KV00,214,0,1,1,eneheuvel,26-09-11
2008,25KV00,302,0,1,1,eneheuvel,26-09-11
2008,25KV00,309,0,1,1,eneheuvel,26-09-11
2008,25KV00,9999,0,1,1,eneheuvel,26-09-11
2008,26AB00,101,0,1,1,eneheuvel,26-09-11
2008,26AB00,109,1,1,2,eneheuvel,26-09-11
2008,26AB00,208,0,1,1,eneheuvel,26-09-11
2008,26AB00,211,0,1,1,eneheuvel,26-09-11
2008,26AB00,214,1,0,1,eneheuvel,26-09-11
2008,26AB00,301,2,0,2,eneheuvel,26-09-11
2008,26AB00,302,15,22,37,eneheuvel,26-09-11
2008,26AB00,303,174,187,361,eneheuvel,26-09-11
2008,26AB00,304,3,4,7,eneheuvel,26-09-11
2008,26AB00,305,1,0,1,eneheuvel,26-09-11
2008,26AB00,306,0,4,4,eneheuvel,26-09-11
2008,26AB00,308,0,2,2,eneheuvel,26-09-11
2008,26AB00,309,4,1,5,eneheuvel,26-09-11
2008,26AB00,310,1,0,1,eneheuvel,26-09-11
2008,26AB00,311,4,3,7,eneheuvel,26-09-11
2008,26AB00,312,2,3,5,eneheuvel,26-09-11
2008,26AB00,313,4,2,6,eneheuvel,26-09-11
2008,26AB00,402,0,1,1,eneheuvel,26-09-11
2008,26AB00,9999,2,3,5,eneheuvel,26-09-11
2008,26AC00,107,0,4,4,eneheuvel,26-09-11
2008,26AC00,108,0,1,1,eneheuvel,26-09-11
2008,26AC00,109,23,10,33,eneheuvel,26-09-11
2008,26AC00,201,0,1,1,eneheuvel,26-09-11
2008,26AC00,203,2,0,2,eneheuvel,26-09-11
2008,26AC00,204,1,1,2,eneheuvel,26-09-11
2008,26AC00,207,0,1,1,eneheuvel,26-09-11
2008,26AC00,210,0,1,1,eneheuvel,26-09-11
2008,26AC00,211,5,7,12,eneheuvel,26-09-11
2008,26AC00,212,10,14,24,eneheuvel,26-09-11
2008,26AC00,213,8,17,25,eneheuvel,26-09-11
2008,26AC00,214,471,361,832,eneheuvel,26-09-11
2008,26AC00,215,1,0,1,eneheuvel,26-09-11
2008,26AC00,216,2,0,2,eneheuvel,26-09-11
2008,26AC00,301,1,0,1,eneheuvel,26-09-11
2008,26AC00,302,1,0,1,eneheuvel,26-09-11
2008,26AC00,303,0,1,1,eneheuvel,26-09-11
2008,26AC00,311,3,0,3,eneheuvel,26-09-11
2008,26AC00,312,2,0,2,eneheuvel,26-09-11
2008,26AC00,402,1,1,2,eneheuvel,26-09-11
2008,26AC00,9999,3,4,7,eneheuvel,26-09-11
2008,26AD00,204,0,2,2,eneheuvel,26-09-11
2008,26AD00,208,3,0,3,eneheuvel,26-09-11
2008,26AD00,210,1,0,1,eneheuvel,26-09-11
2008,26AD00,213,1,0,1,eneheuvel,26-09-11
2008,26AD00,214,1,1,2,eneheuvel,26-09-11
2008,26AD00,301,1,1,2,eneheuvel,26-09-11
2008,26AD00,302,89,68,157,eneheuvel,26-09-11
2008,26AD00,303,46,26,72,eneheuvel,26-09-11
2008,26AD00,304,2,1,3,eneheuvel,26-09-11
2008,26AD00,305,3,3,6,eneheuvel,26-09-11
2008,26AD00,306,0,2,2,eneheuvel,26-09-11
2008,26AD00,307,1,1,2,eneheuvel,26-09-11
2008,26AD00,308,1,1,2,eneheuvel,26-09-11
2008,26AD00,309,79,37,116,eneheuvel,26-09-11
2008,26AD00,310,25,6,31,eneheuvel,26-09-11
2008,26AD00,311,36,31,67,eneheuvel,26-09-11
2008,26AD00,312,8,6,14,eneheuvel,26-09-11
2008,26AD00,313,7,10,17,eneheuvel,26-09-11
2008,26AD00,502,0,1,1,eneheuvel,26-09-11
2008,26AD00,9999,0,1,1,eneheuvel,26-09-11
2008,26PD00,101,0,1,1,eneheuvel,26-09-11
2008,26PD00,104,2,0,2,eneheuvel,26-09-11
2008,26PD00,108,3,0,3,eneheuvel,26-09-11
2008,26PD00,204,1,7,8,eneheuvel,26-09-11
2008,26PD00,205,5,5,10,eneheuvel,26-09-11
2008,26PD00,207,148,182,330,eneheuvel,26-09-11
2008,26PD00,208,32,49,81,eneheuvel,26-09-11
2008,26PD00,211,0,1,1,eneheuvel,26-09-11
2008,26PD00,308,2,1,3,eneheuvel,26-09-11
2008,26PD00,309,0,1,1,eneheuvel,26-09-11
2008,26PD00,401,0,1,1,eneheuvel,26-09-11
2008,26PD00,502,2,2,4,eneheuvel,26-09-11
2008,26PD00,9999,4,3,7,eneheuvel,26-09-11
2008,26PE00,201,1,1,2,eneheuvel,26-09-11
2008,26PE00,202,1,0,1,eneheuvel,26-09-11
2008,26PE00,208,2,1,3,eneheuvel,26-09-11
2008,26PE00,301,2,0,2,eneheuvel,26-09-11
2008,26PE00,302,234,251,485,eneheuvel,26-09-11
2008,26PE00,303,25,17,42,eneheuvel,26-09-11
2008,26PE00,305,1,0,1,eneheuvel,26-09-11
2008,26PE00,307,1,0,1,eneheuvel,26-09-11
2008,26PE00,309,4,1,5,eneheuvel,26-09-11
2008,26PE00,311,3,6,9,eneheuvel,26-09-11
2008,26PE00,312,3,5,8,eneheuvel,26-09-11
2008,26PE00,313,7,4,11,eneheuvel,26-09-11
2008,26PE00,402,0,1,1,eneheuvel,26-09-11
2008,26PE00,9999,5,1,6,eneheuvel,26-09-11
2008,26PF00,103,1,0,1,eneheuvel,26-09-11
2008,26PF00,201,1,1,2,eneheuvel,26-09-11
2008,26PF00,202,1,0,1,eneheuvel,26-09-11
2008,26PF00,204,3,0,3,eneheuvel,26-09-11
2008,26PF00,206,2,1,3,eneheuvel,26-09-11
2008,26PF00,208,0,1,1,eneheuvel,26-09-11
2008,26PF00,209,2,1,3,eneheuvel,26-09-11
2008,26PF00,210,2,0,2,eneheuvel,26-09-11
2008,26PF00,211,4,10,14,eneheuvel,26-09-11
2008,26PF00,212,9,2,11,eneheuvel,26-09-11
2008,26PF00,213,4,4,8,eneheuvel,26-09-11
2008,26PF00,214,181,207,388,eneheuvel,26-09-11
2008,26PF00,216,2,2,4,eneheuvel,26-09-11
2008,26PF00,302,2,3,5,eneheuvel,26-09-11
2008,26PF00,305,0,1,1,eneheuvel,26-09-11
2008,26PF00,308,1,0,1,eneheuvel,26-09-11
2008,26PF00,309,2,1,3,eneheuvel,26-09-11
2008,26PF00,310,0,1,1,eneheuvel,26-09-11
2008,26PF00,402,0,1,1,eneheuvel,26-09-11
2008,26PF00,502,2,0,2,eneheuvel,26-09-11
2008,26PF00,9999,8,6,14,eneheuvel,26-09-11
2008,26PG00,101,1,0,1,eneheuvel,26-09-11
2008,26PG00,103,0,1,1,eneheuvel,26-09-11
2008,26PG00,108,1,0,1,eneheuvel,26-09-11
2008,26PG00,207,1,0,1,eneheuvel,26-09-11
2008,26PG00,209,1,0,1,eneheuvel,26-09-11
2008,26PG00,210,1,0,1,eneheuvel,26-09-11
2008,26PG00,211,2,1,3,eneheuvel,26-09-11
2008,26PG00,212,0,2,2,eneheuvel,26-09-11
2008,26PG00,213,1,1,2,eneheuvel,26-09-11
2008,26PG00,214,62,89,151,eneheuvel,26-09-11
2008,26PG00,307,0,2,2,eneheuvel,26-09-11
2008,26PG00,9999,3,2,5,eneheuvel,26-09-11
2008,26PH00,204,0,1,1,eneheuvel,26-09-11
2008,26PH00,207,0,1,1,eneheuvel,26-09-11
2008,26PH00,211,1,0,1,eneheuvel,26-09-11
2008,26PH00,212,1,0,1,eneheuvel,26-09-11
2008,26PH00,216,0,2,2,eneheuvel,26-09-11
2008,26PH00,301,1,0,1,eneheuvel,26-09-11
2008,26PH00,302,30,15,45,eneheuvel,26-09-11
2008,26PH00,303,5,9,14,eneheuvel,26-09-11
2008,26PH00,304,3,1,4,eneheuvel,26-09-11
2008,26PH00,305,3,1,4,eneheuvel,26-09-11
2008,26PH00,306,1,0,1,eneheuvel,26-09-11
2008,26PH00,307,1,0,1,eneheuvel,26-09-11
2008,26PH00,308,5,3,8,eneheuvel,26-09-11
2008,26PH00,309,43,30,73,eneheuvel,26-09-11
2008,26PH00,311,238,206,444,eneheuvel,26-09-11
2008,26PH00,312,17,7,24,eneheuvel,26-09-11
2008,26PH00,313,7,4,11,eneheuvel,26-09-11
2008,26PH00,9999,4,4,8,eneheuvel,26-09-11
2008,26PW00,208,0,1,1,eneheuvel,26-09-11
2008,26PW00,302,26,39,65,eneheuvel,26-09-11
2008,26PW00,303,42,22,64,eneheuvel,26-09-11
2008,26PW00,306,1,1,2,eneheuvel,26-09-11
2008,26PW00,308,5,3,8,eneheuvel,26-09-11
2008,26PW00,309,43,27,70,eneheuvel,26-09-11
2008,26PW00,310,10,6,16,eneheuvel,26-09-11
2008,26PW00,311,22,15,37,eneheuvel,26-09-11
2008,26PW00,312,4,3,7,eneheuvel,26-09-11
2008,26PW00,313,2,4,6,eneheuvel,26-09-11
2008,26PW00,9999,2,0,2,eneheuvel,26-09-11
2008,26ZZ00,105,1,0,1,eneheuvel,26-09-11
2008,26ZZ00,202,219,226,445,eneheuvel,26-09-11
2008,26ZZ00,203,7,15,22,eneheuvel,26-09-11
2008,26ZZ00,204,2,4,6,eneheuvel,26-09-11
2008,26ZZ00,205,0,1,1,eneheuvel,26-09-11
2008,26ZZ00,206,0,1,1,eneheuvel,26-09-11
2008,26ZZ00,207,1,0,1,eneheuvel,26-09-11
2008,26ZZ00,208,2,2,4,eneheuvel,26-09-11
2008,26ZZ00,210,0,1,1,eneheuvel,26-09-11
2008,26ZZ00,211,1,0,1,eneheuvel,26-09-11
2008,26ZZ00,212,1,1,2,eneheuvel,26-09-11
2008,26ZZ00,216,0,1,1,eneheuvel,26-09-11
2008,26ZZ00,309,0,2,2,eneheuvel,26-09-11
2008,26ZZ00,313,1,0,1,eneheuvel,26-09-11
2008,26ZZ00,402,1,0,1,eneheuvel,26-09-11
2008,26ZZ00,502,3,2,5,eneheuvel,26-09-11
2008,26ZZ00,9999,3,1,4,eneheuvel,26-09-11
2008,27AA00,106,1,1,2,eneheuvel,26-09-11
2008,27AA00,201,1,0,1,eneheuvel,26-09-11
2008,27AA00,202,3,1,4,eneheuvel,26-09-11
2008,27AA00,203,3,6,9,eneheuvel,26-09-11
2008,27AA00,204,9,12,21,eneheuvel,26-09-11
2008,27AA00,205,2,2,4,eneheuvel,26-09-11
2008,27AA00,206,0,1,1,eneheuvel,26-09-11
2008,27AA00,207,79,67,146,eneheuvel,26-09-11
2008,27AA00,208,192,168,360,eneheuvel,26-09-11
2008,27AA00,209,1,0,1,eneheuvel,26-09-11
2008,27AA00,210,2,1,3,eneheuvel,26-09-11
2008,27AA00,211,0,3,3,eneheuvel,26-09-11
2008,27AA00,212,0,1,1,eneheuvel,26-09-11
2008,27AA00,214,1,2,3,eneheuvel,26-09-11
2008,27AA00,216,0,1,1,eneheuvel,26-09-11
2008,27AA00,303,2,1,3,eneheuvel,26-09-11
2008,27AA00,305,0,1,1,eneheuvel,26-09-11
2008,27AA00,307,3,6,9,eneheuvel,26-09-11
2008,27AA00,308,2,1,3,eneheuvel,26-09-11
2008,27AA00,309,0,3,3,eneheuvel,26-09-11
2008,27AA00,312,1,1,2,eneheuvel,26-09-11
2008,27AA00,9999,3,1,4,eneheuvel,26-09-11
2008,27NU00,103,1,0,1,eneheuvel,26-09-11
2008,27NU00,104,1,0,1,eneheuvel,26-09-11
2008,27NU00,108,1,0,1,eneheuvel,26-09-11
2008,27NU00,201,1,0,1,eneheuvel,26-09-11
2008,27NU00,202,2,0,2,eneheuvel,26-09-11
2008,27NU00,203,5,5,10,eneheuvel,26-09-11
2008,27NU00,204,3,3,6,eneheuvel,26-09-11
2008,27NU00,205,3,0,3,eneheuvel,26-09-11
2008,27NU00,206,1,0,1,eneheuvel,26-09-11
2008,27NU00,207,22,13,35,eneheuvel,26-09-11
2008,27NU00,208,146,131,277,eneheuvel,26-09-11
2008,27NU00,209,1,0,1,eneheuvel,26-09-11
2008,27NU00,210,0,1,1,eneheuvel,26-09-11
2008,27NU00,211,1,0,1,eneheuvel,26-09-11
2008,27NU00,302,2,0,2,eneheuvel,26-09-11
2008,27NU00,305,0,1,1,eneheuvel,26-09-11
2008,27NU00,311,0,1,1,eneheuvel,26-09-11
2008,27NU00,312,1,2,3,eneheuvel,26-09-11
2008,27NU00,502,0,2,2,eneheuvel,26-09-11
2008,27NU00,9999,2,2,4,eneheuvel,26-09-11
2008,27UB00,106,0,1,1,eneheuvel,26-09-11
2008,27UB00,202,0,2,2,eneheuvel,26-09-11
2008,27UB00,203,7,3,10,eneheuvel,26-09-11
2008,27UB00,204,3,0,3,eneheuvel,26-09-11
2008,27UB00,207,13,3,16,eneheuvel,26-09-11
2008,27UB00,208,173,97,270,eneheuvel,26-09-11
2008,27UB00,209,1,0,1,eneheuvel,26-09-11
2008,27UB00,211,2,0,2,eneheuvel,26-09-11
2008,27UB00,212,1,0,1,eneheuvel,26-09-11
2008,27UB00,302,0,1,1,eneheuvel,26-09-11
2008,27UB00,305,2,0,2,eneheuvel,26-09-11
2008,27UB00,306,0,3,3,eneheuvel,26-09-11
2008,27UB00,307,2,0,2,eneheuvel,26-09-11
2008,27UB00,309,1,1,2,eneheuvel,26-09-11
2008,27UB00,311,2,0,2,eneheuvel,26-09-11
2008,27UB00,502,5,2,7,eneheuvel,26-09-11
2008,27UB00,9999,1,1,2,eneheuvel,26-09-11
2008,27XH00,201,0,1,1,eneheuvel,26-09-11
2008,27XH00,202,2,0,2,eneheuvel,26-09-11
2008,27XH00,203,1,0,1,eneheuvel,26-09-11
2008,27XH00,206,1,5,6,eneheuvel,26-09-11
2008,27XH00,207,0,1,1,eneheuvel,26-09-11
2008,27XH00,208,1,0,1,eneheuvel,26-09-11
2008,27XH00,209,3,1,4,eneheuvel,26-09-11
2008,27XH00,210,7,5,12,eneheuvel,26-09-11
2008,27XH00,212,2,3,5,eneheuvel,26-09-11
2008,27XH00,213,0,1,1,eneheuvel,26-09-11
2008,27XH00,214,7,2,9,eneheuvel,26-09-11
2008,27XH00,215,14,32,46,eneheuvel,26-09-11
2008,27XH00,216,100,67,167,eneheuvel,26-09-11
2008,27XH00,311,1,0,1,eneheuvel,26-09-11
2008,27XJ00,108,1,0,1,eneheuvel,26-09-11
2008,27XJ00,201,1,0,1,eneheuvel,26-09-11
2008,27XJ00,207,1,0,1,eneheuvel,26-09-11
2008,27XJ00,211,1,0,1,eneheuvel,26-09-11
2008,27XJ00,212,0,1,1,eneheuvel,26-09-11
2008,27XJ00,302,17,2,19,eneheuvel,26-09-11
2008,27XJ00,303,6,1,7,eneheuvel,26-09-11
2008,27XJ00,304,1,0,1,eneheuvel,26-09-11
2008,27XJ00,305,0,1,1,eneheuvel,26-09-11
2008,27XJ00,306,1,2,3,eneheuvel,26-09-11
2008,27XJ00,307,0,1,1,eneheuvel,26-09-11
2008,27XJ00,308,2,2,4,eneheuvel,26-09-11
2008,27XJ00,309,4,1,5,eneheuvel,26-09-11
2008,27XJ00,311,22,3,25,eneheuvel,26-09-11
2008,27XJ00,312,142,63,205,eneheuvel,26-09-11
2008,27XJ00,313,36,10,46,eneheuvel,26-09-11
2008,27XJ00,502,1,2,3,eneheuvel,26-09-11
2008,27XJ00,9999,0,2,2,eneheuvel,26-09-11
2008,27YN00,109,1,0,1,eneheuvel,26-09-11
2008,27YN00,202,0,1,1,eneheuvel,26-09-11
2008,27YN00,205,1,0,1,eneheuvel,26-09-11
2008,27YN00,206,0,2,2,eneheuvel,26-09-11
2008,27YN00,210,9,6,15,eneheuvel,26-09-11
2008,27YN00,211,1,3,4,eneheuvel,26-09-11
2008,27YN00,212,4,6,10,eneheuvel,26-09-11
2008,27YN00,214,0,2,2,eneheuvel,26-09-11
2008,27YN00,215,7,5,12,eneheuvel,26-09-11
2008,27YN00,216,81,70,151,eneheuvel,26-09-11
2008,27YN00,302,0,2,2,eneheuvel,26-09-11
2008,27YN00,303,0,1,1,eneheuvel,26-09-11
2008,27YN00,307,0,1,1,eneheuvel,26-09-11
2008,27YN00,308,0,1,1,eneheuvel,26-09-11
2008,27YN00,309,1,1,2,eneheuvel,26-09-11
2008,28AM00,104,0,1,1,eneheuvel,26-09-11
2008,28AM00,207,0,1,1,eneheuvel,26-09-11
2008,28AM00,208,1,1,2,eneheuvel,26-09-11
2008,28AM00,211,0,1,1,eneheuvel,26-09-11
2008,28AM00,214,1,0,1,eneheuvel,26-09-11
2008,28AM00,302,6,2,8,eneheuvel,26-09-11
2008,28AM00,305,1,0,1,eneheuvel,26-09-11
2008,28AM00,306,1,2,3,eneheuvel,26-09-11
2008,28AM00,309,1,0,1,eneheuvel,26-09-11
2008,28AM00,311,22,1,23,eneheuvel,26-09-11
2008,28AM00,312,171,138,309,eneheuvel,26-09-11
2008,28AM00,313,4,4,8,eneheuvel,26-09-11
2008,28AM00,9999,1,0,1,eneheuvel,26-09-11
2008,28BR00,108,0,1,1,eneheuvel,26-09-11
2008,28BR00,203,0,1,1,eneheuvel,26-09-11
2008,28BR00,207,0,1,1,eneheuvel,26-09-11
2008,28BR00,208,1,1,2,eneheuvel,26-09-11
2008,28BR00,211,0,1,1,eneheuvel,26-09-11
2008,28BR00,212,1,5,6,eneheuvel,26-09-11
2008,28BR00,213,1,0,1,eneheuvel,26-09-11
2008,28BR00,301,1,2,3,eneheuvel,26-09-11
2008,28BR00,302,8,3,11,eneheuvel,26-09-11
2008,28BR00,303,0,3,3,eneheuvel,26-09-11
2008,28BR00,305,0,1,1,eneheuvel,26-09-11
2008,28BR00,306,2,0,2,eneheuvel,26-09-11
2008,28BR00,307,1,0,1,eneheuvel,26-09-11
2008,28BR00,309,1,2,3,eneheuvel,26-09-11
2008,28BR00,311,13,17,30,eneheuvel,26-09-11
2008,28BR00,312,2,1,3,eneheuvel,26-09-11
2008,28DJ00,101,2,0,2,eneheuvel,26-09-11
2008,28DJ00,103,0,2,2,eneheuvel,26-09-11
2008,28DJ00,106,1,1,2,eneheuvel,26-09-11
2008,28DJ00,107,2,0,2,eneheuvel,26-09-11
2008,28DJ00,108,1,1,2,eneheuvel,26-09-11
2008,28DJ00,202,4,0,4,eneheuvel,26-09-11
2008,28DJ00,203,6,4,10,eneheuvel,26-09-11
2008,28DJ00,204,1,3,4,eneheuvel,26-09-11
2008,28DJ00,205,2,2,4,eneheuvel,26-09-11
2008,28DJ00,206,1,1,2,eneheuvel,26-09-11
2008,28DJ00,207,15,9,24,eneheuvel,26-09-11
2008,28DJ00,208,12,10,22,eneheuvel,26-09-11
2008,28DJ00,209,0,1,1,eneheuvel,26-09-11
2008,28DJ00,210,2,1,3,eneheuvel,26-09-11
2008,28DJ00,211,4,2,6,eneheuvel,26-09-11
2008,28DJ00,212,5,4,9,eneheuvel,26-09-11
2008,28DJ00,213,2,2,4,eneheuvel,26-09-11
2008,28DJ00,214,2,1,3,eneheuvel,26-09-11
2008,28DJ00,216,2,0,2,eneheuvel,26-09-11
2008,28DJ00,302,6,0,6,eneheuvel,26-09-11
2008,28DJ00,303,3,3,6,eneheuvel,26-09-11
2008,28DJ00,304,2,1,3,eneheuvel,26-09-11
2008,28DJ00,305,5,9,14,eneheuvel,26-09-11
2008,28DJ00,306,5,3,8,eneheuvel,26-09-11
2008,28DJ00,307,5,5,10,eneheuvel,26-09-11
2008,28DJ00,308,6,5,11,eneheuvel,26-09-11
2008,29UB00,102,1,0,1,eneheuvel,26-09-11
2008,29UB00,107,1,2,3,eneheuvel,26-09-11
2008,29UB00,207,0,1,1,eneheuvel,26-09-11
2008,29UB00,208,1,0,1,eneheuvel,26-09-11
2008,29UB00,211,1,4,5,eneheuvel,26-09-11
2008,29UB00,212,4,6,10,eneheuvel,26-09-11
2008,29UB00,214,15,22,37,eneheuvel,26-09-11
2008,29UB00,311,0,1,1,eneheuvel,26-09-11
2008,29UB00,402,1,0,1,eneheuvel,26-09-11
2008,29UB00,9999,0,1,1,eneheuvel,26-09-11
2008,29UN00,211,1,0,1,eneheuvel,26-09-11
2008,29UN00,213,2,0,2,eneheuvel,26-09-11
2008,29UN00,214,1,0,1,eneheuvel,26-09-11
2008,29UN00,301,1,2,3,eneheuvel,26-09-11
2008,29UN00,302,2,0,2,eneheuvel,26-09-11
2008,29UN00,304,2,2,4,eneheuvel,26-09-11
2008,29UN00,305,4,3,7,eneheuvel,26-09-11
2008,29UN00,306,2,2,4,eneheuvel,26-09-11
2008,29UN00,307,0,3,3,eneheuvel,26-09-11
2008,29UN00,308,2,0,2,eneheuvel,26-09-11
2008,29UN00,309,3,1,4,eneheuvel,26-09-11
2008,29UN00,310,1,0,1,eneheuvel,26-09-11
2008,29UN00,311,2,3,5,eneheuvel,26-09-11
2008,29UN00,312,0,2,2,eneheuvel,26-09-11
2008,29XX00,203,1,1,2,eneheuvel,26-09-11
2008,29XX00,206,0,1,1,eneheuvel,26-09-11
2008,29XX00,207,2,3,5,eneheuvel,26-09-11
2008,29XX00,208,1,1,2,eneheuvel,26-09-11
2008,29XX00,210,3,2,5,eneheuvel,26-09-11
2008,29XX00,212,5,0,5,eneheuvel,26-09-11
2008,29XX00,213,1,1,2,eneheuvel,26-09-11
2008,29XX00,214,4,5,9,eneheuvel,26-09-11
2008,29XX00,216,1,0,1,eneheuvel,26-09-11
2008,29XX00,302,3,2,5,eneheuvel,26-09-11
2008,29XX00,303,0,1,1,eneheuvel,26-09-11
2008,29XX00,305,1,0,1,eneheuvel,26-09-11
2008,29XX00,307,1,1,2,eneheuvel,26-09-11
2008,29XX00,311,5,4,9,eneheuvel,26-09-11
2008,29XX00,313,1,0,1,eneheuvel,26-09-11
2009,06RM00,102,1,3,4,eneheuvel,26-09-11
2009,06RM00,103,4,1,5,eneheuvel,26-09-11
2009,06RM00,104,0,2,2,eneheuvel,26-09-11
2009,06RM00,105,0,1,1,eneheuvel,26-09-11
2009,06RM00,106,0,2,2,eneheuvel,26-09-11
2009,06RM00,107,1,0,1,eneheuvel,26-09-11
2009,06RM00,201,1,0,1,eneheuvel,26-09-11
2009,06RM00,202,10,6,16,eneheuvel,26-09-11
2009,06RM00,204,4,4,8,eneheuvel,26-09-11
2009,06RM00,205,0,1,1,eneheuvel,26-09-11
2009,06RM00,206,1,5,6,eneheuvel,26-09-11
2009,06RM00,207,3,1,4,eneheuvel,26-09-11
2009,06RM00,208,1,0,1,eneheuvel,26-09-11
2009,06RM00,209,1,0,1,eneheuvel,26-09-11
2009,06RM00,210,6,10,16,eneheuvel,26-09-11
2009,06RM00,211,3,9,12,eneheuvel,26-09-11
2009,06RM00,212,16,39,55,eneheuvel,26-09-11
2009,06RM00,213,2,8,10,eneheuvel,26-09-11
2009,06RM00,214,11,14,25,eneheuvel,26-09-11
2009,06RM00,215,1,3,4,eneheuvel,26-09-11
2009,06RM00,216,6,6,12,eneheuvel,26-09-11
2009,06RM00,302,4,4,8,eneheuvel,26-09-11
2009,06RM00,303,4,1,5,eneheuvel,26-09-11
2009,06RM00,304,1,2,3,eneheuvel,26-09-11
2009,06RM00,305,1,0,1,eneheuvel,26-09-11
2009,06RM00,307,1,0,1,eneheuvel,26-09-11
2009,06RM00,308,2,0,2,eneheuvel,26-09-11
2009,06RM00,309,0,3,3,eneheuvel,26-09-11
2009,06RM00,311,5,0,5,eneheuvel,26-09-11
2009,06RM00,312,3,4,7,eneheuvel,26-09-11
2009,06RM00,402,0,1,1,eneheuvel,26-09-11
2009,06RM00,502,0,4,4,eneheuvel,26-09-11
2009,06RM00,9999,8,13,21,eneheuvel,26-09-11
2009,12HU00,102,1,0,1,eneheuvel,26-09-11
2009,12HU00,103,1,2,3,eneheuvel,26-09-11
2009,12HU00,201,3,5,8,eneheuvel,26-09-11
2009,12HU00,202,1,1,2,eneheuvel,26-09-11
2009,12HU00,209,5,1,6,eneheuvel,26-09-11
2009,12HU00,210,1,3,4,eneheuvel,26-09-11
2009,12HU00,211,41,42,83,eneheuvel,26-09-11
2009,12HU00,212,0,1,1,eneheuvel,26-09-11
2009,12HU00,213,0,1,1,eneheuvel,26-09-11
2009,12HU00,303,1,0,1,eneheuvel,26-09-11
2009,12HU00,401,1,1,2,eneheuvel,26-09-11
2009,12HU00,9999,1,2,3,eneheuvel,26-09-11
2009,12PM00,101,7,6,13,eneheuvel,26-09-11
2009,12PM00,102,11,5,16,eneheuvel,26-09-11
2009,12PM00,103,32,39,71,eneheuvel,26-09-11
2009,12PM00,104,2,2,4,eneheuvel,26-09-11
2009,12PM00,106,3,5,8,eneheuvel,26-09-11
2009,12PM00,107,20,18,38,eneheuvel,26-09-11
2009,12PM00,108,22,12,34,eneheuvel,26-09-11
2009,12PM00,109,8,11,19,eneheuvel,26-09-11
2009,12PM00,206,1,0,1,eneheuvel,26-09-11
2009,12PM00,211,1,0,1,eneheuvel,26-09-11
2009,12PM00,212,0,1,1,eneheuvel,26-09-11
2009,12PM00,216,0,2,2,eneheuvel,26-09-11
2009,12PM00,303,1,1,2,eneheuvel,26-09-11
2009,12PM00,304,0,1,1,eneheuvel,26-09-11
2009,12PM00,311,1,2,3,eneheuvel,26-09-11
2009,12PM00,9999,2,1,3,eneheuvel,26-09-11
2009,12QK00,201,0,1,1,eneheuvel,26-09-11
2009,12QK00,202,1,0,1,eneheuvel,26-09-11
2009,12QK00,203,1,0,1,eneheuvel,26-09-11
2009,12QK00,206,101,94,195,eneheuvel,26-09-11
2009,12QK00,207,1,3,4,eneheuvel,26-09-11
2009,12QK00,208,1,1,2,eneheuvel,26-09-11
2009,12QK00,209,5,3,8,eneheuvel,26-09-11
2009,12QK00,210,11,8,19,eneheuvel,26-09-11
2009,12QK00,211,0,2,2,eneheuvel,26-09-11
2009,12QK00,212,1,0,1,eneheuvel,26-09-11
2009,12QK00,213,0,1,1,eneheuvel,26-09-11
2009,12QK00,214,1,0,1,eneheuvel,26-09-11
2009,12QK00,215,1,3,4,eneheuvel,26-09-11
2009,12QK00,216,1,0,1,eneheuvel,26-09-11
2009,12QK00,301,1,0,1,eneheuvel,26-09-11
2009,12QK00,302,0,1,1,eneheuvel,26-09-11
2009,12QK00,303,1,0,1,eneheuvel,26-09-11
2009,12QK00,306,1,0,1,eneheuvel,26-09-11
2009,12QK00,312,0,1,1,eneheuvel,26-09-11
2009,12QK00,9999,0,1,1,eneheuvel,26-09-11
2009,12XA00,208,0,1,1,eneheuvel,26-09-11
2009,12XA00,211,40,59,99,eneheuvel,26-09-11
2009,12XA00,212,1,0,1,eneheuvel,26-09-11
2009,12XA00,213,0,2,2,eneheuvel,26-09-11
2009,12XA00,214,1,0,1,eneheuvel,26-09-11
2009,12XA00,303,2,0,2,eneheuvel,26-09-11
2009,13CW00,106,1,0,1,eneheuvel,26-09-11
2009,13CW00,201,2,3,5,eneheuvel,26-09-11
2009,13CW00,202,1,0,1,eneheuvel,26-09-11
2009,13CW00,203,0,1,1,eneheuvel,26-09-11
2009,13CW00,205,1,1,2,eneheuvel,26-09-11
2009,13CW00,206,61,70,131,eneheuvel,26-09-11
2009,13CW00,207,1,3,4,eneheuvel,26-09-11
2009,13CW00,208,0,2,2,eneheuvel,26-09-11
2009,13CW00,209,14,6,20,eneheuvel,26-09-11
2009,13CW00,210,7,4,11,eneheuvel,26-09-11
2009,13CW00,211,0,1,1,eneheuvel,26-09-11
2009,13CW00,212,2,0,2,eneheuvel,26-09-11
2009,13CW00,214,1,0,1,eneheuvel,26-09-11
2009,13CW00,215,0,4,4,eneheuvel,26-09-11
2009,13CW00,216,0,1,1,eneheuvel,26-09-11
2009,13CW00,306,1,0,1,eneheuvel,26-09-11
2009,13CW00,308,2,1,3,eneheuvel,26-09-11
2009,13CW00,9999,3,1,4,eneheuvel,26-09-11
2009,13IF00,105,0,1,1,eneheuvel,26-09-11
2009,13IF00,201,1,0,1,eneheuvel,26-09-11
2009,13IF00,207,0,3,3,eneheuvel,26-09-11
2009,13IF00,208,3,0,3,eneheuvel,26-09-11
2009,13IF00,214,0,2,2,eneheuvel,26-09-11
2009,13IF00,301,7,7,14,eneheuvel,26-09-11
2009,13IF00,302,1,1,2,eneheuvel,26-09-11
2009,13IF00,303,8,13,21,eneheuvel,26-09-11
2009,13IF00,304,30,33,63,eneheuvel,26-09-11
2009,13IF00,305,6,3,9,eneheuvel,26-09-11
2009,13IF00,306,8,11,19,eneheuvel,26-09-11
2009,13IF00,307,3,2,5,eneheuvel,26-09-11
2009,13IF00,308,3,2,5,eneheuvel,26-09-11
2009,13IF00,309,2,0,2,eneheuvel,26-09-11
2009,13IF00,310,2,0,2,eneheuvel,26-09-11
2009,13IF00,401,0,1,1,eneheuvel,26-09-11
2009,13IU00,101,0,1,1,eneheuvel,26-09-11
2009,13IU00,102,11,8,19,eneheuvel,26-09-11
2009,13IU00,103,9,4,13,eneheuvel,26-09-11
2009,13IU00,104,3,2,5,eneheuvel,26-09-11
2009,13IU00,105,3,5,8,eneheuvel,26-09-11
2009,13IU00,106,56,35,91,eneheuvel,26-09-11
2009,13IU00,107,7,4,11,eneheuvel,26-09-11
2009,13IU00,108,1,3,4,eneheuvel,26-09-11
2009,13IU00,109,3,1,4,eneheuvel,26-09-11
2009,13IU00,110,1,0,1,eneheuvel,26-09-11
2009,13IU00,202,1,0,1,eneheuvel,26-09-11
2009,13IU00,211,0,1,1,eneheuvel,26-09-11
2009,13IU00,212,0,2,2,eneheuvel,26-09-11
2009,13IU00,311,1,0,1,eneheuvel,26-09-11
2009,13IU00,9999,1,0,1,eneheuvel,26-09-11
2009,13NH00,101,2,2,4,eneheuvel,26-09-11
2009,13NH00,102,10,9,19,eneheuvel,26-09-11
2009,13NH00,103,3,2,5,eneheuvel,26-09-11
2009,13NH00,104,27,18,45,eneheuvel,26-09-11
2009,13NH00,105,66,68,134,eneheuvel,26-09-11
2009,13NH00,106,10,11,21,eneheuvel,26-09-11
2009,13NH00,107,2,1,3,eneheuvel,26-09-11
2009,13NH00,109,2,0,2,eneheuvel,26-09-11
2009,13NH00,110,18,12,30,eneheuvel,26-09-11
2009,13NH00,203,1,0,1,eneheuvel,26-09-11
2009,13NH00,308,1,0,1,eneheuvel,26-09-11
2009,13NH00,502,1,2,3,eneheuvel,26-09-11
2009,13NH00,9999,0,1,1,eneheuvel,26-09-11
2009,13NU00,206,1,0,1,eneheuvel,26-09-11
2009,13NU00,211,1,1,2,eneheuvel,26-09-11
2009,13NU00,216,0,1,1,eneheuvel,26-09-11
2009,13NU00,301,12,8,20,eneheuvel,26-09-11
2009,13NU00,302,4,1,5,eneheuvel,26-09-11
2009,13NU00,303,29,38,67,eneheuvel,26-09-11
2009,13NU00,304,65,52,117,eneheuvel,26-09-11
2009,13NU00,305,24,18,42,eneheuvel,26-09-11
2009,13NU00,306,14,24,38,eneheuvel,26-09-11
2009,13NU00,307,2,1,3,eneheuvel,26-09-11
2009,13NU00,308,5,3,8,eneheuvel,26-09-11
2009,13NU00,309,1,1,2,eneheuvel,26-09-11
2009,13NU00,310,1,0,1,eneheuvel,26-09-11
2009,13NU00,311,0,1,1,eneheuvel,26-09-11
2009,13NU00,312,0,1,1,eneheuvel,26-09-11
2009,13NU00,9999,1,1,2,eneheuvel,26-09-11
2009,14QC00,108,1,0,1,eneheuvel,26-09-11
2009,14QC00,109,2,3,5,eneheuvel,26-09-11
2009,14QC00,110,1,0,1,eneheuvel,26-09-11
2009,14QC00,201,3,0,3,eneheuvel,26-09-11
2009,14QC00,202,53,48,101,eneheuvel,26-09-11
2009,14QC00,203,39,45,84,eneheuvel,26-09-11
2009,14QC00,204,25,27,52,eneheuvel,26-09-11
2009,14QC00,205,19,14,33,eneheuvel,26-09-11
2009,14QC00,206,25,10,35,eneheuvel,26-09-11
2009,14QC00,207,10,5,15,eneheuvel,26-09-11
2009,14QC00,208,27,21,48,eneheuvel,26-09-11
2009,14QC00,209,3,0,3,eneheuvel,26-09-11
2009,14QC00,210,10,7,17,eneheuvel,26-09-11
2009,14QC00,211,11,4,15,eneheuvel,26-09-11
2009,14QC00,212,2,3,5,eneheuvel,26-09-11
2009,14QC00,213,2,3,5,eneheuvel,26-09-11
2009,14QC00,214,3,3,6,eneheuvel,26-09-11
2009,14QC00,215,1,3,4,eneheuvel,26-09-11
2009,14QC00,216,3,1,4,eneheuvel,26-09-11
2009,14QC00,302,3,5,8,eneheuvel,26-09-11
2009,14QC00,303,16,4,20,eneheuvel,26-09-11
2009,14QC00,304,2,2,4,eneheuvel,26-09-11
2009,14QC00,306,1,0,1,eneheuvel,26-09-11
2009,14QC00,307,4,1,5,eneheuvel,26-09-11
2009,14QC00,309,0,1,1,eneheuvel,26-09-11
2009,14QC00,311,8,3,11,eneheuvel,26-09-11
2009,14QC00,312,5,3,8,eneheuvel,26-09-11
2009,14QC00,313,0,1,1,eneheuvel,26-09-11
2009,14QC00,502,16,15,31,eneheuvel,26-09-11
2009,14QC00,9999,3,1,4,eneheuvel,26-09-11
2009,14QC02,202,0,1,1,eneheuvel,26-09-11
2009,14QC02,209,1,1,2,eneheuvel,26-09-11
2009,14QC02,210,0,2,2,eneheuvel,26-09-11
2009,14QC02,212,16,23,39,eneheuvel,26-09-11
2009,14QC02,213,5,5,10,eneheuvel,26-09-11
2009,14QC02,214,5,3,8,eneheuvel,26-09-11
2009,14QC02,216,2,1,3,eneheuvel,26-09-11
2009,15SJ00,101,0,3,3,eneheuvel,26-09-11
2009,15SJ00,102,2,6,8,eneheuvel,26-09-11
2009,15SJ00,103,1,5,6,eneheuvel,26-09-11
2009,15SJ00,104,2,5,7,eneheuvel,26-09-11
2009,15SJ00,105,2,1,3,eneheuvel,26-09-11
2009,15SJ00,106,1,3,4,eneheuvel,26-09-11
2009,15SJ00,108,1,7,8,eneheuvel,26-09-11
2009,15SJ00,201,1,3,4,eneheuvel,26-09-11
2009,15SJ00,202,2,12,14,eneheuvel,26-09-11
2009,15SJ00,203,1,6,7,eneheuvel,26-09-11
2009,15SJ00,204,0,6,6,eneheuvel,26-09-11
2009,15SJ00,205,2,8,10,eneheuvel,26-09-11
2009,15SJ00,206,3,14,17,eneheuvel,26-09-11
2009,15SJ00,207,2,19,21,eneheuvel,26-09-11
2009,15SJ00,208,2,10,12,eneheuvel,26-09-11
2009,15SJ00,209,1,12,13,eneheuvel,26-09-11
2009,15SJ00,210,6,21,27,eneheuvel,26-09-11
2009,15SJ00,211,5,23,28,eneheuvel,26-09-11
2009,15SJ00,212,2,11,13,eneheuvel,26-09-11
2009,15SJ00,213,2,5,7,eneheuvel,26-09-11
2009,15SJ00,214,1,9,10,eneheuvel,26-09-11
2009,15SJ00,216,1,2,3,eneheuvel,26-09-11
2009,15SJ00,301,1,5,6,eneheuvel,26-09-11
2009,15SJ00,302,2,7,9,eneheuvel,26-09-11
2009,15SJ00,303,2,7,9,eneheuvel,26-09-11
2009,15SJ00,304,4,4,8,eneheuvel,26-09-11
2009,15SJ00,305,0,6,6,eneheuvel,26-09-11
2009,15SJ00,306,1,8,9,eneheuvel,26-09-11
2009,15SJ00,307,2,5,7,eneheuvel,26-09-11
2009,15SJ00,308,1,7,8,eneheuvel,26-09-11
2009,15SJ00,309,4,7,11,eneheuvel,26-09-11
2009,15SJ00,311,4,2,6,eneheuvel,26-09-11
2009,15SJ00,312,0,1,1,eneheuvel,26-09-11
2009,15SJ00,313,0,1,1,eneheuvel,26-09-11
2009,15SJ00,401,0,2,2,eneheuvel,26-09-11
2009,15SJ00,9999,0,1,1,eneheuvel,26-09-11
2009,15ZL00,203,0,1,1,eneheuvel,26-09-11
2009,15ZL00,204,0,3,3,eneheuvel,26-09-11
2009,15ZL00,205,0,1,1,eneheuvel,26-09-11
2009,15ZL00,206,1,0,1,eneheuvel,26-09-11
2009,15ZL00,208,4,4,8,eneheuvel,26-09-11
2009,15ZL00,214,1,2,3,eneheuvel,26-09-11
2009,15ZL00,216,1,0,1,eneheuvel,26-09-11
2009,15ZL00,302,4,2,6,eneheuvel,26-09-11
2009,15ZL00,303,2,4,6,eneheuvel,26-09-11
2009,15ZL00,304,0,2,2,eneheuvel,26-09-11
2009,15ZL00,305,45,51,96,eneheuvel,26-09-11
2009,15ZL00,306,3,9,12,eneheuvel,26-09-11
2009,15ZL00,307,2,7,9,eneheuvel,26-09-11
2009,15ZL00,308,3,5,8,eneheuvel,26-09-11
2009,15ZL00,309,7,6,13,eneheuvel,26-09-11
2009,15ZL00,311,6,1,7,eneheuvel,26-09-11
2009,15ZL00,312,1,2,3,eneheuvel,26-09-11
2009,15ZL00,313,0,1,1,eneheuvel,26-09-11
2009,15ZL00,502,0,2,2,eneheuvel,26-09-11
2009,15ZL00,9999,0,2,2,eneheuvel,26-09-11
2009,15ZL01,206,1,3,4,eneheuvel,26-09-11
2009,15ZL01,207,2,0,2,eneheuvel,26-09-11
2009,15ZL01,209,5,9,14,eneheuvel,26-09-11
2009,15ZL01,210,71,61,132,eneheuvel,26-09-11
2009,15ZL01,211,1,0,1,eneheuvel,26-09-11
2009,15ZL01,212,1,1,2,eneheuvel,26-09-11
2009,15ZL01,215,1,3,4,eneheuvel,26-09-11
2009,15ZL01,216,1,4,5,eneheuvel,26-09-11
2009,15ZL01,307,0,1,1,eneheuvel,26-09-11
2009,15ZL01,308,1,0,1,eneheuvel,26-09-11
2009,15ZL01,309,0,2,2,eneheuvel,26-09-11
2009,15ZL01,9999,1,1,2,eneheuvel,26-09-11
2009,16KK00,101,14,11,25,eneheuvel,26-09-11
2009,16KK00,102,32,37,69,eneheuvel,26-09-11
2009,16KK00,103,63,57,120,eneheuvel,26-09-11
2009,16KK00,104,4,0,4,eneheuvel,26-09-11
2009,16KK00,105,0,2,2,eneheuvel,26-09-11
2009,16KK00,106,6,5,11,eneheuvel,26-09-11
2009,16KK00,107,9,9,18,eneheuvel,26-09-11
2009,16KK00,108,20,24,44,eneheuvel,26-09-11
2009,16KK00,109,13,13,26,eneheuvel,26-09-11
2009,16KK00,110,1,0,1,eneheuvel,26-09-11
2009,16KK00,201,0,1,1,eneheuvel,26-09-11
2009,16KK00,202,2,2,4,eneheuvel,26-09-11
2009,16KK00,205,0,1,1,eneheuvel,26-09-11
2009,16KK00,206,2,1,3,eneheuvel,26-09-11
2009,16KK00,207,0,3,3,eneheuvel,26-09-11
2009,16KK00,208,1,0,1,eneheuvel,26-09-11
2009,16KK00,210,1,1,2,eneheuvel,26-09-11
2009,16KK00,211,2,2,4,eneheuvel,26-09-11
2009,16KK00,212,0,1,1,eneheuvel,26-09-11
2009,16KK00,213,3,1,4,eneheuvel,26-09-11
2009,16KK00,214,0,3,3,eneheuvel,26-09-11
2009,16KK00,303,1,0,1,eneheuvel,26-09-11
2009,16KK00,304,0,1,1,eneheuvel,26-09-11
2009,16KK00,305,0,1,1,eneheuvel,26-09-11
2009,16KK00,308,0,1,1,eneheuvel,26-09-11
2009,16KK00,311,0,1,1,eneheuvel,26-09-11
2009,16KK00,502,2,0,2,eneheuvel,26-09-11
2009,16KK00,9999,1,2,3,eneheuvel,26-09-11
2009,16LJ00,101,2,4,6,eneheuvel,26-09-11
2009,16LJ00,102,6,5,11,eneheuvel,26-09-11
2009,16LJ00,103,1,0,1,eneheuvel,26-09-11
2009,16LJ00,104,2,0,2,eneheuvel,26-09-11
2009,16LJ00,105,0,1,1,eneheuvel,26-09-11
2009,16LJ00,106,48,43,91,eneheuvel,26-09-11
2009,16LJ00,107,1,3,4,eneheuvel,26-09-11
2009,16LJ00,108,1,5,6,eneheuvel,26-09-11
2009,16LJ00,203,2,1,3,eneheuvel,26-09-11
2009,16LJ00,208,1,0,1,eneheuvel,26-09-11
2009,16LJ00,210,0,1,1,eneheuvel,26-09-11
2009,16LJ00,306,1,0,1,eneheuvel,26-09-11
2009,16LJ00,9999,0,2,2,eneheuvel,26-09-11
2009,16ML00,101,2,8,10,eneheuvel,26-09-11
2009,16ML00,102,24,26,50,eneheuvel,26-09-11
2009,16ML00,103,5,3,8,eneheuvel,26-09-11
2009,16ML00,104,55,48,103,eneheuvel,26-09-11
2009,16ML00,105,19,25,44,eneheuvel,26-09-11
2009,16ML00,106,2,2,4,eneheuvel,26-09-11
2009,16ML00,107,3,8,11,eneheuvel,26-09-11
2009,16ML00,108,2,3,5,eneheuvel,26-09-11
2009,16ML00,109,4,4,8,eneheuvel,26-09-11
2009,16ML00,110,1,6,7,eneheuvel,26-09-11
2009,16ML00,201,0,1,1,eneheuvel,26-09-11
2009,16ML00,202,1,0,1,eneheuvel,26-09-11
2009,16ML00,203,0,3,3,eneheuvel,26-09-11
2009,16ML00,205,0,3,3,eneheuvel,26-09-11
2009,16ML00,209,0,1,1,eneheuvel,26-09-11
2009,16ML00,210,0,1,1,eneheuvel,26-09-11
2009,16ML00,211,0,1,1,eneheuvel,26-09-11
2009,16ML00,212,1,2,3,eneheuvel,26-09-11
2009,16ML00,213,0,1,1,eneheuvel,26-09-11
2009,16ML00,214,0,2,2,eneheuvel,26-09-11
2009,16ML00,303,1,2,3,eneheuvel,26-09-11
2009,16ML00,306,0,1,1,eneheuvel,26-09-11
2009,16ML00,307,1,0,1,eneheuvel,26-09-11
2009,16ML00,311,1,1,2,eneheuvel,26-09-11
2009,16ML00,502,2,2,4,eneheuvel,26-09-11
2009,16ML00,9999,1,2,3,eneheuvel,26-09-11
2009,16OC00,101,2,2,4,eneheuvel,26-09-11
2009,16OC00,102,2,0,2,eneheuvel,26-09-11
2009,16OC00,103,7,9,16,eneheuvel,26-09-11
2009,16OC00,104,0,2,2,eneheuvel,26-09-11
2009,16OC00,105,1,1,2,eneheuvel,26-09-11
2009,16OC00,106,0,2,2,eneheuvel,26-09-11
2009,16OC00,107,72,81,153,eneheuvel,26-09-11
2009,16OC00,108,24,23,47,eneheuvel,26-09-11
2009,16OC00,109,42,54,96,eneheuvel,26-09-11
2009,16OC00,201,1,2,3,eneheuvel,26-09-11
2009,16OC00,202,3,1,4,eneheuvel,26-09-11
2009,16OC00,203,0,3,3,eneheuvel,26-09-11
2009,16OC00,204,1,0,1,eneheuvel,26-09-11
2009,16OC00,205,1,1,2,eneheuvel,26-09-11
2009,16OC00,206,1,2,3,eneheuvel,26-09-11
2009,16OC00,207,1,2,3,eneheuvel,26-09-11
2009,16OC00,208,5,6,11,eneheuvel,26-09-11
2009,16OC00,210,1,1,2,eneheuvel,26-09-11
2009,16OC00,211,2,4,6,eneheuvel,26-09-11
2009,16OC00,212,1,1,2,eneheuvel,26-09-11
2009,16OC00,213,1,4,5,eneheuvel,26-09-11
2009,16OC00,214,7,10,17,eneheuvel,26-09-11
2009,16OC00,301,2,0,2,eneheuvel,26-09-11
2009,16OC00,302,4,1,5,eneheuvel,26-09-11
2009,16OC00,303,2,3,5,eneheuvel,26-09-11
2009,16OC00,304,2,2,4,eneheuvel,26-09-11
2009,16OC00,305,2,0,2,eneheuvel,26-09-11
2009,16OC00,306,1,1,2,eneheuvel,26-09-11
2009,16OC00,308,2,0,2,eneheuvel,26-09-11
2009,16OC00,309,10,1,11,eneheuvel,26-09-11
2009,16OC00,311,1,1,2,eneheuvel,26-09-11
2009,16OC00,312,1,2,3,eneheuvel,26-09-11
2009,16OC00,313,1,1,2,eneheuvel,26-09-11
2009,16OC00,401,0,2,2,eneheuvel,26-09-11
2009,16OC00,502,2,0,2,eneheuvel,26-09-11
2009,16OC00,9999,3,2,5,eneheuvel,26-09-11
2009,16UK00,102,2,1,3,eneheuvel,26-09-11
2009,16UK00,103,4,6,10,eneheuvel,26-09-11
2009,16UK00,107,1,2,3,eneheuvel,26-09-11
2009,16UK00,108,70,65,135,eneheuvel,26-09-11
2009,16UK00,109,0,1,1,eneheuvel,26-09-11
2009,16UK00,204,1,0,1,eneheuvel,26-09-11
2009,16UK00,212,0,1,1,eneheuvel,26-09-11
2009,16UK00,214,1,0,1,eneheuvel,26-09-11
2009,16WV00,108,1,0,1,eneheuvel,26-09-11
2009,16WV00,201,6,1,7,eneheuvel,26-09-11
2009,16WV00,202,0,1,1,eneheuvel,26-09-11
2009,16WV00,207,0,1,1,eneheuvel,26-09-11
2009,16WV00,209,11,10,21,eneheuvel,26-09-11
2009,16WV00,211,59,52,111,eneheuvel,26-09-11
2009,16WV00,213,2,1,3,eneheuvel,26-09-11
2009,16WV00,214,2,1,3,eneheuvel,26-09-11
2009,16WV00,305,1,0,1,eneheuvel,26-09-11
2009,16WV00,9999,3,2,5,eneheuvel,26-09-11
2009,16YS00,201,10,7,17,eneheuvel,26-09-11
2009,16YS00,202,1,1,2,eneheuvel,26-09-11
2009,16YS00,207,2,0,2,eneheuvel,26-09-11
2009,16YS00,208,0,1,1,eneheuvel,26-09-11
2009,16YS00,209,1,3,4,eneheuvel,26-09-11
2009,16YS00,210,0,1,1,eneheuvel,26-09-11
2009,16YS00,211,81,72,153,eneheuvel,26-09-11
2009,16YS00,212,2,3,5,eneheuvel,26-09-11
2009,16YS00,213,1,1,2,eneheuvel,26-09-11
2009,16YS00,214,1,0,1,eneheuvel,26-09-11
2009,16YS00,216,1,0,1,eneheuvel,26-09-11
2009,16YS00,302,0,1,1,eneheuvel,26-09-11
2009,16YS00,303,1,0,1,eneheuvel,26-09-11
2009,16YS00,309,1,1,2,eneheuvel,26-09-11
2009,16YS00,312,2,0,2,eneheuvel,26-09-11
2009,16YS00,9999,1,0,1,eneheuvel,26-09-11
2009,16ZG00,103,0,1,1,eneheuvel,26-09-11
2009,16ZG00,201,1,0,1,eneheuvel,26-09-11
2009,16ZG00,202,2,0,2,eneheuvel,26-09-11
2009,16ZG00,211,78,63,141,eneheuvel,26-09-11
2009,16ZG00,212,0,1,1,eneheuvel,26-09-11
2009,16ZG00,213,0,2,2,eneheuvel,26-09-11
2009,16ZG00,214,0,1,1,eneheuvel,26-09-11
2009,16ZG00,301,1,0,1,eneheuvel,26-09-11
2009,16ZG00,9999,1,0,1,eneheuvel,26-09-11
2009,16ZX00,105,0,1,1,eneheuvel,26-09-11
2009,16ZX00,201,1,1,2,eneheuvel,26-09-11
2009,16ZX00,206,16,16,32,eneheuvel,26-09-11
2009,16ZX00,209,38,28,66,eneheuvel,26-09-11
2009,16ZX00,210,2,2,4,eneheuvel,26-09-11
2009,16ZX00,211,0,1,1,eneheuvel,26-09-11
2009,16ZX00,304,1,0,1,eneheuvel,26-09-11
2009,16ZX00,305,0,1,1,eneheuvel,26-09-11
2009,16ZX00,9999,1,2,3,eneheuvel,26-09-11
2009,17AK00,201,1,0,1,eneheuvel,26-09-11
2009,17AK00,204,1,1,2,eneheuvel,26-09-11
2009,17AK00,205,1,0,1,eneheuvel,26-09-11
2009,17AK00,206,52,66,118,eneheuvel,26-09-11
2009,17AK00,207,0,1,1,eneheuvel,26-09-11
2009,17AK00,209,3,0,3,eneheuvel,26-09-11
2009,17AK00,210,3,5,8,eneheuvel,26-09-11
2009,17AK00,211,0,1,1,eneheuvel,26-09-11
2009,17AK00,303,1,0,1,eneheuvel,26-09-11
2009,17AK00,304,0,1,1,eneheuvel,26-09-11
2009,17AK00,306,1,1,2,eneheuvel,26-09-11
2009,17AK00,307,0,2,2,eneheuvel,26-09-11
2009,17AK00,309,1,1,2,eneheuvel,26-09-11
2009,17AK00,312,1,0,1,eneheuvel,26-09-11
2009,17AV00,202,0,1,1,eneheuvel,26-09-11
2009,17AV00,204,1,2,3,eneheuvel,26-09-11
2009,17AV00,205,2,0,2,eneheuvel,26-09-11
2009,17AV00,206,67,80,147,eneheuvel,26-09-11
2009,17AV00,207,2,0,2,eneheuvel,26-09-11
2009,17AV00,208,1,0,1,eneheuvel,26-09-11
2009,17AV00,209,3,0,3,eneheuvel,26-09-11
2009,17AV00,215,1,0,1,eneheuvel,26-09-11
2009,17AV00,216,0,1,1,eneheuvel,26-09-11
2009,17AV00,9999,0,2,2,eneheuvel,26-09-11
2009,17BP00,103,0,2,2,eneheuvel,26-09-11
2009,17BP00,201,0,1,1,eneheuvel,26-09-11
2009,17BP00,202,0,1,1,eneheuvel,26-09-11
2009,17BP00,208,0,1,1,eneheuvel,26-09-11
2009,17BP00,209,1,0,1,eneheuvel,26-09-11
2009,17BP00,210,2,1,3,eneheuvel,26-09-11
2009,17BP00,211,50,54,104,eneheuvel,26-09-11
2009,17BP00,212,3,7,10,eneheuvel,26-09-11
2009,17BP00,213,53,73,126,eneheuvel,26-09-11
2009,17BP00,214,2,2,4,eneheuvel,26-09-11
2009,17BP00,309,0,1,1,eneheuvel,26-09-11
2009,17DA00,103,0,1,1,eneheuvel,26-09-11
2009,17DA00,201,1,0,1,eneheuvel,26-09-11
2009,17DA00,207,0,1,1,eneheuvel,26-09-11
2009,17DA00,209,4,7,11,eneheuvel,26-09-11
2009,17DA00,210,47,56,103,eneheuvel,26-09-11
2009,17DA00,211,1,1,2,eneheuvel,26-09-11
2009,17DA00,302,0,3,3,eneheuvel,26-09-11
2009,17DA00,303,0,1,1,eneheuvel,26-09-11
2009,17DA00,307,0,1,1,eneheuvel,26-09-11
2009,17DA00,402,0,1,1,eneheuvel,26-09-11
2009,17DA00,9999,1,0,1,eneheuvel,26-09-11
2009,17DK00,202,1,1,2,eneheuvel,26-09-11
2009,17DK00,203,1,1,2,eneheuvel,26-09-11
2009,17DK00,206,0,2,2,eneheuvel,26-09-11
2009,17DK00,207,1,2,3,eneheuvel,26-09-11
2009,17DK00,208,1,1,2,eneheuvel,26-09-11
2009,17DK00,213,0,1,1,eneheuvel,26-09-11
2009,17DK00,301,6,5,11,eneheuvel,26-09-11
2009,17DK00,302,1,2,3,eneheuvel,26-09-11
2009,17DK00,303,2,3,5,eneheuvel,26-09-11
2009,17DK00,304,34,40,74,eneheuvel,26-09-11
2009,17DK00,305,0,1,1,eneheuvel,26-09-11
2009,17DK00,306,1,0,1,eneheuvel,26-09-11
2009,17DK00,307,1,0,1,eneheuvel,26-09-11
2009,17DK00,308,2,2,4,eneheuvel,26-09-11
2009,17DK00,309,2,2,4,eneheuvel,26-09-11
2009,17DK00,9999,1,0,1,eneheuvel,26-09-11
2009,17DV00,106,0,1,1,eneheuvel,26-09-11
2009,17DV00,108,0,1,1,eneheuvel,26-09-11
2009,17DV00,202,0,1,1,eneheuvel,26-09-11
2009,17DV00,203,0,1,1,eneheuvel,26-09-11
2009,17DV00,204,0,1,1,eneheuvel,26-09-11
2009,17DV00,207,2,0,2,eneheuvel,26-09-11
2009,17DV00,211,1,0,1,eneheuvel,26-09-11
2009,17DV00,212,0,1,1,eneheuvel,26-09-11
2009,17DV00,214,0,1,1,eneheuvel,26-09-11
2009,17DV00,216,1,0,1,eneheuvel,26-09-11
2009,17DV00,301,20,6,26,eneheuvel,26-09-11
2009,17DV00,302,3,6,9,eneheuvel,26-09-11
2009,17DV00,303,29,32,61,eneheuvel,26-09-11
2009,17DV00,304,34,41,75,eneheuvel,26-09-11
2009,17DV00,305,8,4,12,eneheuvel,26-09-11
2009,17DV00,306,13,10,23,eneheuvel,26-09-11
2009,17DV00,307,4,10,14,eneheuvel,26-09-11
2009,17DV00,308,12,10,22,eneheuvel,26-09-11
2009,17DV00,309,14,13,27,eneheuvel,26-09-11
2009,17DV00,310,1,2,3,eneheuvel,26-09-11
2009,17DV00,311,7,4,11,eneheuvel,26-09-11
2009,17DV00,312,1,0,1,eneheuvel,26-09-11
2009,17DV00,502,0,2,2,eneheuvel,26-09-11
2009,17DV00,9999,1,2,3,eneheuvel,26-09-11
2009,17FI00,101,0,1,1,eneheuvel,26-09-11
2009,17FI00,102,0,3,3,eneheuvel,26-09-11
2009,17FI00,103,2,4,6,eneheuvel,26-09-11
2009,17FI00,104,1,0,1,eneheuvel,26-09-11
2009,17FI00,106,2,2,4,eneheuvel,26-09-11
2009,17FI00,108,1,7,8,eneheuvel,26-09-11
2009,17FI00,201,0,1,1,eneheuvel,26-09-11
2009,17FI00,202,0,18,18,eneheuvel,26-09-11
2009,17FI00,203,5,11,16,eneheuvel,26-09-11
2009,17FI00,204,5,7,12,eneheuvel,26-09-11
2009,17FI00,205,0,6,6,eneheuvel,26-09-11
2009,17FI00,206,3,6,9,eneheuvel,26-09-11
2009,17FI00,207,1,3,4,eneheuvel,26-09-11
2009,17FI00,208,3,12,15,eneheuvel,26-09-11
2009,17FI00,209,2,2,4,eneheuvel,26-09-11
2009,17FI00,210,3,4,7,eneheuvel,26-09-11
2009,17FI00,211,3,6,9,eneheuvel,26-09-11
2009,17FI00,212,1,8,9,eneheuvel,26-09-11
2009,17FI00,213,1,5,6,eneheuvel,26-09-11
2009,17FI00,214,0,6,6,eneheuvel,26-09-11
2009,17FI00,216,1,3,4,eneheuvel,26-09-11
2009,17FI00,302,1,4,5,eneheuvel,26-09-11
2009,17FI00,303,2,3,5,eneheuvel,26-09-11
2009,17FI00,304,3,6,9,eneheuvel,26-09-11
2009,17FI00,305,0,7,7,eneheuvel,26-09-11
2009,17FI00,306,2,2,4,eneheuvel,26-09-11
2009,17FI00,307,2,5,7,eneheuvel,26-09-11
2009,17FI00,308,0,2,2,eneheuvel,26-09-11
2009,17FI00,309,3,4,7,eneheuvel,26-09-11
2009,17FI00,310,0,1,1,eneheuvel,26-09-11
2009,17FI00,311,2,4,6,eneheuvel,26-09-11
2009,17FI00,312,0,1,1,eneheuvel,26-09-11
2009,17FI00,313,1,0,1,eneheuvel,26-09-11
2009,17FI00,402,0,1,1,eneheuvel,26-09-11
2009,17FI00,502,0,1,1,eneheuvel,26-09-11
2009,17FI00,9999,1,1,2,eneheuvel,26-09-11
2009,17LP00,207,1,0,1,eneheuvel,26-09-11
2009,17LP00,213,1,0,1,eneheuvel,26-09-11
2009,17LP00,301,1,1,2,eneheuvel,26-09-11
2009,17LP00,304,1,0,1,eneheuvel,26-09-11
2009,17LP00,305,56,53,109,eneheuvel,26-09-11
2009,17LP00,306,9,3,12,eneheuvel,26-09-11
2009,17LP00,308,2,1,3,eneheuvel,26-09-11
2009,17LP00,309,3,1,4,eneheuvel,26-09-11
2009,17LP00,310,1,0,1,eneheuvel,26-09-11
2009,17MH00,202,1,1,2,eneheuvel,26-09-11
2009,17MH00,203,1,0,1,eneheuvel,26-09-11
2009,17MH00,207,0,2,2,eneheuvel,26-09-11
2009,17MH00,210,0,3,3,eneheuvel,26-09-11
2009,17MH00,212,0,1,1,eneheuvel,26-09-11
2009,17MH00,302,0,1,1,eneheuvel,26-09-11
2009,17MH00,304,0,1,1,eneheuvel,26-09-11
2009,17MH00,305,58,61,119,eneheuvel,26-09-11
2009,17MH00,306,1,4,5,eneheuvel,26-09-11
2009,21KO00,201,2,0,2,eneheuvel,26-09-11
2009,21KO00,202,0,2,2,eneheuvel,26-09-11
2009,21KO00,206,0,1,1,eneheuvel,26-09-11
2009,21KO00,209,8,4,12,eneheuvel,26-09-11
2009,21KO00,210,75,82,157,eneheuvel,26-09-11
2009,21KO00,211,3,0,3,eneheuvel,26-09-11
2009,21KO00,212,3,0,3,eneheuvel,26-09-11
2009,21KO00,214,1,1,2,eneheuvel,26-09-11
2009,21KO00,216,0,2,2,eneheuvel,26-09-11
2009,21KO00,309,0,1,1,eneheuvel,26-09-11
2009,21KO00,9999,0,1,1,eneheuvel,26-09-11
2009,21NC00,103,0,1,1,eneheuvel,26-09-11
2009,21NC00,110,2,1,3,eneheuvel,26-09-11
2009,21NC00,210,1,0,1,eneheuvel,26-09-11
2009,21NC00,211,7,1,8,eneheuvel,26-09-11
2009,21NC00,212,6,3,9,eneheuvel,26-09-11
2009,21NC00,213,47,56,103,eneheuvel,26-09-11
2009,21NC00,214,7,16,23,eneheuvel,26-09-11
2009,21NC00,301,0,1,1,eneheuvel,26-09-11
2009,21NC00,303,1,0,1,eneheuvel,26-09-11
2009,21NC00,309,0,1,1,eneheuvel,26-09-11
2009,21NC00,310,1,2,3,eneheuvel,26-09-11
2009,21NC00,9999,4,0,4,eneheuvel,26-09-11
2009,21ND00,102,1,1,2,eneheuvel,26-09-11
2009,21ND00,208,0,1,1,eneheuvel,26-09-11
2009,21ND00,209,1,0,1,eneheuvel,26-09-11
2009,21ND00,211,13,16,29,eneheuvel,26-09-11
2009,21ND00,212,7,4,11,eneheuvel,26-09-11
2009,21ND00,213,52,94,146,eneheuvel,26-09-11
2009,21ND00,214,1,0,1,eneheuvel,26-09-11
2009,21ND00,312,0,1,1,eneheuvel,26-09-11
2009,21ND00,402,1,0,1,eneheuvel,26-09-11
2009,22KP00,102,0,1,1,eneheuvel,26-09-11
2009,22KP00,202,1,0,1,eneheuvel,26-09-11
2009,22KP00,203,2,0,2,eneheuvel,26-09-11
2009,22KP00,204,2,0,2,eneheuvel,26-09-11
2009,22KP00,207,0,1,1,eneheuvel,26-09-11
2009,22KP00,208,2,0,2,eneheuvel,26-09-11
2009,22KP00,210,1,1,2,eneheuvel,26-09-11
2009,22KP00,211,2,0,2,eneheuvel,26-09-11
2009,22KP00,301,1,1,2,eneheuvel,26-09-11
2009,22KP00,302,4,3,7,eneheuvel,26-09-11
2009,22KP00,303,4,4,8,eneheuvel,26-09-11
2009,22KP00,304,2,6,8,eneheuvel,26-09-11
2009,22KP00,305,1,0,1,eneheuvel,26-09-11
2009,22KP00,306,0,2,2,eneheuvel,26-09-11
2009,22KP00,307,1,4,5,eneheuvel,26-09-11
2009,22KP00,308,1,11,12,eneheuvel,26-09-11
2009,22KP00,309,130,151,281,eneheuvel,26-09-11
2009,22KP00,310,5,5,10,eneheuvel,26-09-11
2009,22KP00,311,15,18,33,eneheuvel,26-09-11
2009,22KP00,312,2,4,6,eneheuvel,26-09-11
2009,22KP00,9999,3,1,4,eneheuvel,26-09-11
2009,22KQ00,109,0,1,1,eneheuvel,26-09-11
2009,22KQ00,201,2,0,2,eneheuvel,26-09-11
2009,22KQ00,205,1,1,2,eneheuvel,26-09-11
2009,22KQ00,206,0,1,1,eneheuvel,26-09-11
2009,22KQ00,208,1,0,1,eneheuvel,26-09-11
2009,22KQ00,209,2,2,4,eneheuvel,26-09-11
2009,22KQ00,210,54,79,133,eneheuvel,26-09-11
2009,22KQ00,211,1,2,3,eneheuvel,26-09-11
2009,22KQ00,212,1,2,3,eneheuvel,26-09-11
2009,22KQ00,307,0,1,1,eneheuvel,26-09-11
2009,22KQ00,9999,1,1,2,eneheuvel,26-09-11
2009,23ER00,201,1,0,1,eneheuvel,26-09-11
2009,23ER00,210,2,0,2,eneheuvel,26-09-11
2009,23ER00,212,64,86,150,eneheuvel,26-09-11
2009,23ER00,213,3,0,3,eneheuvel,26-09-11
2009,23ER00,214,2,3,5,eneheuvel,26-09-11
2009,23ER00,303,0,2,2,eneheuvel,26-09-11
2009,23ER00,9999,0,1,1,eneheuvel,26-09-11
2009,23ET00,201,1,0,1,eneheuvel,26-09-11
2009,23ET00,202,0,1,1,eneheuvel,26-09-11
2009,23ET00,203,1,0,1,eneheuvel,26-09-11
2009,23ET00,204,1,0,1,eneheuvel,26-09-11
2009,23ET00,208,0,2,2,eneheuvel,26-09-11
2009,23ET00,210,0,1,1,eneheuvel,26-09-11
2009,23ET00,214,0,2,2,eneheuvel,26-09-11
2009,23ET00,301,0,1,1,eneheuvel,26-09-11
2009,23ET00,302,0,2,2,eneheuvel,26-09-11
2009,23ET00,305,1,0,1,eneheuvel,26-09-11
2009,23ET00,306,2,6,8,eneheuvel,26-09-11
2009,23ET00,307,5,5,10,eneheuvel,26-09-11
2009,23ET00,308,65,76,141,eneheuvel,26-09-11
2009,23ET00,309,4,8,12,eneheuvel,26-09-11
2009,23ET00,310,0,1,1,eneheuvel,26-09-11
2009,23ET00,311,2,2,4,eneheuvel,26-09-11
2009,23ET00,312,3,4,7,eneheuvel,26-09-11
2009,23ET00,9999,0,1,1,eneheuvel,26-09-11
2009,23EU00,207,1,1,2,eneheuvel,26-09-11
2009,23EU00,208,0,1,1,eneheuvel,26-09-11
2009,23EU00,301,0,1,1,eneheuvel,26-09-11
2009,23EU00,302,1,0,1,eneheuvel,26-09-11
2009,23EU00,303,0,2,2,eneheuvel,26-09-11
2009,23EU00,305,0,9,9,eneheuvel,26-09-11
2009,23EU00,306,86,104,190,eneheuvel,26-09-11
2009,23EU00,307,8,6,14,eneheuvel,26-09-11
2009,23EU00,308,0,2,2,eneheuvel,26-09-11
2009,23EU00,309,2,0,2,eneheuvel,26-09-11
2009,23EU00,310,0,1,1,eneheuvel,26-09-11
2009,23EU00,311,1,2,3,eneheuvel,26-09-11
2009,23EU00,313,0,2,2,eneheuvel,26-09-11
2009,23EU00,9999,0,1,1,eneheuvel,26-09-11
2009,23EV00,102,1,0,1,eneheuvel,26-09-11
2009,23EV00,201,0,1,1,eneheuvel,26-09-11
2009,23EV00,204,1,0,1,eneheuvel,26-09-11
2009,23EV00,207,1,2,3,eneheuvel,26-09-11
2009,23EV00,208,0,1,1,eneheuvel,26-09-11
2009,23EV00,209,1,0,1,eneheuvel,26-09-11
2009,23EV00,210,11,8,19,eneheuvel,26-09-11
2009,23EV00,211,7,12,19,eneheuvel,26-09-11
2009,23EV00,212,86,119,205,eneheuvel,26-09-11
2009,23EV00,213,34,16,50,eneheuvel,26-09-11
2009,23EV00,214,5,3,8,eneheuvel,26-09-11
2009,23EV00,216,0,1,1,eneheuvel,26-09-11
2009,23EV00,302,1,0,1,eneheuvel,26-09-11
2009,23EV00,307,0,2,2,eneheuvel,26-09-11
2009,23EV00,402,0,1,1,eneheuvel,26-09-11
2009,23EV00,403,0,1,1,eneheuvel,26-09-11
2009,23EV00,9999,4,0,4,eneheuvel,26-09-11
2009,23EY00,103,1,0,1,eneheuvel,26-09-11
2009,23EY00,201,2,1,3,eneheuvel,26-09-11
2009,23EY00,202,1,1,2,eneheuvel,26-09-11
2009,23EY00,206,0,1,1,eneheuvel,26-09-11
2009,23EY00,208,1,4,5,eneheuvel,26-09-11
2009,23EY00,209,0,1,1,eneheuvel,26-09-11
2009,23EY00,210,6,11,17,eneheuvel,26-09-11
2009,23EY00,211,13,14,27,eneheuvel,26-09-11
2009,23EY00,212,116,112,228,eneheuvel,26-09-11
2009,23EY00,213,25,21,46,eneheuvel,26-09-11
2009,23EY00,214,4,3,7,eneheuvel,26-09-11
2009,23EY00,215,2,0,2,eneheuvel,26-09-11
2009,23EY00,216,0,2,2,eneheuvel,26-09-11
2009,23EY00,302,1,0,1,eneheuvel,26-09-11
2009,23EY00,304,0,1,1,eneheuvel,26-09-11
2009,23EY00,311,1,0,1,eneheuvel,26-09-11
2009,23EY00,502,0,1,1,eneheuvel,26-09-11
2009,23EY00,9999,2,0,2,eneheuvel,26-09-11
2009,23ZU00,110,1,0,1,eneheuvel,26-09-11
2009,23ZU00,201,1,0,1,eneheuvel,26-09-11
2009,23ZU00,202,71,82,153,eneheuvel,26-09-11
2009,23ZU00,203,7,8,15,eneheuvel,26-09-11
2009,23ZU00,204,51,40,91,eneheuvel,26-09-11
2009,23ZU00,205,84,98,182,eneheuvel,26-09-11
2009,23ZU00,206,2,1,3,eneheuvel,26-09-11
2009,23ZU00,207,34,19,53,eneheuvel,26-09-11
2009,23ZU00,208,13,15,28,eneheuvel,26-09-11
2009,23ZU00,209,1,0,1,eneheuvel,26-09-11
2009,23ZU00,210,1,3,4,eneheuvel,26-09-11
2009,23ZU00,211,1,1,2,eneheuvel,26-09-11
2009,23ZU00,214,0,2,2,eneheuvel,26-09-11
2009,23ZU00,215,0,2,2,eneheuvel,26-09-11
2009,23ZU00,216,4,3,7,eneheuvel,26-09-11
2009,23ZU00,302,1,1,2,eneheuvel,26-09-11
2009,23ZU00,303,0,6,6,eneheuvel,26-09-11
2009,23ZU00,306,2,0,2,eneheuvel,26-09-11
2009,23ZU00,307,0,1,1,eneheuvel,26-09-11
2009,23ZU00,309,0,2,2,eneheuvel,26-09-11
2009,23ZU00,311,2,1,3,eneheuvel,26-09-11
2009,23ZU00,502,0,1,1,eneheuvel,26-09-11
2009,23ZU00,9999,1,0,1,eneheuvel,26-09-11
2009,23ZV00,103,0,1,1,eneheuvel,26-09-11
2009,23ZV00,107,0,1,1,eneheuvel,26-09-11
2009,23ZV00,110,0,1,1,eneheuvel,26-09-11
2009,23ZV00,201,3,3,6,eneheuvel,26-09-11
2009,23ZV00,202,31,37,68,eneheuvel,26-09-11
2009,23ZV00,203,4,4,8,eneheuvel,26-09-11
2009,23ZV00,204,21,33,54,eneheuvel,26-09-11
2009,23ZV00,205,34,53,87,eneheuvel,26-09-11
2009,23ZV00,206,0,1,1,eneheuvel,26-09-11
2009,23ZV00,207,10,11,21,eneheuvel,26-09-11
2009,23ZV00,208,3,9,12,eneheuvel,26-09-11
2009,23ZV00,210,1,2,3,eneheuvel,26-09-11
2009,23ZV00,211,1,1,2,eneheuvel,26-09-11
2009,23ZV00,212,2,1,3,eneheuvel,26-09-11
2009,23ZV00,302,0,1,1,eneheuvel,26-09-11
2009,23ZV00,306,1,0,1,eneheuvel,26-09-11
2009,23ZV00,308,1,1,2,eneheuvel,26-09-11
2009,23ZV00,309,1,0,1,eneheuvel,26-09-11
2009,23ZV00,311,1,0,1,eneheuvel,26-09-11
2009,23ZV00,9999,1,2,3,eneheuvel,26-09-11
2009,23ZW00,206,1,0,1,eneheuvel,26-09-11
2009,23ZW00,207,1,0,1,eneheuvel,26-09-11
2009,23ZW00,208,2,5,7,eneheuvel,26-09-11
2009,23ZW00,214,1,1,2,eneheuvel,26-09-11
2009,23ZW00,301,3,1,4,eneheuvel,26-09-11
2009,23ZW00,302,6,2,8,eneheuvel,26-09-11
2009,23ZW00,303,4,4,8,eneheuvel,26-09-11
2009,23ZW00,304,2,3,5,eneheuvel,26-09-11
2009,23ZW00,305,2,4,6,eneheuvel,26-09-11
2009,23ZW00,306,25,28,53,eneheuvel,26-09-11
2009,23ZW00,307,79,81,160,eneheuvel,26-09-11
2009,23ZW00,308,85,85,170,eneheuvel,26-09-11
2009,23ZW00,309,7,5,12,eneheuvel,26-09-11
2009,23ZW00,310,1,2,3,eneheuvel,26-09-11
2009,23ZW00,311,1,0,1,eneheuvel,26-09-11
2009,23ZW00,312,2,5,7,eneheuvel,26-09-11
2009,23ZW00,313,0,1,1,eneheuvel,26-09-11
2009,23ZW00,502,4,0,4,eneheuvel,26-09-11
2009,23ZW00,9999,3,3,6,eneheuvel,26-09-11
2009,23ZX00,110,0,1,1,eneheuvel,26-09-11
2009,23ZX00,201,9,4,13,eneheuvel,26-09-11
2009,23ZX00,202,117,150,267,eneheuvel,26-09-11
2009,23ZX00,203,2,2,4,eneheuvel,26-09-11
2009,23ZX00,204,3,3,6,eneheuvel,26-09-11
2009,23ZX00,205,5,8,13,eneheuvel,26-09-11
2009,23ZX00,207,2,7,9,eneheuvel,26-09-11
2009,23ZX00,208,5,9,14,eneheuvel,26-09-11
2009,23ZX00,209,4,1,5,eneheuvel,26-09-11
2009,23ZX00,210,0,1,1,eneheuvel,26-09-11
2009,23ZX00,211,6,2,8,eneheuvel,26-09-11
2009,23ZX00,301,1,0,1,eneheuvel,26-09-11
2009,23ZX00,306,1,1,2,eneheuvel,26-09-11
2009,23ZX00,307,0,1,1,eneheuvel,26-09-11
2009,23ZX00,9999,0,1,1,eneheuvel,26-09-11
2009,23ZY00,107,1,0,1,eneheuvel,26-09-11
2009,23ZY00,203,1,0,1,eneheuvel,26-09-11
2009,23ZY00,206,1,1,2,eneheuvel,26-09-11
2009,23ZY00,207,1,0,1,eneheuvel,26-09-11
2009,23ZY00,210,3,0,3,eneheuvel,26-09-11
2009,23ZY00,211,1,1,2,eneheuvel,26-09-11
2009,23ZY00,212,157,178,335,eneheuvel,26-09-11
2009,23ZY00,213,3,1,4,eneheuvel,26-09-11
2009,23ZY00,214,1,2,3,eneheuvel,26-09-11
2009,23ZY00,215,1,1,2,eneheuvel,26-09-11
2009,23ZY00,216,0,1,1,eneheuvel,26-09-11
2009,23ZY00,302,1,1,2,eneheuvel,26-09-11
2009,23ZY00,9999,1,0,1,eneheuvel,26-09-11
2009,24EJ00,101,1,0,1,eneheuvel,26-09-11
2009,24EJ00,102,2,4,6,eneheuvel,26-09-11
2009,24EJ00,106,0,2,2,eneheuvel,26-09-11
2009,24EJ00,107,2,1,3,eneheuvel,26-09-11
2009,24EJ00,108,2,1,3,eneheuvel,26-09-11
2009,24EJ00,201,2,0,2,eneheuvel,26-09-11
2009,24EJ00,202,6,3,9,eneheuvel,26-09-11
2009,24EJ00,203,1,2,3,eneheuvel,26-09-11
2009,24EJ00,204,5,8,13,eneheuvel,26-09-11
2009,24EJ00,206,1,3,4,eneheuvel,26-09-11
2009,24EJ00,207,3,2,5,eneheuvel,26-09-11
2009,24EJ00,208,1,6,7,eneheuvel,26-09-11
2009,24EJ00,209,12,10,22,eneheuvel,26-09-11
2009,24EJ00,210,22,17,39,eneheuvel,26-09-11
2009,24EJ00,211,37,32,69,eneheuvel,26-09-11
2009,24EJ00,212,9,11,20,eneheuvel,26-09-11
2009,24EJ00,213,5,6,11,eneheuvel,26-09-11
2009,24EJ00,214,5,1,6,eneheuvel,26-09-11
2009,24EJ00,303,0,2,2,eneheuvel,26-09-11
2009,24EJ00,305,3,0,3,eneheuvel,26-09-11
2009,24EJ00,308,1,0,1,eneheuvel,26-09-11
2009,24EJ00,309,1,0,1,eneheuvel,26-09-11
2009,24EJ00,9999,3,2,5,eneheuvel,26-09-11
2009,24FT00,102,0,2,2,eneheuvel,26-09-11
2009,24FT00,103,0,3,3,eneheuvel,26-09-11
2009,24FT00,104,1,0,1,eneheuvel,26-09-11
2009,24FT00,105,0,2,2,eneheuvel,26-09-11
2009,24FT00,106,0,2,2,eneheuvel,26-09-11
2009,24FT00,107,1,0,1,eneheuvel,26-09-11
2009,24FT00,108,0,2,2,eneheuvel,26-09-11
2009,24FT00,109,1,0,1,eneheuvel,26-09-11
2009,24FT00,203,1,4,5,eneheuvel,26-09-11
2009,24FT00,204,0,2,2,eneheuvel,26-09-11
2009,24FT00,205,1,3,4,eneheuvel,26-09-11
2009,24FT00,206,1,6,7,eneheuvel,26-09-11
2009,24FT00,207,2,2,4,eneheuvel,26-09-11
2009,24FT00,208,3,6,9,eneheuvel,26-09-11
2009,24FT00,209,1,0,1,eneheuvel,26-09-11
2009,24FT00,210,0,3,3,eneheuvel,26-09-11
2009,24FT00,211,8,12,20,eneheuvel,26-09-11
2009,24FT00,212,3,18,21,eneheuvel,26-09-11
2009,24FT00,213,2,9,11,eneheuvel,26-09-11
2009,24FT00,214,3,15,18,eneheuvel,26-09-11
2009,24FT00,216,0,1,1,eneheuvel,26-09-11
2009,24FT00,301,2,0,2,eneheuvel,26-09-11
2009,24FT00,302,1,20,21,eneheuvel,26-09-11
2009,24FT00,303,1,17,18,eneheuvel,26-09-11
2009,24FT00,304,1,5,6,eneheuvel,26-09-11
2009,24FT00,305,0,3,3,eneheuvel,26-09-11
2009,24FT00,306,2,5,7,eneheuvel,26-09-11
2009,24FT00,307,0,9,9,eneheuvel,26-09-11
2009,24FT00,308,0,11,11,eneheuvel,26-09-11
2009,24FT00,309,1,9,10,eneheuvel,26-09-11
2009,24FT00,311,3,9,12,eneheuvel,26-09-11
2009,24FT00,312,5,14,19,eneheuvel,26-09-11
2009,24FT00,313,0,1,1,eneheuvel,26-09-11
2009,24FT00,502,0,1,1,eneheuvel,26-09-11
2009,24FT00,9999,0,2,2,eneheuvel,26-09-11
2009,24MR00,201,0,2,2,eneheuvel,26-09-11
2009,24MR00,205,1,0,1,eneheuvel,26-09-11
2009,24MR00,208,2,1,3,eneheuvel,26-09-11
2009,24MR00,301,1,0,1,eneheuvel,26-09-11
2009,24MR00,302,1,0,1,eneheuvel,26-09-11
2009,24MR00,305,2,1,3,eneheuvel,26-09-11
2009,24MR00,306,9,15,24,eneheuvel,26-09-11
2009,24MR00,307,104,135,239,eneheuvel,26-09-11
2009,24MR00,308,3,8,11,eneheuvel,26-09-11
2009,24MR00,309,1,0,1,eneheuvel,26-09-11
2009,24MR00,311,1,1,2,eneheuvel,26-09-11
2009,24MR00,502,0,2,2,eneheuvel,26-09-11
2009,24RK00,202,13,14,27,eneheuvel,26-09-11
2009,24RK00,203,15,8,23,eneheuvel,26-09-11
2009,24RK00,204,11,13,24,eneheuvel,26-09-11
2009,24RK00,205,8,5,13,eneheuvel,26-09-11
2009,24RK00,206,4,1,5,eneheuvel,26-09-11
2009,24RK00,207,6,4,10,eneheuvel,26-09-11
2009,24RK00,208,6,2,8,eneheuvel,26-09-11
2009,24RK00,210,0,2,2,eneheuvel,26-09-11
2009,24RK00,211,2,0,2,eneheuvel,26-09-11
2009,24RK00,212,1,1,2,eneheuvel,26-09-11
2009,24RK00,213,2,2,4,eneheuvel,26-09-11
2009,24RK00,214,1,1,2,eneheuvel,26-09-11
2009,24RK00,216,1,3,4,eneheuvel,26-09-11
2009,24RK00,301,2,1,3,eneheuvel,26-09-11
2009,24RK00,302,4,5,9,eneheuvel,26-09-11
2009,24RK00,303,3,5,8,eneheuvel,26-09-11
2009,24RK00,304,2,4,6,eneheuvel,26-09-11
2009,24RK00,305,1,2,3,eneheuvel,26-09-11
2009,24RK00,306,3,2,5,eneheuvel,26-09-11
2009,24RK00,307,5,5,10,eneheuvel,26-09-11
2009,24RK00,308,5,3,8,eneheuvel,26-09-11
2009,24RK00,309,2,3,5,eneheuvel,26-09-11
2009,24RK00,311,1,0,1,eneheuvel,26-09-11
2009,24RK00,312,2,0,2,eneheuvel,26-09-11
2009,24RK00,9999,0,2,2,eneheuvel,26-09-11
2009,24UN00,202,3,1,4,eneheuvel,26-09-11
2009,24UN00,204,0,1,1,eneheuvel,26-09-11
2009,24UN00,210,0,1,1,eneheuvel,26-09-11
2009,24UN00,302,1,1,2,eneheuvel,26-09-11
2009,24UN00,303,2,0,2,eneheuvel,26-09-11
2009,24UN00,305,0,1,1,eneheuvel,26-09-11
2009,24UN00,306,15,29,44,eneheuvel,26-09-11
2009,24UN00,307,35,42,77,eneheuvel,26-09-11
2009,24UN00,308,56,48,104,eneheuvel,26-09-11
2009,24UN00,309,12,15,27,eneheuvel,26-09-11
2009,24UN00,311,1,1,2,eneheuvel,26-09-11
2009,24UN00,312,0,1,1,eneheuvel,26-09-11
2009,24UN00,313,0,1,1,eneheuvel,26-09-11
2009,24UN00,9999,1,1,2,eneheuvel,26-09-11
2009,25CF00,201,1,1,2,eneheuvel,26-09-11
2009,25CF00,202,3,8,11,eneheuvel,26-09-11
2009,25CF00,203,2,5,7,eneheuvel,26-09-11
2009,25CF00,204,58,73,131,eneheuvel,26-09-11
2009,25CF00,205,12,42,54,eneheuvel,26-09-11
2009,25CF00,206,1,0,1,eneheuvel,26-09-11
2009,25CF00,207,2,6,8,eneheuvel,26-09-11
2009,25CF00,208,3,4,7,eneheuvel,26-09-11
2009,25CF00,212,2,0,2,eneheuvel,26-09-11
2009,25CF00,213,0,1,1,eneheuvel,26-09-11
2009,25CF00,307,1,0,1,eneheuvel,26-09-11
2009,25CF00,309,1,0,1,eneheuvel,26-09-11
2009,25CF00,9999,1,0,1,eneheuvel,26-09-11
2009,25KT00,101,1,1,2,eneheuvel,26-09-11
2009,25KT00,105,1,0,1,eneheuvel,26-09-11
2009,25KT00,107,0,1,1,eneheuvel,26-09-11
2009,25KT00,109,1,0,1,eneheuvel,26-09-11
2009,25KT00,202,36,53,89,eneheuvel,26-09-11
2009,25KT00,203,96,90,186,eneheuvel,26-09-11
2009,25KT00,204,76,85,161,eneheuvel,26-09-11
2009,25KT00,205,2,6,8,eneheuvel,26-09-11
2009,25KT00,207,18,6,24,eneheuvel,26-09-11
2009,25KT00,208,34,38,72,eneheuvel,26-09-11
2009,25KT00,214,1,0,1,eneheuvel,26-09-11
2009,25KT00,302,0,1,1,eneheuvel,26-09-11
2009,25KT00,306,1,1,2,eneheuvel,26-09-11
2009,25KT00,308,1,0,1,eneheuvel,26-09-11
2009,25KT00,309,0,2,2,eneheuvel,26-09-11
2009,25KT00,402,0,1,1,eneheuvel,26-09-11
2009,25KT00,502,3,11,14,eneheuvel,26-09-11
2009,25KT00,9999,2,0,2,eneheuvel,26-09-11
2009,25KU00,110,1,3,4,eneheuvel,26-09-11
2009,25KU00,201,0,2,2,eneheuvel,26-09-11
2009,25KU00,202,25,31,56,eneheuvel,26-09-11
2009,25KU00,203,68,56,124,eneheuvel,26-09-11
2009,25KU00,204,55,74,129,eneheuvel,26-09-11
2009,25KU00,205,3,3,6,eneheuvel,26-09-11
2009,25KU00,206,0,1,1,eneheuvel,26-09-11
2009,25KU00,207,6,6,12,eneheuvel,26-09-11
2009,25KU00,208,21,25,46,eneheuvel,26-09-11
2009,25KU00,211,1,0,1,eneheuvel,26-09-11
2009,25KU00,212,0,2,2,eneheuvel,26-09-11
2009,25KU00,216,2,0,2,eneheuvel,26-09-11
2009,25KU00,309,0,1,1,eneheuvel,26-09-11
2009,25KU00,312,1,0,1,eneheuvel,26-09-11
2009,25KU00,313,0,1,1,eneheuvel,26-09-11
2009,25KU00,401,1,0,1,eneheuvel,26-09-11
2009,25KU00,402,1,0,1,eneheuvel,26-09-11
2009,25KU00,502,3,8,11,eneheuvel,26-09-11
2009,25KU00,9999,0,3,3,eneheuvel,26-09-11
2009,25KV00,104,0,1,1,eneheuvel,26-09-11
2009,25KV00,108,1,0,1,eneheuvel,26-09-11
2009,25KV00,202,2,1,3,eneheuvel,26-09-11
2009,25KV00,203,154,197,351,eneheuvel,26-09-11
2009,25KV00,204,2,7,9,eneheuvel,26-09-11
2009,25KV00,205,1,1,2,eneheuvel,26-09-11
2009,25KV00,207,0,2,2,eneheuvel,26-09-11
2009,25KV00,208,1,3,4,eneheuvel,26-09-11
2009,25KV00,211,0,1,1,eneheuvel,26-09-11
2009,25KV00,212,1,0,1,eneheuvel,26-09-11
2009,25KV00,308,0,1,1,eneheuvel,26-09-11
2009,25KV00,312,1,0,1,eneheuvel,26-09-11
2009,26AB00,205,1,0,1,eneheuvel,26-09-11
2009,26AB00,211,0,1,1,eneheuvel,26-09-11
2009,26AB00,215,0,1,1,eneheuvel,26-09-11
2009,26AB00,301,2,0,2,eneheuvel,26-09-11
2009,26AB00,302,16,26,42,eneheuvel,26-09-11
2009,26AB00,303,159,182,341,eneheuvel,26-09-11
2009,26AB00,304,3,6,9,eneheuvel,26-09-11
2009,26AB00,305,1,0,1,eneheuvel,26-09-11
2009,26AB00,306,0,3,3,eneheuvel,26-09-11
2009,26AB00,309,5,3,8,eneheuvel,26-09-11
2009,26AB00,310,2,0,2,eneheuvel,26-09-11
2009,26AB00,311,2,5,7,eneheuvel,26-09-11
2009,26AB00,312,1,4,5,eneheuvel,26-09-11
2009,26AB00,313,3,3,6,eneheuvel,26-09-11
2009,26AB00,9999,1,0,1,eneheuvel,26-09-11
2009,26AC00,107,1,3,4,eneheuvel,26-09-11
2009,26AC00,108,0,2,2,eneheuvel,26-09-11
2009,26AC00,109,26,13,39,eneheuvel,26-09-11
2009,26AC00,110,0,1,1,eneheuvel,26-09-11
2009,26AC00,201,0,1,1,eneheuvel,26-09-11
2009,26AC00,202,0,1,1,eneheuvel,26-09-11
2009,26AC00,203,3,0,3,eneheuvel,26-09-11
2009,26AC00,204,1,0,1,eneheuvel,26-09-11
2009,26AC00,205,1,1,2,eneheuvel,26-09-11
2009,26AC00,207,0,1,1,eneheuvel,26-09-11
2009,26AC00,210,0,2,2,eneheuvel,26-09-11
2009,26AC00,211,8,5,13,eneheuvel,26-09-11
2009,26AC00,212,8,13,21,eneheuvel,26-09-11
2009,26AC00,213,7,17,24,eneheuvel,26-09-11
2009,26AC00,214,443,377,820,eneheuvel,26-09-11
2009,26AC00,215,1,0,1,eneheuvel,26-09-11
2009,26AC00,301,1,0,1,eneheuvel,26-09-11
2009,26AC00,303,1,0,1,eneheuvel,26-09-11
2009,26AC00,309,1,0,1,eneheuvel,26-09-11
2009,26AC00,311,0,3,3,eneheuvel,26-09-11
2009,26AC00,312,2,0,2,eneheuvel,26-09-11
2009,26AC00,401,0,1,1,eneheuvel,26-09-11
2009,26AC00,402,0,2,2,eneheuvel,26-09-11
2009,26AC00,403,2,1,3,eneheuvel,26-09-11
2009,26AC00,9999,2,3,5,eneheuvel,26-09-11
2009,26AD00,101,0,1,1,eneheuvel,26-09-11
2009,26AD00,206,1,0,1,eneheuvel,26-09-11
2009,26AD00,207,1,1,2,eneheuvel,26-09-11
2009,26AD00,208,3,1,4,eneheuvel,26-09-11
2009,26AD00,210,1,0,1,eneheuvel,26-09-11
2009,26AD00,212,0,1,1,eneheuvel,26-09-11
2009,26AD00,214,1,1,2,eneheuvel,26-09-11
2009,26AD00,216,0,2,2,eneheuvel,26-09-11
2009,26AD00,301,3,0,3,eneheuvel,26-09-11
2009,26AD00,302,95,60,155,eneheuvel,26-09-11
2009,26AD00,303,35,26,61,eneheuvel,26-09-11
2009,26AD00,304,2,1,3,eneheuvel,26-09-11
2009,26AD00,305,2,2,4,eneheuvel,26-09-11
2009,26AD00,306,0,2,2,eneheuvel,26-09-11
2009,26AD00,307,1,1,2,eneheuvel,26-09-11
2009,26AD00,308,2,1,3,eneheuvel,26-09-11
2009,26AD00,309,69,50,119,eneheuvel,26-09-11
2009,26AD00,310,20,10,30,eneheuvel,26-09-11
2009,26AD00,311,34,27,61,eneheuvel,26-09-11
2009,26AD00,312,9,10,19,eneheuvel,26-09-11
2009,26AD00,313,7,7,14,eneheuvel,26-09-11
2009,26AD00,502,0,1,1,eneheuvel,26-09-11
2009,26AD00,9999,0,2,2,eneheuvel,26-09-11
2009,26PD00,101,0,2,2,eneheuvel,26-09-11
2009,26PD00,104,2,0,2,eneheuvel,26-09-11
2009,26PD00,108,1,0,1,eneheuvel,26-09-11
2009,26PD00,204,1,2,3,eneheuvel,26-09-11
2009,26PD00,205,3,6,9,eneheuvel,26-09-11
2009,26PD00,207,128,156,284,eneheuvel,26-09-11
2009,26PD00,208,29,31,60,eneheuvel,26-09-11
2009,26PD00,211,0,1,1,eneheuvel,26-09-11
2009,26PD00,304,0,1,1,eneheuvel,26-09-11
2009,26PD00,308,1,0,1,eneheuvel,26-09-11
2009,26PD00,309,0,1,1,eneheuvel,26-09-11
2009,26PD00,502,2,2,4,eneheuvel,26-09-11
2009,26PD00,9999,0,4,4,eneheuvel,26-09-11
2009,26PE00,201,1,1,2,eneheuvel,26-09-11
2009,26PE00,202,1,0,1,eneheuvel,26-09-11
2009,26PE00,203,1,1,2,eneheuvel,26-09-11
2009,26PE00,208,1,0,1,eneheuvel,26-09-11
2009,26PE00,301,3,0,3,eneheuvel,26-09-11
2009,26PE00,302,239,250,489,eneheuvel,26-09-11
2009,26PE00,303,28,18,46,eneheuvel,26-09-11
2009,26PE00,304,0,1,1,eneheuvel,26-09-11
2009,26PE00,306,0,1,1,eneheuvel,26-09-11
2009,26PE00,307,1,0,1,eneheuvel,26-09-11
2009,26PE00,308,1,0,1,eneheuvel,26-09-11
2009,26PE00,309,3,2,5,eneheuvel,26-09-11
2009,26PE00,311,7,9,16,eneheuvel,26-09-11
2009,26PE00,312,3,4,7,eneheuvel,26-09-11
2009,26PE00,313,6,3,9,eneheuvel,26-09-11
2009,26PE00,9999,1,1,2,eneheuvel,26-09-11
2009,26PF00,103,1,0,1,eneheuvel,26-09-11
2009,26PF00,201,4,1,5,eneheuvel,26-09-11
2009,26PF00,202,3,4,7,eneheuvel,26-09-11
2009,26PF00,203,1,0,1,eneheuvel,26-09-11
2009,26PF00,206,1,2,3,eneheuvel,26-09-11
2009,26PF00,207,2,3,5,eneheuvel,26-09-11
2009,26PF00,209,6,1,7,eneheuvel,26-09-11
2009,26PF00,210,2,0,2,eneheuvel,26-09-11
2009,26PF00,211,6,9,15,eneheuvel,26-09-11
2009,26PF00,212,15,7,22,eneheuvel,26-09-11
2009,26PF00,213,8,2,10,eneheuvel,26-09-11
2009,26PF00,214,178,203,381,eneheuvel,26-09-11
2009,26PF00,216,2,1,3,eneheuvel,26-09-11
2009,26PF00,302,0,5,5,eneheuvel,26-09-11
2009,26PF00,305,0,1,1,eneheuvel,26-09-11
2009,26PF00,306,0,1,1,eneheuvel,26-09-11
2009,26PF00,307,1,0,1,eneheuvel,26-09-11
2009,26PF00,309,2,1,3,eneheuvel,26-09-11
2009,26PF00,312,1,0,1,eneheuvel,26-09-11
2009,26PF00,401,2,0,2,eneheuvel,26-09-11
2009,26PF00,403,0,1,1,eneheuvel,26-09-11
2009,26PF00,9999,6,6,12,eneheuvel,26-09-11
2009,26PG00,101,1,0,1,eneheuvel,26-09-11
2009,26PG00,103,0,1,1,eneheuvel,26-09-11
2009,26PG00,108,1,0,1,eneheuvel,26-09-11
2009,26PG00,207,0,1,1,eneheuvel,26-09-11
2009,26PG00,209,1,0,1,eneheuvel,26-09-11
2009,26PG00,210,1,0,1,eneheuvel,26-09-11
2009,26PG00,211,2,1,3,eneheuvel,26-09-11
2009,26PG00,212,0,1,1,eneheuvel,26-09-11
2009,26PG00,213,1,1,2,eneheuvel,26-09-11
2009,26PG00,214,48,70,118,eneheuvel,26-09-11
2009,26PG00,9999,2,2,4,eneheuvel,26-09-11
2009,26PH00,102,1,1,2,eneheuvel,26-09-11
2009,26PH00,203,1,0,1,eneheuvel,26-09-11
2009,26PH00,207,0,1,1,eneheuvel,26-09-11
2009,26PH00,208,0,1,1,eneheuvel,26-09-11
2009,26PH00,214,1,0,1,eneheuvel,26-09-11
2009,26PH00,216,1,3,4,eneheuvel,26-09-11
2009,26PH00,302,27,25,52,eneheuvel,26-09-11
2009,26PH00,303,5,9,14,eneheuvel,26-09-11
2009,26PH00,304,2,1,3,eneheuvel,26-09-11
2009,26PH00,305,2,2,4,eneheuvel,26-09-11
2009,26PH00,306,4,1,5,eneheuvel,26-09-11
2009,26PH00,307,2,1,3,eneheuvel,26-09-11
2009,26PH00,308,5,2,7,eneheuvel,26-09-11
2009,26PH00,309,39,40,79,eneheuvel,26-09-11
2009,26PH00,310,2,0,2,eneheuvel,26-09-11
2009,26PH00,311,224,210,434,eneheuvel,26-09-11
2009,26PH00,312,15,15,30,eneheuvel,26-09-11
2009,26PH00,313,7,5,12,eneheuvel,26-09-11
2009,26PH00,9999,3,1,4,eneheuvel,26-09-11
2009,26PW00,216,0,2,2,eneheuvel,26-09-11
2009,26PW00,302,23,36,59,eneheuvel,26-09-11
2009,26PW00,303,31,25,56,eneheuvel,26-09-11
2009,26PW00,308,3,4,7,eneheuvel,26-09-11
2009,26PW00,309,37,32,69,eneheuvel,26-09-11
2009,26PW00,310,10,8,18,eneheuvel,26-09-11
2009,26PW00,311,19,20,39,eneheuvel,26-09-11
2009,26PW00,312,4,3,7,eneheuvel,26-09-11
2009,26PW00,313,0,5,5,eneheuvel,26-09-11
2009,26PW00,9999,2,0,2,eneheuvel,26-09-11
2009,26ZZ00,104,0,1,1,eneheuvel,26-09-11
2009,26ZZ00,106,0,3,3,eneheuvel,26-09-11
2009,26ZZ00,201,1,1,2,eneheuvel,26-09-11
2009,26ZZ00,202,224,218,442,eneheuvel,26-09-11
2009,26ZZ00,203,15,13,28,eneheuvel,26-09-11
2009,26ZZ00,204,2,2,4,eneheuvel,26-09-11
2009,26ZZ00,205,0,1,1,eneheuvel,26-09-11
2009,26ZZ00,207,1,1,2,eneheuvel,26-09-11
2009,26ZZ00,208,1,2,3,eneheuvel,26-09-11
2009,26ZZ00,210,1,1,2,eneheuvel,26-09-11
2009,26ZZ00,211,1,0,1,eneheuvel,26-09-11
2009,26ZZ00,212,0,1,1,eneheuvel,26-09-11
2009,26ZZ00,216,1,1,2,eneheuvel,26-09-11
2009,26ZZ00,302,1,1,2,eneheuvel,26-09-11
2009,26ZZ00,309,0,2,2,eneheuvel,26-09-11
2009,26ZZ00,313,1,0,1,eneheuvel,26-09-11
2009,26ZZ00,502,1,3,4,eneheuvel,26-09-11
2009,26ZZ00,9999,0,1,1,eneheuvel,26-09-11
2009,27AA00,106,2,1,3,eneheuvel,26-09-11
2009,27AA00,201,2,0,2,eneheuvel,26-09-11
2009,27AA00,202,5,0,5,eneheuvel,26-09-11
2009,27AA00,203,4,7,11,eneheuvel,26-09-11
2009,27AA00,204,5,14,19,eneheuvel,26-09-11
2009,27AA00,205,4,3,7,eneheuvel,26-09-11
2009,27AA00,206,0,1,1,eneheuvel,26-09-11
2009,27AA00,207,90,68,158,eneheuvel,26-09-11
2009,27AA00,208,178,162,340,eneheuvel,26-09-11
2009,27AA00,209,1,0,1,eneheuvel,26-09-11
2009,27AA00,210,1,1,2,eneheuvel,26-09-11
2009,27AA00,211,0,3,3,eneheuvel,26-09-11
2009,27AA00,212,1,0,1,eneheuvel,26-09-11
2009,27AA00,214,1,1,2,eneheuvel,26-09-11
2009,27AA00,303,3,2,5,eneheuvel,26-09-11
2009,27AA00,305,0,1,1,eneheuvel,26-09-11
2009,27AA00,306,0,1,1,eneheuvel,26-09-11
2009,27AA00,307,2,3,5,eneheuvel,26-09-11
2009,27AA00,308,1,2,3,eneheuvel,26-09-11
2009,27AA00,312,1,1,2,eneheuvel,26-09-11
2009,27NU00,103,1,0,1,eneheuvel,26-09-11
2009,27NU00,104,1,0,1,eneheuvel,26-09-11
2009,27NU00,108,1,0,1,eneheuvel,26-09-11
2009,27NU00,201,1,0,1,eneheuvel,26-09-11
2009,27NU00,202,1,0,1,eneheuvel,26-09-11
2009,27NU00,203,2,7,9,eneheuvel,26-09-11
2009,27NU00,204,4,3,7,eneheuvel,26-09-11
2009,27NU00,205,2,1,3,eneheuvel,26-09-11
2009,27NU00,206,0,1,1,eneheuvel,26-09-11
2009,27NU00,207,33,16,49,eneheuvel,26-09-11
2009,27NU00,208,145,154,299,eneheuvel,26-09-11
2009,27NU00,209,1,0,1,eneheuvel,26-09-11
2009,27NU00,210,0,2,2,eneheuvel,26-09-11
2009,27NU00,211,1,0,1,eneheuvel,26-09-11
2009,27NU00,214,0,1,1,eneheuvel,26-09-11
2009,27NU00,216,1,0,1,eneheuvel,26-09-11
2009,27NU00,302,1,0,1,eneheuvel,26-09-11
2009,27NU00,304,1,0,1,eneheuvel,26-09-11
2009,27NU00,305,0,1,1,eneheuvel,26-09-11
2009,27NU00,311,0,1,1,eneheuvel,26-09-11
2009,27NU00,312,0,1,1,eneheuvel,26-09-11
2009,27NU00,401,1,0,1,eneheuvel,26-09-11
2009,27NU00,502,0,2,2,eneheuvel,26-09-11
2009,27NU00,9999,1,1,2,eneheuvel,26-09-11
2009,27UB00,104,1,0,1,eneheuvel,26-09-11
2009,27UB00,105,0,1,1,eneheuvel,26-09-11
2009,27UB00,201,1,0,1,eneheuvel,26-09-11
2009,27UB00,202,1,2,3,eneheuvel,26-09-11
2009,27UB00,203,6,4,10,eneheuvel,26-09-11
2009,27UB00,204,4,1,5,eneheuvel,26-09-11
2009,27UB00,205,0,2,2,eneheuvel,26-09-11
2009,27UB00,207,15,7,22,eneheuvel,26-09-11
2009,27UB00,208,187,112,299,eneheuvel,26-09-11
2009,27UB00,209,1,0,1,eneheuvel,26-09-11
2009,27UB00,212,1,0,1,eneheuvel,26-09-11
2009,27UB00,216,1,0,1,eneheuvel,26-09-11
2009,27UB00,302,0,1,1,eneheuvel,26-09-11
2009,27UB00,305,1,0,1,eneheuvel,26-09-11
2009,27UB00,306,0,3,3,eneheuvel,26-09-11
2009,27UB00,307,2,1,3,eneheuvel,26-09-11
2009,27UB00,308,0,1,1,eneheuvel,26-09-11
2009,27UB00,309,1,1,2,eneheuvel,26-09-11
2009,27UB00,311,1,0,1,eneheuvel,26-09-11
2009,27UB00,502,5,1,6,eneheuvel,26-09-11
2009,27UB00,9999,2,1,3,eneheuvel,26-09-11
2009,27XH00,201,1,0,1,eneheuvel,26-09-11
2009,27XH00,202,0,1,1,eneheuvel,26-09-11
2009,27XH00,203,1,0,1,eneheuvel,26-09-11
2009,27XH00,206,0,1,1,eneheuvel,26-09-11
2009,27XH00,209,3,1,4,eneheuvel,26-09-11
2009,27XH00,210,7,5,12,eneheuvel,26-09-11
2009,27XH00,212,2,4,6,eneheuvel,26-09-11
2009,27XH00,213,0,1,1,eneheuvel,26-09-11
2009,27XH00,214,4,1,5,eneheuvel,26-09-11
2009,27XH00,215,15,24,39,eneheuvel,26-09-11
2009,27XH00,216,118,87,205,eneheuvel,26-09-11
2009,27XH00,311,1,0,1,eneheuvel,26-09-11
2009,27XJ00,108,1,0,1,eneheuvel,26-09-11
2009,27XJ00,201,1,0,1,eneheuvel,26-09-11
2009,27XJ00,207,1,0,1,eneheuvel,26-09-11
2009,27XJ00,212,0,1,1,eneheuvel,26-09-11
2009,27XJ00,302,15,2,17,eneheuvel,26-09-11
2009,27XJ00,303,8,1,9,eneheuvel,26-09-11
2009,27XJ00,306,2,2,4,eneheuvel,26-09-11
2009,27XJ00,307,0,1,1,eneheuvel,26-09-11
2009,27XJ00,308,1,1,2,eneheuvel,26-09-11
2009,27XJ00,309,6,2,8,eneheuvel,26-09-11
2009,27XJ00,311,27,5,32,eneheuvel,26-09-11
2009,27XJ00,312,162,89,251,eneheuvel,26-09-11
2009,27XJ00,313,46,14,60,eneheuvel,26-09-11
2009,27XJ00,403,1,0,1,eneheuvel,26-09-11
2009,27XJ00,502,0,2,2,eneheuvel,26-09-11
2009,27XJ00,9999,0,2,2,eneheuvel,26-09-11
2009,27YN00,107,2,0,2,eneheuvel,26-09-11
2009,27YN00,109,1,0,1,eneheuvel,26-09-11
2009,27YN00,110,1,2,3,eneheuvel,26-09-11
2009,27YN00,202,1,1,2,eneheuvel,26-09-11
2009,27YN00,203,0,1,1,eneheuvel,26-09-11
2009,27YN00,206,1,1,2,eneheuvel,26-09-11
2009,27YN00,208,1,1,2,eneheuvel,26-09-11
2009,27YN00,209,1,0,1,eneheuvel,26-09-11
2009,27YN00,210,13,14,27,eneheuvel,26-09-11
2009,27YN00,211,4,4,8,eneheuvel,26-09-11
2009,27YN00,212,5,5,10,eneheuvel,26-09-11
2009,27YN00,213,2,0,2,eneheuvel,26-09-11
2009,27YN00,214,2,2,4,eneheuvel,26-09-11
2009,27YN00,215,4,5,9,eneheuvel,26-09-11
2009,27YN00,216,129,96,225,eneheuvel,26-09-11
2009,27YN00,302,0,2,2,eneheuvel,26-09-11
2009,27YN00,303,1,1,2,eneheuvel,26-09-11
2009,27YN00,304,0,3,3,eneheuvel,26-09-11
2009,27YN00,307,0,1,1,eneheuvel,26-09-11
2009,27YN00,308,0,1,1,eneheuvel,26-09-11
2009,27YN00,9999,1,0,1,eneheuvel,26-09-11
2009,28AM00,102,0,1,1,eneheuvel,26-09-11
2009,28AM00,103,2,1,3,eneheuvel,26-09-11
2009,28AM00,207,3,1,4,eneheuvel,26-09-11
2009,28AM00,208,0,2,2,eneheuvel,26-09-11
2009,28AM00,211,0,1,1,eneheuvel,26-09-11
2009,28AM00,214,0,1,1,eneheuvel,26-09-11
2009,28AM00,302,6,1,7,eneheuvel,26-09-11
2009,28AM00,305,1,0,1,eneheuvel,26-09-11
2009,28AM00,309,1,1,2,eneheuvel,26-09-11
2009,28AM00,311,26,2,28,eneheuvel,26-09-11
2009,28AM00,312,183,156,339,eneheuvel,26-09-11
2009,28AM00,313,6,5,11,eneheuvel,26-09-11
2009,28BR00,203,0,1,1,eneheuvel,26-09-11
2009,28BR00,208,0,1,1,eneheuvel,26-09-11
2009,28BR00,212,0,4,4,eneheuvel,26-09-11
2009,28BR00,213,1,0,1,eneheuvel,26-09-11
2009,28BR00,301,0,1,1,eneheuvel,26-09-11
2009,28BR00,302,3,5,8,eneheuvel,26-09-11
2009,28BR00,303,0,1,1,eneheuvel,26-09-11
2009,28BR00,304,0,1,1,eneheuvel,26-09-11
2009,28BR00,306,4,0,4,eneheuvel,26-09-11
2009,28BR00,307,0,1,1,eneheuvel,26-09-11
2009,28BR00,309,1,2,3,eneheuvel,26-09-11
2009,28BR00,311,9,10,19,eneheuvel,26-09-11
2009,28BR00,312,0,2,2,eneheuvel,26-09-11
2009,28BR00,9999,0,1,1,eneheuvel,26-09-11
2009,28DJ00,106,1,1,2,eneheuvel,26-09-11
2009,28DJ00,107,2,2,4,eneheuvel,26-09-11
2009,28DJ00,108,1,0,1,eneheuvel,26-09-11
2009,28DJ00,202,3,0,3,eneheuvel,26-09-11
2009,28DJ00,203,2,6,8,eneheuvel,26-09-11
2009,28DJ00,204,1,1,2,eneheuvel,26-09-11
2009,28DJ00,205,4,2,6,eneheuvel,26-09-11
2009,28DJ00,206,1,0,1,eneheuvel,26-09-11
2009,28DJ00,207,11,7,18,eneheuvel,26-09-11
2009,28DJ00,208,10,15,25,eneheuvel,26-09-11
2009,28DJ00,210,1,1,2,eneheuvel,26-09-11
2009,28DJ00,211,5,3,8,eneheuvel,26-09-11
2009,28DJ00,212,2,3,5,eneheuvel,26-09-11
2009,28DJ00,213,2,1,3,eneheuvel,26-09-11
2009,28DJ00,214,1,2,3,eneheuvel,26-09-11
2009,28DJ00,215,0,1,1,eneheuvel,26-09-11
2009,28DJ00,216,2,0,2,eneheuvel,26-09-11
2009,28DJ00,301,1,0,1,eneheuvel,26-09-11
2009,28DJ00,302,6,2,8,eneheuvel,26-09-11
2009,28DJ00,303,2,4,6,eneheuvel,26-09-11
2009,28DJ00,304,2,1,3,eneheuvel,26-09-11
2009,28DJ00,305,3,4,7,eneheuvel,26-09-11
2009,28DJ00,306,4,2,6,eneheuvel,26-09-11
2009,28DJ00,307,3,4,7,eneheuvel,26-09-11
2009,28DJ00,308,6,4,10,eneheuvel,26-09-11
2009,28DJ00,309,2,0,2,eneheuvel,26-09-11
2009,28DJ00,311,0,1,1,eneheuvel,26-09-11
2009,28DJ00,312,1,0,1,eneheuvel,26-09-11
2009,28DJ00,9999,1,0,1,eneheuvel,26-09-11
2009,29UB00,102,1,1,2,eneheuvel,26-09-11
2009,29UB00,107,1,1,2,eneheuvel,26-09-11
2009,29UB00,202,1,0,1,eneheuvel,26-09-11
2009,29UB00,203,1,0,1,eneheuvel,26-09-11
2009,29UB00,206,1,0,1,eneheuvel,26-09-11
2009,29UB00,207,0,1,1,eneheuvel,26-09-11
2009,29UB00,208,1,0,1,eneheuvel,26-09-11
2009,29UB00,209,0,1,1,eneheuvel,26-09-11
2009,29UB00,210,0,4,4,eneheuvel,26-09-11
2009,29UB00,211,1,2,3,eneheuvel,26-09-11
2009,29UB00,212,6,8,14,eneheuvel,26-09-11
2009,29UB00,213,1,2,3,eneheuvel,26-09-11
2009,29UB00,214,27,30,57,eneheuvel,26-09-11
2009,29UB00,216,1,0,1,eneheuvel,26-09-11
2009,29UB00,306,1,0,1,eneheuvel,26-09-11
2009,29UB00,309,1,0,1,eneheuvel,26-09-11
2009,29UB00,401,10,7,17,eneheuvel,26-09-11
2009,29UB00,402,29,15,44,eneheuvel,26-09-11
2009,29UB00,403,12,4,16,eneheuvel,26-09-11
2009,29UB00,9999,3,0,3,eneheuvel,26-09-11
2009,29UN00,207,1,2,3,eneheuvel,26-09-11
2009,29UN00,209,1,0,1,eneheuvel,26-09-11
2009,29UN00,211,0,1,1,eneheuvel,26-09-11
2009,29UN00,213,1,1,2,eneheuvel,26-09-11
2009,29UN00,301,2,2,4,eneheuvel,26-09-11
2009,29UN00,302,4,0,4,eneheuvel,26-09-11
2009,29UN00,304,2,3,5,eneheuvel,26-09-11
2009,29UN00,305,4,10,14,eneheuvel,26-09-11
2009,29UN00,306,2,3,5,eneheuvel,26-09-11
2009,29UN00,307,1,2,3,eneheuvel,26-09-11
2009,29UN00,308,3,2,5,eneheuvel,26-09-11
2009,29UN00,309,3,3,6,eneheuvel,26-09-11
2009,29UN00,310,1,0,1,eneheuvel,26-09-11
2009,29UN00,311,3,6,9,eneheuvel,26-09-11
2009,29UN00,312,2,2,4,eneheuvel,26-09-11
2009,29XC00,207,0,2,2,eneheuvel,26-09-11
2009,29XC00,213,1,1,2,eneheuvel,26-09-11
2009,29XC00,402,1,1,2,eneheuvel,26-09-11
2009,29XC00,403,0,1,1,eneheuvel,26-09-11
2009,29XT00,104,1,0,1,eneheuvel,26-09-11
2009,29XT00,203,1,0,1,eneheuvel,26-09-11
2009,29XT00,212,1,2,3,eneheuvel,26-09-11
2009,29XT00,214,9,1,10,eneheuvel,26-09-11
2009,29XT00,302,1,0,1,eneheuvel,26-09-11
2009,29XT00,304,2,1,3,eneheuvel,26-09-11
2009,29XT00,311,2,0,2,eneheuvel,26-09-11
2009,29XT00,313,2,1,3,eneheuvel,26-09-11
2009,29XT00,401,12,7,19,eneheuvel,26-09-11
2009,29XT00,402,4,1,5,eneheuvel,26-09-11
2009,29XT00,9999,2,0,2,eneheuvel,26-09-11
2009,29XU00,203,0,2,2,eneheuvel,26-09-11
2009,29XU00,216,0,1,1,eneheuvel,26-09-11
2009,29XU00,302,0,1,1,eneheuvel,26-09-11
2009,29XU00,401,9,4,13,eneheuvel,26-09-11
2009,29XU00,402,1,3,4,eneheuvel,26-09-11
2009,29XU00,9999,1,0,1,eneheuvel,26-09-11
2009,29XX00,202,1,1,2,eneheuvel,26-09-11
2009,29XX00,203,1,1,2,eneheuvel,26-09-11
2009,29XX00,205,0,1,1,eneheuvel,26-09-11
2009,29XX00,206,0,1,1,eneheuvel,26-09-11
2009,29XX00,207,1,4,5,eneheuvel,26-09-11
2009,29XX00,208,1,3,4,eneheuvel,26-09-11
2009,29XX00,209,1,2,3,eneheuvel,26-09-11
2009,29XX00,210,5,3,8,eneheuvel,26-09-11
2009,29XX00,211,1,0,1,eneheuvel,26-09-11
2009,29XX00,212,8,1,9,eneheuvel,26-09-11
2009,29XX00,213,0,1,1,eneheuvel,26-09-11
2009,29XX00,214,8,9,17,eneheuvel,26-09-11
2009,29XX00,216,1,2,3,eneheuvel,26-09-11
2009,29XX00,302,5,5,10,eneheuvel,26-09-11
2009,29XX00,303,0,1,1,eneheuvel,26-09-11
2009,29XX00,305,2,0,2,eneheuvel,26-09-11
2009,29XX00,307,1,1,2,eneheuvel,26-09-11
2009,29XX00,309,1,0,1,eneheuvel,26-09-11
2009,29XX00,311,4,5,9,eneheuvel,26-09-11
2009,29XX00,312,2,0,2,eneheuvel,26-09-11
2009,29XX00,313,0,2,2,eneheuvel,26-09-11
2009,29XX00,9999,0,1,1,eneheuvel,26-09-11
2009,30AJ00,107,0,1,1,eneheuvel,26-09-11
2009,30AJ00,203,0,2,2,eneheuvel,26-09-11
2009,30AJ00,402,6,4,10,eneheuvel,26-09-11
2009,30AJ00,9999,1,2,3,eneheuvel,26-09-11
2010,06RM00,102,2,3,5,eneheuvel,26-09-11
2010,06RM00,103,1,4,5,eneheuvel,26-09-11
2010,06RM00,104,1,2,3,eneheuvel,26-09-11
2010,06RM00,105,0,1,1,eneheuvel,26-09-11
2010,06RM00,106,0,1,1,eneheuvel,26-09-11
2010,06RM00,107,2,0,2,eneheuvel,26-09-11
2010,06RM00,201,1,0,1,eneheuvel,26-09-11
2010,06RM00,202,12,3,15,eneheuvel,26-09-11
2010,06RM00,204,2,4,6,eneheuvel,26-09-11
2010,06RM00,206,2,2,4,eneheuvel,26-09-11
2010,06RM00,207,5,3,8,eneheuvel,26-09-11
2010,06RM00,208,2,1,3,eneheuvel,26-09-11
2010,06RM00,209,2,0,2,eneheuvel,26-09-11
2010,06RM00,210,7,10,17,eneheuvel,26-09-11
2010,06RM00,211,5,7,12,eneheuvel,26-09-11
2010,06RM00,212,17,25,42,eneheuvel,26-09-11
2010,06RM00,213,5,6,11,eneheuvel,26-09-11
2010,06RM00,214,12,8,20,eneheuvel,26-09-11
2010,06RM00,215,0,3,3,eneheuvel,26-09-11
2010,06RM00,216,6,8,14,eneheuvel,26-09-11
2010,06RM00,302,4,3,7,eneheuvel,26-09-11
2010,06RM00,303,5,2,7,eneheuvel,26-09-11
2010,06RM00,304,1,1,2,eneheuvel,26-09-11
2010,06RM00,305,0,1,1,eneheuvel,26-09-11
2010,06RM00,307,0,1,1,eneheuvel,26-09-11
2010,06RM00,308,2,0,2,eneheuvel,26-09-11
2010,06RM00,309,1,2,3,eneheuvel,26-09-11
2010,06RM00,311,2,1,3,eneheuvel,26-09-11
2010,06RM00,312,1,4,5,eneheuvel,26-09-11
2010,06RM00,313,1,0,1,eneheuvel,26-09-11
2010,06RM00,402,0,1,1,eneheuvel,26-09-11
2010,06RM00,502,2,5,7,eneheuvel,26-09-11
2010,06RM00,9999,0,5,5,eneheuvel,26-09-11
2010,12HU00,102,0,1,1,eneheuvel,26-09-11
2010,12HU00,103,1,2,3,eneheuvel,26-09-11
2010,12HU00,201,4,2,6,eneheuvel,26-09-11
2010,12HU00,202,1,1,2,eneheuvel,26-09-11
2010,12HU00,203,1,0,1,eneheuvel,26-09-11
2010,12HU00,209,6,2,8,eneheuvel,26-09-11
2010,12HU00,210,1,2,3,eneheuvel,26-09-11
2010,12HU00,211,33,35,68,eneheuvel,26-09-11
2010,12HU00,213,1,0,1,eneheuvel,26-09-11
2010,12HU00,307,0,1,1,eneheuvel,26-09-11
2010,12HU00,312,1,0,1,eneheuvel,26-09-11
2010,12HU00,401,1,1,2,eneheuvel,26-09-11
2010,12HU00,9999,1,2,3,eneheuvel,26-09-11
2010,12PM00,101,6,6,12,eneheuvel,26-09-11
2010,12PM00,102,14,8,22,eneheuvel,26-09-11
2010,12PM00,103,35,27,62,eneheuvel,26-09-11
2010,12PM00,104,4,2,6,eneheuvel,26-09-11
2010,12PM00,105,0,1,1,eneheuvel,26-09-11
2010,12PM00,106,2,3,5,eneheuvel,26-09-11
2010,12PM00,107,14,14,28,eneheuvel,26-09-11
2010,12PM00,108,22,15,37,eneheuvel,26-09-11
2010,12PM00,109,4,8,12,eneheuvel,26-09-11
2010,12PM00,201,1,0,1,eneheuvel,26-09-11
2010,12PM00,207,0,1,1,eneheuvel,26-09-11
2010,12PM00,212,0,2,2,eneheuvel,26-09-11
2010,12PM00,214,1,0,1,eneheuvel,26-09-11
2010,12PM00,303,1,1,2,eneheuvel,26-09-11
2010,12PM00,311,1,1,2,eneheuvel,26-09-11
2010,12PM00,9999,1,1,2,eneheuvel,26-09-11
2010,12QK00,105,0,1,1,eneheuvel,26-09-11
2010,12QK00,202,1,0,1,eneheuvel,26-09-11
2010,12QK00,203,1,0,1,eneheuvel,26-09-11
2010,12QK00,206,91,102,193,eneheuvel,26-09-11
2010,12QK00,207,1,1,2,eneheuvel,26-09-11
2010,12QK00,208,2,1,3,eneheuvel,26-09-11
2010,12QK00,209,3,3,6,eneheuvel,26-09-11
2010,12QK00,210,9,9,18,eneheuvel,26-09-11
2010,12QK00,211,0,1,1,eneheuvel,26-09-11
2010,12QK00,214,2,1,3,eneheuvel,26-09-11
2010,12QK00,215,0,5,5,eneheuvel,26-09-11
2010,12QK00,302,0,1,1,eneheuvel,26-09-11
2010,12QK00,303,3,1,4,eneheuvel,26-09-11
2010,12QK00,306,2,0,2,eneheuvel,26-09-11
2010,12QK00,309,1,0,1,eneheuvel,26-09-11
2010,12QK00,312,0,1,1,eneheuvel,26-09-11
2010,12QK00,9999,2,0,2,eneheuvel,26-09-11
2010,12XA00,201,0,1,1,eneheuvel,26-09-11
2010,12XA00,206,0,1,1,eneheuvel,26-09-11
2010,12XA00,208,0,1,1,eneheuvel,26-09-11
2010,12XA00,211,37,47,84,eneheuvel,26-09-11
2010,12XA00,212,0,1,1,eneheuvel,26-09-11
2010,12XA00,213,0,1,1,eneheuvel,26-09-11
2010,12XA00,214,1,0,1,eneheuvel,26-09-11
2010,12XA00,303,1,1,2,eneheuvel,26-09-11
2010,13CW00,106,1,0,1,eneheuvel,26-09-11
2010,13CW00,201,0,1,1,eneheuvel,26-09-11
2010,13CW00,202,1,0,1,eneheuvel,26-09-11
2010,13CW00,203,0,1,1,eneheuvel,26-09-11
2010,13CW00,205,0,2,2,eneheuvel,26-09-11
2010,13CW00,206,58,63,121,eneheuvel,26-09-11
2010,13CW00,207,2,1,3,eneheuvel,26-09-11
2010,13CW00,208,0,2,2,eneheuvel,26-09-11
2010,13CW00,209,15,9,24,eneheuvel,26-09-11
2010,13CW00,210,10,5,15,eneheuvel,26-09-11
2010,13CW00,211,0,1,1,eneheuvel,26-09-11
2010,13CW00,212,2,0,2,eneheuvel,26-09-11
2010,13CW00,214,2,0,2,eneheuvel,26-09-11
2010,13CW00,215,0,3,3,eneheuvel,26-09-11
2010,13CW00,216,0,1,1,eneheuvel,26-09-11
2010,13CW00,308,0,4,4,eneheuvel,26-09-11
2010,13CW00,9999,3,1,4,eneheuvel,26-09-11
2010,13IF00,101,2,0,2,eneheuvel,26-09-11
2010,13IF00,201,0,2,2,eneheuvel,26-09-11
2010,13IF00,208,2,1,3,eneheuvel,26-09-11
2010,13IF00,210,1,0,1,eneheuvel,26-09-11
2010,13IF00,211,0,1,1,eneheuvel,26-09-11
2010,13IF00,214,0,2,2,eneheuvel,26-09-11
2010,13IF00,301,7,9,16,eneheuvel,26-09-11
2010,13IF00,302,3,3,6,eneheuvel,26-09-11
2010,13IF00,303,4,11,15,eneheuvel,26-09-11
2010,13IF00,304,32,37,69,eneheuvel,26-09-11
2010,13IF00,305,5,4,9,eneheuvel,26-09-11
2010,13IF00,306,8,9,17,eneheuvel,26-09-11
2010,13IF00,307,3,4,7,eneheuvel,26-09-11
2010,13IF00,308,2,2,4,eneheuvel,26-09-11
2010,13IF00,309,3,0,3,eneheuvel,26-09-11
2010,13IF00,311,0,1,1,eneheuvel,26-09-11
2010,13IF00,9999,0,2,2,eneheuvel,26-09-11
2010,13IU00,102,6,8,14,eneheuvel,26-09-11
2010,13IU00,103,9,5,14,eneheuvel,26-09-11
2010,13IU00,104,1,2,3,eneheuvel,26-09-11
2010,13IU00,105,3,3,6,eneheuvel,26-09-11
2010,13IU00,106,45,39,84,eneheuvel,26-09-11
2010,13IU00,107,7,4,11,eneheuvel,26-09-11
2010,13IU00,108,1,4,5,eneheuvel,26-09-11
2010,13IU00,109,2,2,4,eneheuvel,26-09-11
2010,13IU00,110,1,2,3,eneheuvel,26-09-11
2010,13IU00,202,1,0,1,eneheuvel,26-09-11
2010,13IU00,211,0,1,1,eneheuvel,26-09-11
2010,13IU00,212,0,2,2,eneheuvel,26-09-11
2010,13IU00,301,0,1,1,eneheuvel,26-09-11
2010,13IU00,311,1,0,1,eneheuvel,26-09-11
2010,13IU00,403,1,0,1,eneheuvel,26-09-11
2010,13IU00,9999,1,0,1,eneheuvel,26-09-11
2010,13NH00,101,1,3,4,eneheuvel,26-09-11
2010,13NH00,102,11,7,18,eneheuvel,26-09-11
2010,13NH00,103,1,3,4,eneheuvel,26-09-11
2010,13NH00,104,29,17,46,eneheuvel,26-09-11
2010,13NH00,105,67,56,123,eneheuvel,26-09-11
2010,13NH00,106,9,14,23,eneheuvel,26-09-11
2010,13NH00,107,2,2,4,eneheuvel,26-09-11
2010,13NH00,108,1,1,2,eneheuvel,26-09-11
2010,13NH00,109,1,0,1,eneheuvel,26-09-11
2010,13NH00,110,16,17,33,eneheuvel,26-09-11
2010,13NH00,208,2,1,3,eneheuvel,26-09-11
2010,13NH00,211,0,1,1,eneheuvel,26-09-11
2010,13NH00,212,1,0,1,eneheuvel,26-09-11
2010,13NH00,214,1,0,1,eneheuvel,26-09-11
2010,13NH00,304,1,0,1,eneheuvel,26-09-11
2010,13NH00,502,2,2,4,eneheuvel,26-09-11
2010,13NH00,9999,3,1,4,eneheuvel,26-09-11
2010,13NU00,204,1,0,1,eneheuvel,26-09-11
2010,13NU00,205,0,2,2,eneheuvel,26-09-11
2010,13NU00,211,2,2,4,eneheuvel,26-09-11
2010,13NU00,216,0,1,1,eneheuvel,26-09-11
2010,13NU00,301,12,7,19,eneheuvel,26-09-11
2010,13NU00,302,3,2,5,eneheuvel,26-09-11
2010,13NU00,303,24,32,56,eneheuvel,26-09-11
2010,13NU00,304,56,50,106,eneheuvel,26-09-11
2010,13NU00,305,18,10,28,eneheuvel,26-09-11
2010,13NU00,306,16,21,37,eneheuvel,26-09-11
2010,13NU00,307,1,1,2,eneheuvel,26-09-11
2010,13NU00,308,2,3,5,eneheuvel,26-09-11
2010,13NU00,309,1,1,2,eneheuvel,26-09-11
2010,13NU00,9999,1,0,1,eneheuvel,26-09-11
2010,14QC00,101,1,0,1,eneheuvel,26-09-11
2010,14QC00,108,1,0,1,eneheuvel,26-09-11
2010,14QC00,109,1,3,4,eneheuvel,26-09-11
2010,14QC00,110,3,0,3,eneheuvel,26-09-11
2010,14QC00,201,5,0,5,eneheuvel,26-09-11
2010,14QC00,202,55,44,99,eneheuvel,26-09-11
2010,14QC00,203,31,37,68,eneheuvel,26-09-11
2010,14QC00,204,23,21,44,eneheuvel,26-09-11
2010,14QC00,205,17,15,32,eneheuvel,26-09-11
2010,14QC00,206,36,9,45,eneheuvel,26-09-11
2010,14QC00,207,17,8,25,eneheuvel,26-09-11
2010,14QC00,208,28,19,47,eneheuvel,26-09-11
2010,14QC00,209,7,0,7,eneheuvel,26-09-11
2010,14QC00,210,8,5,13,eneheuvel,26-09-11
2010,14QC00,211,12,7,19,eneheuvel,26-09-11
2010,14QC00,212,2,4,6,eneheuvel,26-09-11
2010,14QC00,213,0,4,4,eneheuvel,26-09-11
2010,14QC00,214,2,1,3,eneheuvel,26-09-11
2010,14QC00,215,1,3,4,eneheuvel,26-09-11
2010,14QC00,216,1,2,3,eneheuvel,26-09-11
2010,14QC00,301,1,0,1,eneheuvel,26-09-11
2010,14QC00,302,4,4,8,eneheuvel,26-09-11
2010,14QC00,303,21,5,26,eneheuvel,26-09-11
2010,14QC00,304,0,2,2,eneheuvel,26-09-11
2010,14QC00,306,2,0,2,eneheuvel,26-09-11
2010,14QC00,307,4,2,6,eneheuvel,26-09-11
2010,14QC00,309,2,1,3,eneheuvel,26-09-11
2010,14QC00,311,9,6,15,eneheuvel,26-09-11
2010,14QC00,312,5,4,9,eneheuvel,26-09-11
2010,14QC00,313,0,1,1,eneheuvel,26-09-11
2010,14QC00,403,4,3,7,eneheuvel,26-09-11
2010,14QC00,502,14,10,24,eneheuvel,26-09-11
2010,14QC00,9999,5,1,6,eneheuvel,26-09-11
2010,14QC02,202,0,1,1,eneheuvel,26-09-11
2010,14QC02,209,1,1,2,eneheuvel,26-09-11
2010,14QC02,210,0,2,2,eneheuvel,26-09-11
2010,14QC02,211,2,0,2,eneheuvel,26-09-11
2010,14QC02,212,22,24,46,eneheuvel,26-09-11
2010,14QC02,213,4,5,9,eneheuvel,26-09-11
2010,14QC02,214,4,4,8,eneheuvel,26-09-11
2010,14QC02,216,0,2,2,eneheuvel,26-09-11
2010,14QC02,403,1,0,1,eneheuvel,26-09-11
2010,15SJ00,101,1,3,4,eneheuvel,26-09-11
2010,15SJ00,102,1,10,11,eneheuvel,26-09-11
2010,15SJ00,103,1,7,8,eneheuvel,26-09-11
2010,15SJ00,104,2,3,5,eneheuvel,26-09-11
2010,15SJ00,105,1,2,3,eneheuvel,26-09-11
2010,15SJ00,106,1,1,2,eneheuvel,26-09-11
2010,15SJ00,108,0,8,8,eneheuvel,26-09-11
2010,15SJ00,201,0,1,1,eneheuvel,26-09-11
2010,15SJ00,202,1,9,10,eneheuvel,26-09-11
2010,15SJ00,203,1,8,9,eneheuvel,26-09-11
2010,15SJ00,204,0,6,6,eneheuvel,26-09-11
2010,15SJ00,205,0,9,9,eneheuvel,26-09-11
2010,15SJ00,206,4,13,17,eneheuvel,26-09-11
2010,15SJ00,207,1,16,17,eneheuvel,26-09-11
2010,15SJ00,208,2,8,10,eneheuvel,26-09-11
2010,15SJ00,209,1,9,10,eneheuvel,26-09-11
2010,15SJ00,210,2,25,27,eneheuvel,26-09-11
2010,15SJ00,211,1,20,21,eneheuvel,26-09-11
2010,15SJ00,212,1,11,12,eneheuvel,26-09-11
2010,15SJ00,213,0,4,4,eneheuvel,26-09-11
2010,15SJ00,214,1,11,12,eneheuvel,26-09-11
2010,15SJ00,216,0,6,6,eneheuvel,26-09-11
2010,15SJ00,301,0,4,4,eneheuvel,26-09-11
2010,15SJ00,302,1,6,7,eneheuvel,26-09-11
2010,15SJ00,303,0,9,9,eneheuvel,26-09-11
2010,15SJ00,304,1,7,8,eneheuvel,26-09-11
2010,15SJ00,305,0,9,9,eneheuvel,26-09-11
2010,15SJ00,306,0,8,8,eneheuvel,26-09-11
2010,15SJ00,307,2,6,8,eneheuvel,26-09-11
2010,15SJ00,308,1,8,9,eneheuvel,26-09-11
2010,15SJ00,309,3,7,10,eneheuvel,26-09-11
2010,15SJ00,311,4,3,7,eneheuvel,26-09-11
2010,15SJ00,312,0,1,1,eneheuvel,26-09-11
2010,15SJ00,401,0,2,2,eneheuvel,26-09-11
2010,15SJ00,402,0,1,1,eneheuvel,26-09-11
2010,15SJ00,9999,1,7,8,eneheuvel,26-09-11
2010,15ZL00,305,2,1,3,eneheuvel,26-09-11
2010,15ZL01,206,1,1,2,eneheuvel,26-09-11
2010,15ZL01,207,0,1,1,eneheuvel,26-09-11
2010,15ZL01,209,7,9,16,eneheuvel,26-09-11
2010,15ZL01,210,77,63,140,eneheuvel,26-09-11
2010,15ZL01,211,1,0,1,eneheuvel,26-09-11
2010,15ZL01,212,1,1,2,eneheuvel,26-09-11
2010,15ZL01,215,1,1,2,eneheuvel,26-09-11
2010,15ZL01,216,1,1,2,eneheuvel,26-09-11
2010,15ZL01,307,0,1,1,eneheuvel,26-09-11
2010,15ZL01,309,0,1,1,eneheuvel,26-09-11
2010,15ZL01,9999,0,2,2,eneheuvel,26-09-11
2010,16CK00,103,1,0,1,eneheuvel,26-09-11
2010,16CK00,105,1,0,1,eneheuvel,26-09-11
2010,16CK00,106,1,0,1,eneheuvel,26-09-11
2010,16CK00,108,1,0,1,eneheuvel,26-09-11
2010,16CK00,202,2,0,2,eneheuvel,26-09-11
2010,16CK00,203,1,0,1,eneheuvel,26-09-11
2010,16CK00,204,4,0,4,eneheuvel,26-09-11
2010,16CK00,205,1,0,1,eneheuvel,26-09-11
2010,16CK00,206,6,0,6,eneheuvel,26-09-11
2010,16CK00,208,1,0,1,eneheuvel,26-09-11
2010,16CK00,209,1,0,1,eneheuvel,26-09-11
2010,16CK00,210,5,0,5,eneheuvel,26-09-11
2010,16CK00,211,4,0,4,eneheuvel,26-09-11
2010,16CK00,212,2,0,2,eneheuvel,26-09-11
2010,16CK00,213,2,0,2,eneheuvel,26-09-11
2010,16CK00,214,1,0,1,eneheuvel,26-09-11
2010,16CK00,216,1,0,1,eneheuvel,26-09-11
2010,16CK00,303,1,0,1,eneheuvel,26-09-11
2010,16CK00,305,1,0,1,eneheuvel,26-09-11
2010,16CK00,308,1,0,1,eneheuvel,26-09-11
2010,16CK00,309,3,0,3,eneheuvel,26-09-11
2010,16CK00,311,2,0,2,eneheuvel,26-09-11
2010,16CK00,312,3,0,3,eneheuvel,26-09-11
2010,16CK00,402,1,0,1,eneheuvel,26-09-11
2010,16CK00,9999,1,0,1,eneheuvel,26-09-11
2010,16KK00,101,14,12,26,eneheuvel,26-09-11
2010,16KK00,102,34,36,70,eneheuvel,26-09-11
2010,16KK00,103,63,52,115,eneheuvel,26-09-11
2010,16KK00,104,4,0,4,eneheuvel,26-09-11
2010,16KK00,105,1,2,3,eneheuvel,26-09-11
2010,16KK00,106,4,5,9,eneheuvel,26-09-11
2010,16KK00,107,7,11,18,eneheuvel,26-09-11
2010,16KK00,108,23,26,49,eneheuvel,26-09-11
2010,16KK00,109,10,12,22,eneheuvel,26-09-11
2010,16KK00,110,1,0,1,eneheuvel,26-09-11
2010,16KK00,201,0,1,1,eneheuvel,26-09-11
2010,16KK00,202,1,4,5,eneheuvel,26-09-11
2010,16KK00,206,2,1,3,eneheuvel,26-09-11
2010,16KK00,207,0,3,3,eneheuvel,26-09-11
2010,16KK00,208,0,1,1,eneheuvel,26-09-11
2010,16KK00,210,2,1,3,eneheuvel,26-09-11
2010,16KK00,211,1,3,4,eneheuvel,26-09-11
2010,16KK00,213,0,1,1,eneheuvel,26-09-11
2010,16KK00,214,0,1,1,eneheuvel,26-09-11
2010,16KK00,308,0,1,1,eneheuvel,26-09-11
2010,16KK00,309,0,1,1,eneheuvel,26-09-11
2010,16KK00,311,0,1,1,eneheuvel,26-09-11
2010,16KK00,502,1,1,2,eneheuvel,26-09-11
2010,16KK00,9999,2,3,5,eneheuvel,26-09-11
2010,16LJ00,101,3,3,6,eneheuvel,26-09-11
2010,16LJ00,102,7,7,14,eneheuvel,26-09-11
2010,16LJ00,103,2,0,2,eneheuvel,26-09-11
2010,16LJ00,104,2,1,3,eneheuvel,26-09-11
2010,16LJ00,105,0,1,1,eneheuvel,26-09-11
2010,16LJ00,106,42,49,91,eneheuvel,26-09-11
2010,16LJ00,107,1,1,2,eneheuvel,26-09-11
2010,16LJ00,108,2,2,4,eneheuvel,26-09-11
2010,16LJ00,203,1,2,3,eneheuvel,26-09-11
2010,16LJ00,208,0,1,1,eneheuvel,26-09-11
2010,16LJ00,209,0,1,1,eneheuvel,26-09-11
2010,16LJ00,212,1,1,2,eneheuvel,26-09-11
2010,16LJ00,312,1,1,2,eneheuvel,26-09-11
2010,16LJ00,9999,0,1,1,eneheuvel,26-09-11
2010,16ML00,101,5,5,10,eneheuvel,26-09-11
2010,16ML00,102,25,26,51,eneheuvel,26-09-11
2010,16ML00,103,5,6,11,eneheuvel,26-09-11
2010,16ML00,104,47,45,92,eneheuvel,26-09-11
2010,16ML00,105,25,24,49,eneheuvel,26-09-11
2010,16ML00,106,3,2,5,eneheuvel,26-09-11
2010,16ML00,107,3,4,7,eneheuvel,26-09-11
2010,16ML00,108,2,4,6,eneheuvel,26-09-11
2010,16ML00,109,0,3,3,eneheuvel,26-09-11
2010,16ML00,110,2,5,7,eneheuvel,26-09-11
2010,16ML00,201,0,1,1,eneheuvel,26-09-11
2010,16ML00,202,0,3,3,eneheuvel,26-09-11
2010,16ML00,203,0,2,2,eneheuvel,26-09-11
2010,16ML00,205,0,1,1,eneheuvel,26-09-11
2010,16ML00,206,1,1,2,eneheuvel,26-09-11
2010,16ML00,209,0,1,1,eneheuvel,26-09-11
2010,16ML00,210,0,1,1,eneheuvel,26-09-11
2010,16ML00,211,0,1,1,eneheuvel,26-09-11
2010,16ML00,212,0,3,3,eneheuvel,26-09-11
2010,16ML00,213,0,1,1,eneheuvel,26-09-11
2010,16ML00,303,0,1,1,eneheuvel,26-09-11
2010,16ML00,307,1,0,1,eneheuvel,26-09-11
2010,16ML00,311,1,0,1,eneheuvel,26-09-11
2010,16ML00,502,4,2,6,eneheuvel,26-09-11
2010,16ML00,9999,1,3,4,eneheuvel,26-09-11
2010,16OC00,101,2,3,5,eneheuvel,26-09-11
2010,16OC00,102,1,3,4,eneheuvel,26-09-11
2010,16OC00,103,9,12,21,eneheuvel,26-09-11
2010,16OC00,104,0,2,2,eneheuvel,26-09-11
2010,16OC00,105,1,2,3,eneheuvel,26-09-11
2010,16OC00,106,4,2,6,eneheuvel,26-09-11
2010,16OC00,107,65,71,136,eneheuvel,26-09-11
2010,16OC00,108,22,19,41,eneheuvel,26-09-11
2010,16OC00,109,40,56,96,eneheuvel,26-09-11
2010,16OC00,203,1,1,2,eneheuvel,26-09-11
2010,16OC00,207,1,0,1,eneheuvel,26-09-11
2010,16OC00,208,1,0,1,eneheuvel,26-09-11
2010,16OC00,213,0,2,2,eneheuvel,26-09-11
2010,16OC00,214,1,0,1,eneheuvel,26-09-11
2010,16OC00,309,1,1,2,eneheuvel,26-09-11
2010,16OC00,502,2,0,2,eneheuvel,26-09-11
2010,16OC00,9999,2,1,3,eneheuvel,26-09-11
2010,16UK00,101,1,0,1,eneheuvel,26-09-11
2010,16UK00,102,0,1,1,eneheuvel,26-09-11
2010,16UK00,103,4,5,9,eneheuvel,26-09-11
2010,16UK00,108,58,67,125,eneheuvel,26-09-11
2010,16UK00,109,0,1,1,eneheuvel,26-09-11
2010,16UK00,9999,1,4,5,eneheuvel,26-09-11
2010,16WV00,108,1,0,1,eneheuvel,26-09-11
2010,16WV00,201,6,2,8,eneheuvel,26-09-11
2010,16WV00,202,0,1,1,eneheuvel,26-09-11
2010,16WV00,204,1,1,2,eneheuvel,26-09-11
2010,16WV00,209,5,16,21,eneheuvel,26-09-11
2010,16WV00,211,60,49,109,eneheuvel,26-09-11
2010,16WV00,213,2,0,2,eneheuvel,26-09-11
2010,16WV00,214,2,1,3,eneheuvel,26-09-11
2010,16WV00,403,1,0,1,eneheuvel,26-09-11
2010,16WV00,9999,1,2,3,eneheuvel,26-09-11
2010,16YS00,108,2,0,2,eneheuvel,26-09-11
2010,16YS00,201,8,5,13,eneheuvel,26-09-11
2010,16YS00,202,1,2,3,eneheuvel,26-09-11
2010,16YS00,205,0,1,1,eneheuvel,26-09-11
2010,16YS00,207,3,1,4,eneheuvel,26-09-11
2010,16YS00,209,1,1,2,eneheuvel,26-09-11
2010,16YS00,210,1,0,1,eneheuvel,26-09-11
2010,16YS00,211,75,82,157,eneheuvel,26-09-11
2010,16YS00,212,1,3,4,eneheuvel,26-09-11
2010,16YS00,213,1,2,3,eneheuvel,26-09-11
2010,16YS00,303,1,0,1,eneheuvel,26-09-11
2010,16YS00,307,1,0,1,eneheuvel,26-09-11
2010,16YS00,309,1,1,2,eneheuvel,26-09-11
2010,16YS00,311,1,0,1,eneheuvel,26-09-11
2010,16ZG00,103,0,1,1,eneheuvel,26-09-11
2010,16ZG00,201,1,0,1,eneheuvel,26-09-11
2010,16ZG00,208,1,0,1,eneheuvel,26-09-11
2010,16ZG00,210,0,1,1,eneheuvel,26-09-11
2010,16ZG00,211,64,58,122,eneheuvel,26-09-11
2010,16ZG00,213,0,1,1,eneheuvel,26-09-11
2010,16ZG00,214,0,1,1,eneheuvel,26-09-11
2010,16ZG00,301,1,0,1,eneheuvel,26-09-11
2010,16ZG00,303,1,0,1,eneheuvel,26-09-11
2010,16ZG00,305,0,1,1,eneheuvel,26-09-11
2010,16ZX00,201,0,1,1,eneheuvel,26-09-11
2010,16ZX00,206,12,14,26,eneheuvel,26-09-11
2010,16ZX00,208,1,0,1,eneheuvel,26-09-11
2010,16ZX00,209,32,25,57,eneheuvel,26-09-11
2010,16ZX00,210,1,0,1,eneheuvel,26-09-11
2010,16ZX00,212,0,1,1,eneheuvel,26-09-11
2010,16ZX00,214,1,0,1,eneheuvel,26-09-11
2010,16ZX00,304,1,0,1,eneheuvel,26-09-11
2010,16ZX00,9999,1,2,3,eneheuvel,26-09-11
2010,17AK00,201,1,0,1,eneheuvel,26-09-11
2010,17AK00,205,0,1,1,eneheuvel,26-09-11
2010,17AK00,206,53,61,114,eneheuvel,26-09-11
2010,17AK00,207,1,2,3,eneheuvel,26-09-11
2010,17AK00,209,2,1,3,eneheuvel,26-09-11
2010,17AK00,210,4,4,8,eneheuvel,26-09-11
2010,17AK00,211,1,1,2,eneheuvel,26-09-11
2010,17AK00,303,1,0,1,eneheuvel,26-09-11
2010,17AK00,306,1,1,2,eneheuvel,26-09-11
2010,17AK00,307,0,2,2,eneheuvel,26-09-11
2010,17AK00,309,0,2,2,eneheuvel,26-09-11
2010,17AK00,312,2,0,2,eneheuvel,26-09-11
2010,17AV00,202,0,1,1,eneheuvel,26-09-11
2010,17AV00,205,3,1,4,eneheuvel,26-09-11
2010,17AV00,206,66,69,135,eneheuvel,26-09-11
2010,17AV00,207,2,0,2,eneheuvel,26-09-11
2010,17AV00,209,2,1,3,eneheuvel,26-09-11
2010,17AV00,210,0,1,1,eneheuvel,26-09-11
2010,17AV00,216,0,1,1,eneheuvel,26-09-11
2010,17AV00,307,0,1,1,eneheuvel,26-09-11
2010,17AV00,311,1,0,1,eneheuvel,26-09-11
2010,17AV00,312,1,0,1,eneheuvel,26-09-11
2010,17AV00,9999,0,3,3,eneheuvel,26-09-11
2010,17BP00,103,1,0,1,eneheuvel,26-09-11
2010,17BP00,201,2,0,2,eneheuvel,26-09-11
2010,17BP00,209,3,1,4,eneheuvel,26-09-11
2010,17BP00,210,1,2,3,eneheuvel,26-09-11
2010,17BP00,211,49,46,95,eneheuvel,26-09-11
2010,17BP00,212,4,5,9,eneheuvel,26-09-11
2010,17BP00,213,53,71,124,eneheuvel,26-09-11
2010,17BP00,214,0,3,3,eneheuvel,26-09-11
2010,17BP00,9999,0,1,1,eneheuvel,26-09-11
2010,17DA00,201,1,0,1,eneheuvel,26-09-11
2010,17DA00,207,0,1,1,eneheuvel,26-09-11
2010,17DA00,209,3,7,10,eneheuvel,26-09-11
2010,17DA00,210,40,53,93,eneheuvel,26-09-11
2010,17DA00,302,0,2,2,eneheuvel,26-09-11
2010,17DA00,303,0,2,2,eneheuvel,26-09-11
2010,17DA00,307,0,1,1,eneheuvel,26-09-11
2010,17DA00,402,0,1,1,eneheuvel,26-09-11
2010,17DA00,403,1,0,1,eneheuvel,26-09-11
2010,17DK00,202,1,1,2,eneheuvel,26-09-11
2010,17DK00,203,0,1,1,eneheuvel,26-09-11
2010,17DK00,206,1,2,3,eneheuvel,26-09-11
2010,17DK00,207,1,1,2,eneheuvel,26-09-11
2010,17DK00,208,3,1,4,eneheuvel,26-09-11
2010,17DK00,301,2,6,8,eneheuvel,26-09-11
2010,17DK00,302,1,2,3,eneheuvel,26-09-11
2010,17DK00,303,1,3,4,eneheuvel,26-09-11
2010,17DK00,304,44,46,90,eneheuvel,26-09-11
2010,17DK00,305,6,3,9,eneheuvel,26-09-11
2010,17DK00,306,1,3,4,eneheuvel,26-09-11
2010,17DK00,307,1,0,1,eneheuvel,26-09-11
2010,17DK00,308,2,1,3,eneheuvel,26-09-11
2010,17DK00,309,2,3,5,eneheuvel,26-09-11
2010,17DK00,9999,0,1,1,eneheuvel,26-09-11
2010,17DV00,101,1,0,1,eneheuvel,26-09-11
2010,17DV00,108,0,1,1,eneheuvel,26-09-11
2010,17DV00,201,4,0,4,eneheuvel,26-09-11
2010,17DV00,202,0,1,1,eneheuvel,26-09-11
2010,17DV00,203,2,1,3,eneheuvel,26-09-11
2010,17DV00,204,0,1,1,eneheuvel,26-09-11
2010,17DV00,205,1,1,2,eneheuvel,26-09-11
2010,17DV00,207,4,4,8,eneheuvel,26-09-11
2010,17DV00,208,2,0,2,eneheuvel,26-09-11
2010,17DV00,211,1,0,1,eneheuvel,26-09-11
2010,17DV00,216,1,1,2,eneheuvel,26-09-11
2010,17DV00,301,19,8,27,eneheuvel,26-09-11
2010,17DV00,302,5,7,12,eneheuvel,26-09-11
2010,17DV00,303,29,34,63,eneheuvel,26-09-11
2010,17DV00,304,31,43,74,eneheuvel,26-09-11
2010,17DV00,305,8,7,15,eneheuvel,26-09-11
2010,17DV00,306,11,8,19,eneheuvel,26-09-11
2010,17DV00,307,5,9,14,eneheuvel,26-09-11
2010,17DV00,308,14,9,23,eneheuvel,26-09-11
2010,17DV00,309,23,16,39,eneheuvel,26-09-11
2010,17DV00,310,0,2,2,eneheuvel,26-09-11
2010,17DV00,311,5,6,11,eneheuvel,26-09-11
2010,17DV00,312,4,1,5,eneheuvel,26-09-11
2010,17DV00,502,0,1,1,eneheuvel,26-09-11
2010,17DV00,9999,2,2,4,eneheuvel,26-09-11
2010,17FI00,101,0,1,1,eneheuvel,26-09-11
2010,17FI00,102,0,7,7,eneheuvel,26-09-11
2010,17FI00,103,1,1,2,eneheuvel,26-09-11
2010,17FI00,106,0,3,3,eneheuvel,26-09-11
2010,17FI00,108,0,7,7,eneheuvel,26-09-11
2010,17FI00,202,1,22,23,eneheuvel,26-09-11
2010,17FI00,203,1,6,7,eneheuvel,26-09-11
2010,17FI00,204,0,10,10,eneheuvel,26-09-11
2010,17FI00,205,0,3,3,eneheuvel,26-09-11
2010,17FI00,206,1,7,8,eneheuvel,26-09-11
2010,17FI00,207,0,5,5,eneheuvel,26-09-11
2010,17FI00,208,1,14,15,eneheuvel,26-09-11
2010,17FI00,209,1,4,5,eneheuvel,26-09-11
2010,17FI00,210,1,5,6,eneheuvel,26-09-11
2010,17FI00,211,5,9,14,eneheuvel,26-09-11
2010,17FI00,212,0,6,6,eneheuvel,26-09-11
2010,17FI00,213,2,5,7,eneheuvel,26-09-11
2010,17FI00,214,0,9,9,eneheuvel,26-09-11
2010,17FI00,216,1,2,3,eneheuvel,26-09-11
2010,17FI00,302,1,3,4,eneheuvel,26-09-11
2010,17FI00,303,1,5,6,eneheuvel,26-09-11
2010,17FI00,304,0,5,5,eneheuvel,26-09-11
2010,17FI00,305,0,5,5,eneheuvel,26-09-11
2010,17FI00,306,1,2,3,eneheuvel,26-09-11
2010,17FI00,307,0,7,7,eneheuvel,26-09-11
2010,17FI00,308,1,2,3,eneheuvel,26-09-11
2010,17FI00,309,1,3,4,eneheuvel,26-09-11
2010,17FI00,310,0,1,1,eneheuvel,26-09-11
2010,17FI00,311,1,4,5,eneheuvel,26-09-11
2010,17FI00,312,0,4,4,eneheuvel,26-09-11
2010,17FI00,402,0,1,1,eneheuvel,26-09-11
2010,17FI00,403,0,1,1,eneheuvel,26-09-11
2010,17FI00,502,0,1,1,eneheuvel,26-09-11
2010,17FI00,9999,0,7,7,eneheuvel,26-09-11
2010,17LP00,207,1,0,1,eneheuvel,26-09-11
2010,17LP00,210,1,0,1,eneheuvel,26-09-11
2010,17LP00,212,0,1,1,eneheuvel,26-09-11
2010,17LP00,301,0,1,1,eneheuvel,26-09-11
2010,17LP00,303,1,0,1,eneheuvel,26-09-11
2010,17LP00,304,1,0,1,eneheuvel,26-09-11
2010,17LP00,305,57,53,110,eneheuvel,26-09-11
2010,17LP00,306,8,4,12,eneheuvel,26-09-11
2010,17LP00,309,1,1,2,eneheuvel,26-09-11
2010,17LP00,310,0,1,1,eneheuvel,26-09-11
2010,17LP00,312,2,0,2,eneheuvel,26-09-11
2010,17MH00,202,1,2,3,eneheuvel,26-09-11
2010,17MH00,203,0,1,1,eneheuvel,26-09-11
2010,17MH00,205,0,1,1,eneheuvel,26-09-11
2010,17MH00,206,0,1,1,eneheuvel,26-09-11
2010,17MH00,207,0,2,2,eneheuvel,26-09-11
2010,17MH00,208,0,2,2,eneheuvel,26-09-11
2010,17MH00,209,2,0,2,eneheuvel,26-09-11
2010,17MH00,210,0,2,2,eneheuvel,26-09-11
2010,17MH00,211,0,2,2,eneheuvel,26-09-11
2010,17MH00,212,0,1,1,eneheuvel,26-09-11
2010,17MH00,216,0,1,1,eneheuvel,26-09-11
2010,17MH00,302,1,1,2,eneheuvel,26-09-11
2010,17MH00,303,1,2,3,eneheuvel,26-09-11
2010,17MH00,304,0,3,3,eneheuvel,26-09-11
2010,17MH00,305,86,107,193,eneheuvel,26-09-11
2010,17MH00,306,5,7,12,eneheuvel,26-09-11
2010,17MH00,307,1,4,5,eneheuvel,26-09-11
2010,17MH00,308,3,2,5,eneheuvel,26-09-11
2010,17MH00,309,5,5,10,eneheuvel,26-09-11
2010,17MH00,311,3,1,4,eneheuvel,26-09-11
2010,17MH00,312,0,1,1,eneheuvel,26-09-11
2010,17MH00,403,1,0,1,eneheuvel,26-09-11
2010,17MH00,9999,2,0,2,eneheuvel,26-09-11
2010,21KO00,108,1,0,1,eneheuvel,26-09-11
2010,21KO00,201,2,0,2,eneheuvel,26-09-11
2010,21KO00,202,0,1,1,eneheuvel,26-09-11
2010,21KO00,206,0,1,1,eneheuvel,26-09-11
2010,21KO00,209,8,6,14,eneheuvel,26-09-11
2010,21KO00,210,73,78,151,eneheuvel,26-09-11
2010,21KO00,211,2,3,5,eneheuvel,26-09-11
2010,21KO00,212,2,0,2,eneheuvel,26-09-11
2010,21KO00,216,0,3,3,eneheuvel,26-09-11
2010,21NC00,103,0,1,1,eneheuvel,26-09-11
2010,21NC00,211,5,3,8,eneheuvel,26-09-11
2010,21NC00,212,5,7,12,eneheuvel,26-09-11
2010,21NC00,213,54,54,108,eneheuvel,26-09-11
2010,21NC00,214,7,16,23,eneheuvel,26-09-11
2010,21NC00,216,0,1,1,eneheuvel,26-09-11
2010,21NC00,301,1,0,1,eneheuvel,26-09-11
2010,21NC00,401,0,1,1,eneheuvel,26-09-11
2010,21NC00,402,0,1,1,eneheuvel,26-09-11
2010,21NC00,9999,3,1,4,eneheuvel,26-09-11
2010,21ND00,102,0,1,1,eneheuvel,26-09-11
2010,21ND00,103,0,1,1,eneheuvel,26-09-11
2010,21ND00,202,1,0,1,eneheuvel,26-09-11
2010,21ND00,209,0,1,1,eneheuvel,26-09-11
2010,21ND00,211,14,15,29,eneheuvel,26-09-11
2010,21ND00,212,7,5,12,eneheuvel,26-09-11
2010,21ND00,213,60,83,143,eneheuvel,26-09-11
2010,21ND00,214,1,1,2,eneheuvel,26-09-11
2010,21ND00,402,1,0,1,eneheuvel,26-09-11
2010,22KP00,202,2,0,2,eneheuvel,26-09-11
2010,22KP00,203,0,1,1,eneheuvel,26-09-11
2010,22KP00,204,1,0,1,eneheuvel,26-09-11
2010,22KP00,205,0,1,1,eneheuvel,26-09-11
2010,22KP00,208,3,4,7,eneheuvel,26-09-11
2010,22KP00,210,1,1,2,eneheuvel,26-09-11
2010,22KP00,211,3,0,3,eneheuvel,26-09-11
2010,22KP00,212,0,1,1,eneheuvel,26-09-11
2010,22KP00,301,2,1,3,eneheuvel,26-09-11
2010,22KP00,302,6,7,13,eneheuvel,26-09-11
2010,22KP00,303,3,6,9,eneheuvel,26-09-11
2010,22KP00,304,1,3,4,eneheuvel,26-09-11
2010,22KP00,305,1,0,1,eneheuvel,26-09-11
2010,22KP00,306,0,2,2,eneheuvel,26-09-11
2010,22KP00,307,1,3,4,eneheuvel,26-09-11
2010,22KP00,308,2,12,14,eneheuvel,26-09-11
2010,22KP00,309,124,151,275,eneheuvel,26-09-11
2010,22KP00,310,9,3,12,eneheuvel,26-09-11
2010,22KP00,311,18,17,35,eneheuvel,26-09-11
2010,22KP00,312,0,6,6,eneheuvel,26-09-11
2010,22KP00,9999,1,1,2,eneheuvel,26-09-11
2010,22KQ00,201,2,2,4,eneheuvel,26-09-11
2010,22KQ00,205,1,1,2,eneheuvel,26-09-11
2010,22KQ00,208,2,0,2,eneheuvel,26-09-11
2010,22KQ00,209,2,2,4,eneheuvel,26-09-11
2010,22KQ00,210,48,76,124,eneheuvel,26-09-11
2010,22KQ00,211,1,2,3,eneheuvel,26-09-11
2010,22KQ00,212,1,2,3,eneheuvel,26-09-11
2010,22KQ00,307,0,1,1,eneheuvel,26-09-11
2010,22KQ00,9999,1,0,1,eneheuvel,26-09-11
2010,23ER00,201,1,0,1,eneheuvel,26-09-11
2010,23ER00,210,1,0,1,eneheuvel,26-09-11
2010,23ER00,212,52,74,126,eneheuvel,26-09-11
2010,23ER00,213,3,0,3,eneheuvel,26-09-11
2010,23ER00,214,0,1,1,eneheuvel,26-09-11
2010,23ER00,216,0,1,1,eneheuvel,26-09-11
2010,23ER00,303,0,2,2,eneheuvel,26-09-11
2010,23ER00,9999,1,1,2,eneheuvel,26-09-11
2010,23ET00,108,0,1,1,eneheuvel,26-09-11
2010,23ET00,201,1,1,2,eneheuvel,26-09-11
2010,23ET00,202,1,1,2,eneheuvel,26-09-11
2010,23ET00,203,0,1,1,eneheuvel,26-09-11
2010,23ET00,204,0,1,1,eneheuvel,26-09-11
2010,23ET00,207,0,1,1,eneheuvel,26-09-11
2010,23ET00,208,1,2,3,eneheuvel,26-09-11
2010,23ET00,210,0,1,1,eneheuvel,26-09-11
2010,23ET00,211,0,1,1,eneheuvel,26-09-11
2010,23ET00,214,0,1,1,eneheuvel,26-09-11
2010,23ET00,302,0,2,2,eneheuvel,26-09-11
2010,23ET00,305,1,0,1,eneheuvel,26-09-11
2010,23ET00,306,1,5,6,eneheuvel,26-09-11
2010,23ET00,307,3,6,9,eneheuvel,26-09-11
2010,23ET00,308,62,67,129,eneheuvel,26-09-11
2010,23ET00,309,1,10,11,eneheuvel,26-09-11
2010,23ET00,311,3,1,4,eneheuvel,26-09-11
2010,23ET00,312,1,6,7,eneheuvel,26-09-11
2010,23ET00,9999,0,1,1,eneheuvel,26-09-11
2010,23EU00,207,1,2,3,eneheuvel,26-09-11
2010,23EU00,301,0,1,1,eneheuvel,26-09-11
2010,23EU00,302,0,1,1,eneheuvel,26-09-11
2010,23EU00,303,1,3,4,eneheuvel,26-09-11
2010,23EU00,305,1,7,8,eneheuvel,26-09-11
2010,23EU00,306,72,107,179,eneheuvel,26-09-11
2010,23EU00,307,7,5,12,eneheuvel,26-09-11
2010,23EU00,309,1,0,1,eneheuvel,26-09-11
2010,23EU00,311,1,2,3,eneheuvel,26-09-11
2010,23EU00,313,0,1,1,eneheuvel,26-09-11
2010,23EU00,9999,0,1,1,eneheuvel,26-09-11
2010,23EV00,102,1,0,1,eneheuvel,26-09-11
2010,23EV00,110,1,1,2,eneheuvel,26-09-11
2010,23EV00,201,0,1,1,eneheuvel,26-09-11
2010,23EV00,203,0,1,1,eneheuvel,26-09-11
2010,23EV00,204,0,1,1,eneheuvel,26-09-11
2010,23EV00,206,0,2,2,eneheuvel,26-09-11
2010,23EV00,208,0,1,1,eneheuvel,26-09-11
2010,23EV00,210,11,8,19,eneheuvel,26-09-11
2010,23EV00,211,7,8,15,eneheuvel,26-09-11
2010,23EV00,212,74,105,179,eneheuvel,26-09-11
2010,23EV00,213,32,21,53,eneheuvel,26-09-11
2010,23EV00,214,4,4,8,eneheuvel,26-09-11
2010,23EV00,302,1,0,1,eneheuvel,26-09-11
2010,23EV00,312,0,1,1,eneheuvel,26-09-11
2010,23EV00,403,0,1,1,eneheuvel,26-09-11
2010,23EV00,9999,2,2,4,eneheuvel,26-09-11
2010,23EY00,103,1,0,1,eneheuvel,26-09-11
2010,23EY00,201,0,1,1,eneheuvel,26-09-11
2010,23EY00,202,1,0,1,eneheuvel,26-09-11
2010,23EY00,206,0,1,1,eneheuvel,26-09-11
2010,23EY00,208,1,1,2,eneheuvel,26-09-11
2010,23EY00,209,1,1,2,eneheuvel,26-09-11
2010,23EY00,210,11,11,22,eneheuvel,26-09-11
2010,23EY00,211,10,14,24,eneheuvel,26-09-11
2010,23EY00,212,115,112,227,eneheuvel,26-09-11
2010,23EY00,213,24,26,50,eneheuvel,26-09-11
2010,23EY00,214,4,3,7,eneheuvel,26-09-11
2010,23EY00,215,1,1,2,eneheuvel,26-09-11
2010,23EY00,216,0,2,2,eneheuvel,26-09-11
2010,23EY00,304,0,1,1,eneheuvel,26-09-11
2010,23EY00,311,1,0,1,eneheuvel,26-09-11
2010,23EY00,401,0,1,1,eneheuvel,26-09-11
2010,23EY00,9999,2,3,5,eneheuvel,26-09-11
2010,23ZU00,110,2,0,2,eneheuvel,26-09-11
2010,23ZU00,201,3,0,3,eneheuvel,26-09-11
2010,23ZU00,202,68,84,152,eneheuvel,26-09-11
2010,23ZU00,203,14,9,23,eneheuvel,26-09-11
2010,23ZU00,204,54,48,102,eneheuvel,26-09-11
2010,23ZU00,205,71,105,176,eneheuvel,26-09-11
2010,23ZU00,206,3,2,5,eneheuvel,26-09-11
2010,23ZU00,207,31,26,57,eneheuvel,26-09-11
2010,23ZU00,208,21,20,41,eneheuvel,26-09-11
2010,23ZU00,209,4,0,4,eneheuvel,26-09-11
2010,23ZU00,210,1,1,2,eneheuvel,26-09-11
2010,23ZU00,211,2,1,3,eneheuvel,26-09-11
2010,23ZU00,214,0,1,1,eneheuvel,26-09-11
2010,23ZU00,215,0,2,2,eneheuvel,26-09-11
2010,23ZU00,216,3,1,4,eneheuvel,26-09-11
2010,23ZU00,303,0,2,2,eneheuvel,26-09-11
2010,23ZU00,305,1,0,1,eneheuvel,26-09-11
2010,23ZU00,306,1,2,3,eneheuvel,26-09-11
2010,23ZU00,308,0,1,1,eneheuvel,26-09-11
2010,23ZU00,309,0,2,2,eneheuvel,26-09-11
2010,23ZU00,311,1,1,2,eneheuvel,26-09-11
2010,23ZU00,502,2,2,4,eneheuvel,26-09-11
2010,23ZU00,9999,3,0,3,eneheuvel,26-09-11
2010,23ZV00,107,0,1,1,eneheuvel,26-09-11
2010,23ZV00,201,2,2,4,eneheuvel,26-09-11
2010,23ZV00,202,23,37,60,eneheuvel,26-09-11
2010,23ZV00,203,5,4,9,eneheuvel,26-09-11
2010,23ZV00,204,18,28,46,eneheuvel,26-09-11
2010,23ZV00,205,26,47,73,eneheuvel,26-09-11
2010,23ZV00,207,10,10,20,eneheuvel,26-09-11
2010,23ZV00,208,2,10,12,eneheuvel,26-09-11
2010,23ZV00,210,1,3,4,eneheuvel,26-09-11
2010,23ZV00,211,3,1,4,eneheuvel,26-09-11
2010,23ZV00,212,1,2,3,eneheuvel,26-09-11
2010,23ZV00,302,1,0,1,eneheuvel,26-09-11
2010,23ZV00,308,1,1,2,eneheuvel,26-09-11
2010,23ZV00,309,1,0,1,eneheuvel,26-09-11
2010,23ZV00,311,1,0,1,eneheuvel,26-09-11
2010,23ZV00,312,1,2,3,eneheuvel,26-09-11
2010,23ZV00,9999,0,1,1,eneheuvel,26-09-11
2010,23ZW00,201,1,1,2,eneheuvel,26-09-11
2010,23ZW00,206,1,1,2,eneheuvel,26-09-11
2010,23ZW00,208,3,4,7,eneheuvel,26-09-11
2010,23ZW00,211,0,1,1,eneheuvel,26-09-11
2010,23ZW00,301,2,0,2,eneheuvel,26-09-11
2010,23ZW00,302,6,3,9,eneheuvel,26-09-11
2010,23ZW00,303,4,3,7,eneheuvel,26-09-11
2010,23ZW00,304,2,1,3,eneheuvel,26-09-11
2010,23ZW00,305,1,4,5,eneheuvel,26-09-11
2010,23ZW00,306,20,32,52,eneheuvel,26-09-11
2010,23ZW00,307,57,80,137,eneheuvel,26-09-11
2010,23ZW00,308,89,84,173,eneheuvel,26-09-11
2010,23ZW00,309,3,10,13,eneheuvel,26-09-11
2010,23ZW00,310,1,2,3,eneheuvel,26-09-11
2010,23ZW00,311,2,0,2,eneheuvel,26-09-11
2010,23ZW00,312,4,5,9,eneheuvel,26-09-11
2010,23ZW00,401,1,0,1,eneheuvel,26-09-11
2010,23ZW00,403,0,1,1,eneheuvel,26-09-11
2010,23ZW00,502,3,1,4,eneheuvel,26-09-11
2010,23ZW00,9999,1,3,4,eneheuvel,26-09-11
2010,23ZX00,104,0,1,1,eneheuvel,26-09-11
2010,23ZX00,201,11,4,15,eneheuvel,26-09-11
2010,23ZX00,202,99,136,235,eneheuvel,26-09-11
2010,23ZX00,203,6,3,9,eneheuvel,26-09-11
2010,23ZX00,204,2,6,8,eneheuvel,26-09-11
2010,23ZX00,205,4,9,13,eneheuvel,26-09-11
2010,23ZX00,207,4,8,12,eneheuvel,26-09-11
2010,23ZX00,208,5,8,13,eneheuvel,26-09-11
2010,23ZX00,209,2,2,4,eneheuvel,26-09-11
2010,23ZX00,210,0,1,1,eneheuvel,26-09-11
2010,23ZX00,211,3,2,5,eneheuvel,26-09-11
2010,23ZX00,308,1,0,1,eneheuvel,26-09-11
2010,23ZX00,311,0,1,1,eneheuvel,26-09-11
2010,23ZX00,9999,1,0,1,eneheuvel,26-09-11
2010,23ZY00,107,1,0,1,eneheuvel,26-09-11
2010,23ZY00,204,2,0,2,eneheuvel,26-09-11
2010,23ZY00,206,0,3,3,eneheuvel,26-09-11
2010,23ZY00,210,4,1,5,eneheuvel,26-09-11
2010,23ZY00,211,1,3,4,eneheuvel,26-09-11
2010,23ZY00,212,144,190,334,eneheuvel,26-09-11
2010,23ZY00,213,3,1,4,eneheuvel,26-09-11
2010,23ZY00,214,1,1,2,eneheuvel,26-09-11
2010,23ZY00,215,1,0,1,eneheuvel,26-09-11
2010,23ZY00,216,0,1,1,eneheuvel,26-09-11
2010,23ZY00,302,1,0,1,eneheuvel,26-09-11
2010,23ZY00,305,0,1,1,eneheuvel,26-09-11
2010,23ZY00,401,1,1,2,eneheuvel,26-09-11
2010,23ZY00,9999,4,1,5,eneheuvel,26-09-11
2010,24EJ00,102,3,1,4,eneheuvel,26-09-11
2010,24EJ00,106,0,1,1,eneheuvel,26-09-11
2010,24EJ00,108,3,1,4,eneheuvel,26-09-11
2010,24EJ00,202,4,4,8,eneheuvel,26-09-11
2010,24EJ00,203,2,0,2,eneheuvel,26-09-11
2010,24EJ00,204,4,4,8,eneheuvel,26-09-11
2010,24EJ00,206,2,1,3,eneheuvel,26-09-11
2010,24EJ00,207,2,1,3,eneheuvel,26-09-11
2010,24EJ00,208,1,2,3,eneheuvel,26-09-11
2010,24EJ00,209,18,6,24,eneheuvel,26-09-11
2010,24EJ00,210,17,19,36,eneheuvel,26-09-11
2010,24EJ00,211,38,36,74,eneheuvel,26-09-11
2010,24EJ00,212,7,7,14,eneheuvel,26-09-11
2010,24EJ00,213,4,5,9,eneheuvel,26-09-11
2010,24EJ00,214,5,0,5,eneheuvel,26-09-11
2010,24EJ00,305,3,0,3,eneheuvel,26-09-11
2010,24EJ00,308,1,0,1,eneheuvel,26-09-11
2010,24EJ00,309,1,3,4,eneheuvel,26-09-11
2010,24EJ00,9999,2,5,7,eneheuvel,26-09-11
2010,24FT00,102,1,6,7,eneheuvel,26-09-11
2010,24FT00,103,1,3,4,eneheuvel,26-09-11
2010,24FT00,104,1,0,1,eneheuvel,26-09-11
2010,24FT00,105,1,1,2,eneheuvel,26-09-11
2010,24FT00,106,0,2,2,eneheuvel,26-09-11
2010,24FT00,107,1,1,2,eneheuvel,26-09-11
2010,24FT00,108,0,2,2,eneheuvel,26-09-11
2010,24FT00,109,1,0,1,eneheuvel,26-09-11
2010,24FT00,202,0,2,2,eneheuvel,26-09-11
2010,24FT00,203,2,3,5,eneheuvel,26-09-11
2010,24FT00,204,0,2,2,eneheuvel,26-09-11
2010,24FT00,205,0,3,3,eneheuvel,26-09-11
2010,24FT00,206,0,3,3,eneheuvel,26-09-11
2010,24FT00,207,2,0,2,eneheuvel,26-09-11
2010,24FT00,208,2,7,9,eneheuvel,26-09-11
2010,24FT00,209,0,1,1,eneheuvel,26-09-11
2010,24FT00,210,5,6,11,eneheuvel,26-09-11
2010,24FT00,211,6,13,19,eneheuvel,26-09-11
2010,24FT00,212,2,19,21,eneheuvel,26-09-11
2010,24FT00,213,2,10,12,eneheuvel,26-09-11
2010,24FT00,214,2,18,20,eneheuvel,26-09-11
2010,24FT00,216,0,4,4,eneheuvel,26-09-11
2010,24FT00,301,1,1,2,eneheuvel,26-09-11
2010,24FT00,302,0,16,16,eneheuvel,26-09-11
2010,24FT00,303,2,21,23,eneheuvel,26-09-11
2010,24FT00,304,1,3,4,eneheuvel,26-09-11
2010,24FT00,305,0,4,4,eneheuvel,26-09-11
2010,24FT00,306,0,6,6,eneheuvel,26-09-11
2010,24FT00,307,0,10,10,eneheuvel,26-09-11
2010,24FT00,308,0,11,11,eneheuvel,26-09-11
2010,24FT00,309,0,7,7,eneheuvel,26-09-11
2010,24FT00,311,1,9,10,eneheuvel,26-09-11
2010,24FT00,312,2,16,18,eneheuvel,26-09-11
2010,24FT00,313,0,1,1,eneheuvel,26-09-11
2010,24FT00,401,0,1,1,eneheuvel,26-09-11
2010,24FT00,402,2,0,2,eneheuvel,26-09-11
2010,24FT00,403,0,1,1,eneheuvel,26-09-11
2010,24FT00,502,0,1,1,eneheuvel,26-09-11
2010,24MR00,101,1,1,2,eneheuvel,26-09-11
2010,24MR00,201,0,2,2,eneheuvel,26-09-11
2010,24MR00,208,2,0,2,eneheuvel,26-09-11
2010,24MR00,212,1,1,2,eneheuvel,26-09-11
2010,24MR00,216,0,1,1,eneheuvel,26-09-11
2010,24MR00,301,0,2,2,eneheuvel,26-09-11
2010,24MR00,302,1,0,1,eneheuvel,26-09-11
2010,24MR00,305,1,1,2,eneheuvel,26-09-11
2010,24MR00,306,10,18,28,eneheuvel,26-09-11
2010,24MR00,307,88,118,206,eneheuvel,26-09-11
2010,24MR00,308,6,7,13,eneheuvel,26-09-11
2010,24MR00,309,2,0,2,eneheuvel,26-09-11
2010,24MR00,311,2,1,3,eneheuvel,26-09-11
2010,24MR00,502,0,1,1,eneheuvel,26-09-11
2010,24MR00,9999,2,2,4,eneheuvel,26-09-11
2010,24RK00,201,0,1,1,eneheuvel,26-09-11
2010,24RK00,202,11,18,29,eneheuvel,26-09-11
2010,24RK00,203,10,10,20,eneheuvel,26-09-11
2010,24RK00,204,10,8,18,eneheuvel,26-09-11
2010,24RK00,205,5,6,11,eneheuvel,26-09-11
2010,24RK00,206,2,2,4,eneheuvel,26-09-11
2010,24RK00,207,3,5,8,eneheuvel,26-09-11
2010,24RK00,208,6,3,9,eneheuvel,26-09-11
2010,24RK00,211,2,0,2,eneheuvel,26-09-11
2010,24RK00,213,1,2,3,eneheuvel,26-09-11
2010,24RK00,214,2,1,3,eneheuvel,26-09-11
2010,24RK00,216,1,2,3,eneheuvel,26-09-11
2010,24RK00,301,2,1,3,eneheuvel,26-09-11
2010,24RK00,302,5,3,8,eneheuvel,26-09-11
2010,24RK00,303,1,4,5,eneheuvel,26-09-11
2010,24RK00,304,1,1,2,eneheuvel,26-09-11
2010,24RK00,305,1,1,2,eneheuvel,26-09-11
2010,24RK00,306,5,3,8,eneheuvel,26-09-11
2010,24RK00,307,5,5,10,eneheuvel,26-09-11
2010,24RK00,308,6,2,8,eneheuvel,26-09-11
2010,24RK00,309,1,3,4,eneheuvel,26-09-11
2010,24RK00,311,1,0,1,eneheuvel,26-09-11
2010,24RK00,312,2,0,2,eneheuvel,26-09-11
2010,24RK00,502,1,2,3,eneheuvel,26-09-11
2010,24UN00,201,0,1,1,eneheuvel,26-09-11
2010,24UN00,202,2,2,4,eneheuvel,26-09-11
2010,24UN00,302,0,1,1,eneheuvel,26-09-11
2010,24UN00,303,3,0,3,eneheuvel,26-09-11
2010,24UN00,305,0,1,1,eneheuvel,26-09-11
2010,24UN00,306,15,29,44,eneheuvel,26-09-11
2010,24UN00,307,35,45,80,eneheuvel,26-09-11
2010,24UN00,308,50,47,97,eneheuvel,26-09-11
2010,24UN00,309,11,14,25,eneheuvel,26-09-11
2010,24UN00,311,0,1,1,eneheuvel,26-09-11
2010,24UN00,313,0,1,1,eneheuvel,26-09-11
2010,24UN00,9999,1,1,2,eneheuvel,26-09-11
2010,25CF00,103,1,0,1,eneheuvel,26-09-11
2010,25CF00,201,1,1,2,eneheuvel,26-09-11
2010,25CF00,202,4,6,10,eneheuvel,26-09-11
2010,25CF00,203,1,7,8,eneheuvel,26-09-11
2010,25CF00,204,50,71,121,eneheuvel,26-09-11
2010,25CF00,205,11,29,40,eneheuvel,26-09-11
2010,25CF00,207,0,6,6,eneheuvel,26-09-11
2010,25CF00,208,1,0,1,eneheuvel,26-09-11
2010,25CF00,212,2,0,2,eneheuvel,26-09-11
2010,25CF00,307,1,2,3,eneheuvel,26-09-11
2010,25CF00,9999,2,2,4,eneheuvel,26-09-11
2010,25KT00,101,1,1,2,eneheuvel,26-09-11
2010,25KT00,105,1,0,1,eneheuvel,26-09-11
2010,25KT00,109,1,0,1,eneheuvel,26-09-11
2010,25KT00,202,35,42,77,eneheuvel,26-09-11
2010,25KT00,203,94,86,180,eneheuvel,26-09-11
2010,25KT00,204,61,76,137,eneheuvel,26-09-11
2010,25KT00,205,1,7,8,eneheuvel,26-09-11
2010,25KT00,207,17,8,25,eneheuvel,26-09-11
2010,25KT00,208,26,37,63,eneheuvel,26-09-11
2010,25KT00,210,0,1,1,eneheuvel,26-09-11
2010,25KT00,214,3,0,3,eneheuvel,26-09-11
2010,25KT00,302,0,1,1,eneheuvel,26-09-11
2010,25KT00,304,1,0,1,eneheuvel,26-09-11
2010,25KT00,306,1,1,2,eneheuvel,26-09-11
2010,25KT00,308,0,1,1,eneheuvel,26-09-11
2010,25KT00,309,0,2,2,eneheuvel,26-09-11
2010,25KT00,502,3,8,11,eneheuvel,26-09-11
2010,25KT00,9999,1,1,2,eneheuvel,26-09-11
2010,25KU00,110,0,3,3,eneheuvel,26-09-11
2010,25KU00,202,21,27,48,eneheuvel,26-09-11
2010,25KU00,203,71,54,125,eneheuvel,26-09-11
2010,25KU00,204,48,74,122,eneheuvel,26-09-11
2010,25KU00,205,1,4,5,eneheuvel,26-09-11
2010,25KU00,207,5,9,14,eneheuvel,26-09-11
2010,25KU00,208,23,24,47,eneheuvel,26-09-11
2010,25KU00,211,1,1,2,eneheuvel,26-09-11
2010,25KU00,212,0,2,2,eneheuvel,26-09-11
2010,25KU00,216,0,2,2,eneheuvel,26-09-11
2010,25KU00,309,0,1,1,eneheuvel,26-09-11
2010,25KU00,312,1,0,1,eneheuvel,26-09-11
2010,25KU00,313,0,1,1,eneheuvel,26-09-11
2010,25KU00,402,1,1,2,eneheuvel,26-09-11
2010,25KU00,403,0,1,1,eneheuvel,26-09-11
2010,25KU00,502,1,7,8,eneheuvel,26-09-11
2010,25KU00,9999,1,3,4,eneheuvel,26-09-11
2010,25KV00,104,0,1,1,eneheuvel,26-09-11
2010,25KV00,108,2,0,2,eneheuvel,26-09-11
2010,25KV00,201,0,1,1,eneheuvel,26-09-11
2010,25KV00,202,3,3,6,eneheuvel,26-09-11
2010,25KV00,203,129,187,316,eneheuvel,26-09-11
2010,25KV00,204,2,6,8,eneheuvel,26-09-11
2010,25KV00,205,0,2,2,eneheuvel,26-09-11
2010,25KV00,208,2,6,8,eneheuvel,26-09-11
2010,25KV00,209,0,1,1,eneheuvel,26-09-11
2010,25KV00,210,0,2,2,eneheuvel,26-09-11
2010,25KV00,211,0,1,1,eneheuvel,26-09-11
2010,25KV00,307,0,1,1,eneheuvel,26-09-11
2010,25KV00,312,1,1,2,eneheuvel,26-09-11
2010,25KV00,9999,0,1,1,eneheuvel,26-09-11
2010,26AB00,101,0,1,1,eneheuvel,26-09-11
2010,26AB00,201,0,2,2,eneheuvel,26-09-11
2010,26AB00,202,1,0,1,eneheuvel,26-09-11
2010,26AB00,205,1,0,1,eneheuvel,26-09-11
2010,26AB00,212,1,0,1,eneheuvel,26-09-11
2010,26AB00,215,0,1,1,eneheuvel,26-09-11
2010,26AB00,301,2,1,3,eneheuvel,26-09-11
2010,26AB00,302,18,23,41,eneheuvel,26-09-11
2010,26AB00,303,145,168,313,eneheuvel,26-09-11
2010,26AB00,304,1,6,7,eneheuvel,26-09-11
2010,26AB00,306,0,3,3,eneheuvel,26-09-11
2010,26AB00,308,1,0,1,eneheuvel,26-09-11
2010,26AB00,309,6,3,9,eneheuvel,26-09-11
2010,26AB00,310,3,0,3,eneheuvel,26-09-11
2010,26AB00,311,1,5,6,eneheuvel,26-09-11
2010,26AB00,312,0,4,4,eneheuvel,26-09-11
2010,26AB00,313,2,4,6,eneheuvel,26-09-11
2010,26AB00,9999,1,0,1,eneheuvel,26-09-11
2010,26AC00,107,0,3,3,eneheuvel,26-09-11
2010,26AC00,109,21,16,37,eneheuvel,26-09-11
2010,26AC00,202,0,1,1,eneheuvel,26-09-11
2010,26AC00,203,3,2,5,eneheuvel,26-09-11
2010,26AC00,204,2,0,2,eneheuvel,26-09-11
2010,26AC00,205,1,0,1,eneheuvel,26-09-11
2010,26AC00,207,0,2,2,eneheuvel,26-09-11
2010,26AC00,209,2,0,2,eneheuvel,26-09-11
2010,26AC00,210,1,3,4,eneheuvel,26-09-11
2010,26AC00,211,11,11,22,eneheuvel,26-09-11
2010,26AC00,212,5,10,15,eneheuvel,26-09-11
2010,26AC00,213,8,16,24,eneheuvel,26-09-11
2010,26AC00,214,392,428,820,eneheuvel,26-09-11
2010,26AC00,215,1,1,2,eneheuvel,26-09-11
2010,26AC00,301,0,1,1,eneheuvel,26-09-11
2010,26AC00,303,1,0,1,eneheuvel,26-09-11
2010,26AC00,308,1,0,1,eneheuvel,26-09-11
2010,26AC00,309,1,0,1,eneheuvel,26-09-11
2010,26AC00,311,0,1,1,eneheuvel,26-09-11
2010,26AC00,312,2,1,3,eneheuvel,26-09-11
2010,26AC00,402,0,3,3,eneheuvel,26-09-11
2010,26AC00,9999,1,1,2,eneheuvel,26-09-11
2010,26AD00,101,1,1,2,eneheuvel,26-09-11
2010,26AD00,201,2,0,2,eneheuvel,26-09-11
2010,26AD00,207,1,0,1,eneheuvel,26-09-11
2010,26AD00,208,2,1,3,eneheuvel,26-09-11
2010,26AD00,212,0,1,1,eneheuvel,26-09-11
2010,26AD00,214,1,1,2,eneheuvel,26-09-11
2010,26AD00,216,0,1,1,eneheuvel,26-09-11
2010,26AD00,301,4,0,4,eneheuvel,26-09-11
2010,26AD00,302,87,66,153,eneheuvel,26-09-11
2010,26AD00,303,37,28,65,eneheuvel,26-09-11
2010,26AD00,304,4,1,5,eneheuvel,26-09-11
2010,26AD00,305,3,3,6,eneheuvel,26-09-11
2010,26AD00,306,3,1,4,eneheuvel,26-09-11
2010,26AD00,307,2,2,4,eneheuvel,26-09-11
2010,26AD00,308,2,1,3,eneheuvel,26-09-11
2010,26AD00,309,53,58,111,eneheuvel,26-09-11
2010,26AD00,310,23,12,35,eneheuvel,26-09-11
2010,26AD00,311,36,35,71,eneheuvel,26-09-11
2010,26AD00,312,12,7,19,eneheuvel,26-09-11
2010,26AD00,313,6,4,10,eneheuvel,26-09-11
2010,26AD00,403,2,0,2,eneheuvel,26-09-11
2010,26AD00,502,0,1,1,eneheuvel,26-09-11
2010,26AD00,9999,1,1,2,eneheuvel,26-09-11
2010,26PD00,104,0,1,1,eneheuvel,26-09-11
2010,26PD00,108,1,0,1,eneheuvel,26-09-11
2010,26PD00,202,0,1,1,eneheuvel,26-09-11
2010,26PD00,205,5,4,9,eneheuvel,26-09-11
2010,26PD00,206,1,0,1,eneheuvel,26-09-11
2010,26PD00,207,106,118,224,eneheuvel,26-09-11
2010,26PD00,208,20,22,42,eneheuvel,26-09-11
2010,26PD00,211,0,1,1,eneheuvel,26-09-11
2010,26PD00,212,0,1,1,eneheuvel,26-09-11
2010,26PD00,216,0,1,1,eneheuvel,26-09-11
2010,26PD00,308,1,0,1,eneheuvel,26-09-11
2010,26PD00,311,1,0,1,eneheuvel,26-09-11
2010,26PD00,403,1,0,1,eneheuvel,26-09-11
2010,26PD00,502,1,2,3,eneheuvel,26-09-11
2010,26PD00,9999,3,5,8,eneheuvel,26-09-11
2010,26PE00,201,0,2,2,eneheuvel,26-09-11
2010,26PE00,202,2,0,2,eneheuvel,26-09-11
2010,26PE00,203,1,1,2,eneheuvel,26-09-11
2010,26PE00,204,1,0,1,eneheuvel,26-09-11
2010,26PE00,208,1,1,2,eneheuvel,26-09-11
2010,26PE00,301,3,1,4,eneheuvel,26-09-11
2010,26PE00,302,232,248,480,eneheuvel,26-09-11
2010,26PE00,303,30,15,45,eneheuvel,26-09-11
2010,26PE00,306,1,0,1,eneheuvel,26-09-11
2010,26PE00,307,2,0,2,eneheuvel,26-09-11
2010,26PE00,308,1,0,1,eneheuvel,26-09-11
2010,26PE00,309,1,2,3,eneheuvel,26-09-11
2010,26PE00,311,5,7,12,eneheuvel,26-09-11
2010,26PE00,312,6,5,11,eneheuvel,26-09-11
2010,26PE00,313,3,6,9,eneheuvel,26-09-11
2010,26PE00,9999,2,1,3,eneheuvel,26-09-11
2010,26PF00,103,1,0,1,eneheuvel,26-09-11
2010,26PF00,106,1,0,1,eneheuvel,26-09-11
2010,26PF00,107,0,1,1,eneheuvel,26-09-11
2010,26PF00,201,4,3,7,eneheuvel,26-09-11
2010,26PF00,202,3,0,3,eneheuvel,26-09-11
2010,26PF00,203,2,0,2,eneheuvel,26-09-11
2010,26PF00,206,0,3,3,eneheuvel,26-09-11
2010,26PF00,207,3,0,3,eneheuvel,26-09-11
2010,26PF00,208,1,0,1,eneheuvel,26-09-11
2010,26PF00,209,3,2,5,eneheuvel,26-09-11
2010,26PF00,210,1,1,2,eneheuvel,26-09-11
2010,26PF00,211,5,11,16,eneheuvel,26-09-11
2010,26PF00,212,16,6,22,eneheuvel,26-09-11
2010,26PF00,213,7,5,12,eneheuvel,26-09-11
2010,26PF00,214,159,203,362,eneheuvel,26-09-11
2010,26PF00,216,1,1,2,eneheuvel,26-09-11
2010,26PF00,302,2,2,4,eneheuvel,26-09-11
2010,26PF00,303,1,0,1,eneheuvel,26-09-11
2010,26PF00,307,1,0,1,eneheuvel,26-09-11
2010,26PF00,309,1,1,2,eneheuvel,26-09-11
2010,26PF00,311,2,0,2,eneheuvel,26-09-11
2010,26PF00,401,1,1,2,eneheuvel,26-09-11
2010,26PF00,402,1,0,1,eneheuvel,26-09-11
2010,26PF00,403,0,3,3,eneheuvel,26-09-11
2010,26PF00,9999,8,8,16,eneheuvel,26-09-11
2010,26PG00,207,2,0,2,eneheuvel,26-09-11
2010,26PG00,209,1,1,2,eneheuvel,26-09-11
2010,26PG00,210,1,1,2,eneheuvel,26-09-11
2010,26PG00,211,2,1,3,eneheuvel,26-09-11
2010,26PG00,212,1,1,2,eneheuvel,26-09-11
2010,26PG00,213,1,1,2,eneheuvel,26-09-11
2010,26PG00,214,52,60,112,eneheuvel,26-09-11
2010,26PG00,216,0,1,1,eneheuvel,26-09-11
2010,26PG00,9999,0,3,3,eneheuvel,26-09-11
2010,26PH00,102,1,1,2,eneheuvel,26-09-11
2010,26PH00,201,1,1,2,eneheuvel,26-09-11
2010,26PH00,202,1,1,2,eneheuvel,26-09-11
2010,26PH00,210,1,0,1,eneheuvel,26-09-11
2010,26PH00,211,1,0,1,eneheuvel,26-09-11
2010,26PH00,214,2,0,2,eneheuvel,26-09-11
2010,26PH00,216,1,2,3,eneheuvel,26-09-11
2010,26PH00,302,25,27,52,eneheuvel,26-09-11
2010,26PH00,303,5,10,15,eneheuvel,26-09-11
2010,26PH00,304,2,3,5,eneheuvel,26-09-11
2010,26PH00,305,1,2,3,eneheuvel,26-09-11
2010,26PH00,306,2,3,5,eneheuvel,26-09-11
2010,26PH00,307,0,2,2,eneheuvel,26-09-11
2010,26PH00,308,8,2,10,eneheuvel,26-09-11
2010,26PH00,309,39,38,77,eneheuvel,26-09-11
2010,26PH00,310,3,0,3,eneheuvel,26-09-11
2010,26PH00,311,207,215,422,eneheuvel,26-09-11
2010,26PH00,312,14,17,31,eneheuvel,26-09-11
2010,26PH00,313,5,5,10,eneheuvel,26-09-11
2010,26PH00,403,1,1,2,eneheuvel,26-09-11
2010,26PH00,9999,2,1,3,eneheuvel,26-09-11
2010,26PW00,108,0,1,1,eneheuvel,26-09-11
2010,26PW00,110,2,1,3,eneheuvel,26-09-11
2010,26PW00,207,1,0,1,eneheuvel,26-09-11
2010,26PW00,212,1,0,1,eneheuvel,26-09-11
2010,26PW00,302,21,30,51,eneheuvel,26-09-11
2010,26PW00,303,29,30,59,eneheuvel,26-09-11
2010,26PW00,308,2,1,3,eneheuvel,26-09-11
2010,26PW00,309,36,35,71,eneheuvel,26-09-11
2010,26PW00,310,10,7,17,eneheuvel,26-09-11
2010,26PW00,311,14,24,38,eneheuvel,26-09-11
2010,26PW00,312,2,6,8,eneheuvel,26-09-11
2010,26PW00,313,0,4,4,eneheuvel,26-09-11
2010,26PW00,9999,1,0,1,eneheuvel,26-09-11
2010,26ZZ00,103,1,0,1,eneheuvel,26-09-11
2010,26ZZ00,201,2,0,2,eneheuvel,26-09-11
2010,26ZZ00,202,184,214,398,eneheuvel,26-09-11
2010,26ZZ00,203,11,11,22,eneheuvel,26-09-11
2010,26ZZ00,204,3,2,5,eneheuvel,26-09-11
2010,26ZZ00,205,0,1,1,eneheuvel,26-09-11
2010,26ZZ00,207,0,1,1,eneheuvel,26-09-11
2010,26ZZ00,208,3,2,5,eneheuvel,26-09-11
2010,26ZZ00,210,1,1,2,eneheuvel,26-09-11
2010,26ZZ00,211,1,0,1,eneheuvel,26-09-11
2010,26ZZ00,214,0,1,1,eneheuvel,26-09-11
2010,26ZZ00,216,1,1,2,eneheuvel,26-09-11
2010,26ZZ00,302,1,0,1,eneheuvel,26-09-11
2010,26ZZ00,309,0,1,1,eneheuvel,26-09-11
2010,26ZZ00,313,1,1,2,eneheuvel,26-09-11
2010,26ZZ00,502,2,5,7,eneheuvel,26-09-11
2010,26ZZ00,9999,1,3,4,eneheuvel,26-09-11
2010,27AA00,102,1,0,1,eneheuvel,26-09-11
2010,27AA00,106,1,2,3,eneheuvel,26-09-11
2010,27AA00,201,1,1,2,eneheuvel,26-09-11
2010,27AA00,202,4,1,5,eneheuvel,26-09-11
2010,27AA00,203,6,8,14,eneheuvel,26-09-11
2010,27AA00,204,4,10,14,eneheuvel,26-09-11
2010,27AA00,205,2,2,4,eneheuvel,26-09-11
2010,27AA00,206,0,1,1,eneheuvel,26-09-11
2010,27AA00,207,97,66,163,eneheuvel,26-09-11
2010,27AA00,208,174,146,320,eneheuvel,26-09-11
2010,27AA00,210,1,0,1,eneheuvel,26-09-11
2010,27AA00,214,1,1,2,eneheuvel,26-09-11
2010,27AA00,216,1,0,1,eneheuvel,26-09-11
2010,27AA00,302,0,1,1,eneheuvel,26-09-11
2010,27AA00,303,3,2,5,eneheuvel,26-09-11
2010,27AA00,304,0,1,1,eneheuvel,26-09-11
2010,27AA00,306,1,1,2,eneheuvel,26-09-11
2010,27AA00,307,2,5,7,eneheuvel,26-09-11
2010,27AA00,308,2,2,4,eneheuvel,26-09-11
2010,27AA00,309,1,0,1,eneheuvel,26-09-11
2010,27AA00,312,1,0,1,eneheuvel,26-09-11
2010,27AA00,401,1,2,3,eneheuvel,26-09-11
2010,27AA00,502,2,0,2,eneheuvel,26-09-11
2010,27AA00,9999,0,1,1,eneheuvel,26-09-11
2010,27NU00,103,1,0,1,eneheuvel,26-09-11
2010,27NU00,104,1,0,1,eneheuvel,26-09-11
2010,27NU00,108,0,1,1,eneheuvel,26-09-11
2010,27NU00,201,0,1,1,eneheuvel,26-09-11
2010,27NU00,202,1,0,1,eneheuvel,26-09-11
2010,27NU00,203,5,8,13,eneheuvel,26-09-11
2010,27NU00,204,9,6,15,eneheuvel,26-09-11
2010,27NU00,205,2,1,3,eneheuvel,26-09-11
2010,27NU00,206,0,1,1,eneheuvel,26-09-11
2010,27NU00,207,39,23,62,eneheuvel,26-09-11
2010,27NU00,208,164,161,325,eneheuvel,26-09-11
2010,27NU00,210,1,1,2,eneheuvel,26-09-11
2010,27NU00,211,1,0,1,eneheuvel,26-09-11
2010,27NU00,301,1,1,2,eneheuvel,26-09-11
2010,27NU00,304,3,0,3,eneheuvel,26-09-11
2010,27NU00,305,1,0,1,eneheuvel,26-09-11
2010,27NU00,306,1,0,1,eneheuvel,26-09-11
2010,27NU00,502,1,2,3,eneheuvel,26-09-11
2010,27NU00,9999,2,1,3,eneheuvel,26-09-11
2010,27UB00,104,1,0,1,eneheuvel,26-09-11
2010,27UB00,105,0,1,1,eneheuvel,26-09-11
2010,27UB00,201,1,0,1,eneheuvel,26-09-11
2010,27UB00,202,2,3,5,eneheuvel,26-09-11
2010,27UB00,203,8,4,12,eneheuvel,26-09-11
2010,27UB00,204,2,1,3,eneheuvel,26-09-11
2010,27UB00,205,0,1,1,eneheuvel,26-09-11
2010,27UB00,207,11,9,20,eneheuvel,26-09-11
2010,27UB00,208,190,133,323,eneheuvel,26-09-11
2010,27UB00,209,1,0,1,eneheuvel,26-09-11
2010,27UB00,210,0,2,2,eneheuvel,26-09-11
2010,27UB00,212,1,0,1,eneheuvel,26-09-11
2010,27UB00,216,1,1,2,eneheuvel,26-09-11
2010,27UB00,302,0,1,1,eneheuvel,26-09-11
2010,27UB00,305,1,1,2,eneheuvel,26-09-11
2010,27UB00,306,0,1,1,eneheuvel,26-09-11
2010,27UB00,307,2,0,2,eneheuvel,26-09-11
2010,27UB00,308,1,1,2,eneheuvel,26-09-11
2010,27UB00,309,1,2,3,eneheuvel,26-09-11
2010,27UB00,311,1,1,2,eneheuvel,26-09-11
2010,27UB00,401,1,0,1,eneheuvel,26-09-11
2010,27UB00,502,4,2,6,eneheuvel,26-09-11
2010,27UB00,9999,2,0,2,eneheuvel,26-09-11
2010,27XH00,201,1,0,1,eneheuvel,26-09-11
2010,27XH00,202,0,1,1,eneheuvel,26-09-11
2010,27XH00,203,1,0,1,eneheuvel,26-09-11
2010,27XH00,209,3,2,5,eneheuvel,26-09-11
2010,27XH00,210,6,6,12,eneheuvel,26-09-11
2010,27XH00,212,0,2,2,eneheuvel,26-09-11
2010,27XH00,214,4,1,5,eneheuvel,26-09-11
2010,27XH00,215,14,18,32,eneheuvel,26-09-11
2010,27XH00,216,132,90,222,eneheuvel,26-09-11
2010,27XH00,304,1,1,2,eneheuvel,26-09-11
2010,27XH00,311,1,0,1,eneheuvel,26-09-11
2010,27XH00,403,0,1,1,eneheuvel,26-09-11
2010,27XJ00,201,0,1,1,eneheuvel,26-09-11
2010,27XJ00,204,1,1,2,eneheuvel,26-09-11
2010,27XJ00,207,1,0,1,eneheuvel,26-09-11
2010,27XJ00,211,0,2,2,eneheuvel,26-09-11
2010,27XJ00,213,0,1,1,eneheuvel,26-09-11
2010,27XJ00,302,19,8,27,eneheuvel,26-09-11
2010,27XJ00,303,4,5,9,eneheuvel,26-09-11
2010,27XJ00,306,3,1,4,eneheuvel,26-09-11
2010,27XJ00,307,0,1,1,eneheuvel,26-09-11
2010,27XJ00,308,2,0,2,eneheuvel,26-09-11
2010,27XJ00,309,7,2,9,eneheuvel,26-09-11
2010,27XJ00,311,28,16,44,eneheuvel,26-09-11
2010,27XJ00,312,177,95,272,eneheuvel,26-09-11
2010,27XJ00,313,49,17,66,eneheuvel,26-09-11
2010,27XJ00,9999,2,1,3,eneheuvel,26-09-11
2010,27YN00,109,2,2,4,eneheuvel,26-09-11
2010,27YN00,110,0,3,3,eneheuvel,26-09-11
2010,27YN00,201,1,1,2,eneheuvel,26-09-11
2010,27YN00,202,1,1,2,eneheuvel,26-09-11
2010,27YN00,203,0,1,1,eneheuvel,26-09-11
2010,27YN00,204,0,1,1,eneheuvel,26-09-11
2010,27YN00,206,1,0,1,eneheuvel,26-09-11
2010,27YN00,207,0,1,1,eneheuvel,26-09-11
2010,27YN00,208,2,1,3,eneheuvel,26-09-11
2010,27YN00,210,13,13,26,eneheuvel,26-09-11
2010,27YN00,211,2,4,6,eneheuvel,26-09-11
2010,27YN00,212,7,5,12,eneheuvel,26-09-11
2010,27YN00,213,2,0,2,eneheuvel,26-09-11
2010,27YN00,214,3,0,3,eneheuvel,26-09-11
2010,27YN00,215,6,5,11,eneheuvel,26-09-11
2010,27YN00,216,155,99,254,eneheuvel,26-09-11
2010,27YN00,302,1,2,3,eneheuvel,26-09-11
2010,27YN00,303,1,2,3,eneheuvel,26-09-11
2010,27YN00,305,0,1,1,eneheuvel,26-09-11
2010,27YN00,308,0,1,1,eneheuvel,26-09-11
2010,27YN00,311,1,0,1,eneheuvel,26-09-11
2010,27YN00,312,1,0,1,eneheuvel,26-09-11
2010,27YN00,403,0,2,2,eneheuvel,26-09-11
2010,27YN00,9999,2,1,3,eneheuvel,26-09-11
2010,28AM00,102,1,1,2,eneheuvel,26-09-11
2010,28AM00,207,2,1,3,eneheuvel,26-09-11
2010,28AM00,208,1,1,2,eneheuvel,26-09-11
2010,28AM00,211,1,1,2,eneheuvel,26-09-11
2010,28AM00,214,0,1,1,eneheuvel,26-09-11
2010,28AM00,302,8,2,10,eneheuvel,26-09-11
2010,28AM00,305,1,0,1,eneheuvel,26-09-11
2010,28AM00,307,1,0,1,eneheuvel,26-09-11
2010,28AM00,309,5,2,7,eneheuvel,26-09-11
2010,28AM00,310,1,0,1,eneheuvel,26-09-11
2010,28AM00,311,34,8,42,eneheuvel,26-09-11
2010,28AM00,312,191,152,343,eneheuvel,26-09-11
2010,28AM00,313,8,5,13,eneheuvel,26-09-11
2010,28DJ00,106,2,1,3,eneheuvel,26-09-11
2010,28DJ00,107,3,2,5,eneheuvel,26-09-11
2010,28DJ00,108,1,0,1,eneheuvel,26-09-11
2010,28DJ00,201,1,0,1,eneheuvel,26-09-11
2010,28DJ00,202,3,0,3,eneheuvel,26-09-11
2010,28DJ00,203,2,5,7,eneheuvel,26-09-11
2010,28DJ00,204,0,1,1,eneheuvel,26-09-11
2010,28DJ00,205,5,3,8,eneheuvel,26-09-11
2010,28DJ00,206,2,2,4,eneheuvel,26-09-11
2010,28DJ00,207,11,8,19,eneheuvel,26-09-11
2010,28DJ00,208,9,10,19,eneheuvel,26-09-11
2010,28DJ00,209,1,0,1,eneheuvel,26-09-11
2010,28DJ00,210,1,1,2,eneheuvel,26-09-11
2010,28DJ00,211,4,3,7,eneheuvel,26-09-11
2010,28DJ00,212,1,2,3,eneheuvel,26-09-11
2010,28DJ00,213,3,2,5,eneheuvel,26-09-11
2010,28DJ00,214,1,1,2,eneheuvel,26-09-11
2010,28DJ00,215,0,1,1,eneheuvel,26-09-11
2010,28DJ00,216,3,0,3,eneheuvel,26-09-11
2010,28DJ00,302,9,2,11,eneheuvel,26-09-11
2010,28DJ00,303,1,3,4,eneheuvel,26-09-11
2010,28DJ00,304,2,0,2,eneheuvel,26-09-11
2010,28DJ00,305,2,4,6,eneheuvel,26-09-11
2010,28DJ00,306,4,3,7,eneheuvel,26-09-11
2010,28DJ00,307,1,6,7,eneheuvel,26-09-11
2010,28DJ00,308,3,3,6,eneheuvel,26-09-11
2010,28DJ00,309,3,0,3,eneheuvel,26-09-11
2010,28DJ00,311,1,0,1,eneheuvel,26-09-11
2010,28DJ00,312,1,0,1,eneheuvel,26-09-11
2010,29UB00,108,1,0,1,eneheuvel,26-09-11
2010,29UB00,109,1,0,1,eneheuvel,26-09-11
2010,29UB00,202,1,0,1,eneheuvel,26-09-11
2010,29UB00,203,1,0,1,eneheuvel,26-09-11
2010,29UB00,207,0,1,1,eneheuvel,26-09-11
2010,29UB00,208,3,2,5,eneheuvel,26-09-11
2010,29UB00,210,1,3,4,eneheuvel,26-09-11
2010,29UB00,211,0,1,1,eneheuvel,26-09-11
2010,29UB00,212,4,12,16,eneheuvel,26-09-11
2010,29UB00,213,1,1,2,eneheuvel,26-09-11
2010,29UB00,214,22,30,52,eneheuvel,26-09-11
2010,29UB00,216,2,1,3,eneheuvel,26-09-11
2010,29UB00,306,1,0,1,eneheuvel,26-09-11
2010,29UB00,307,1,1,2,eneheuvel,26-09-11
2010,29UB00,401,11,12,23,eneheuvel,26-09-11
2010,29UB00,402,56,32,88,eneheuvel,26-09-11
2010,29UB00,403,38,24,62,eneheuvel,26-09-11
2010,29UB00,9999,3,1,4,eneheuvel,26-09-11
2010,29UN00,207,1,3,4,eneheuvel,26-09-11
2010,29UN00,209,1,0,1,eneheuvel,26-09-11
2010,29UN00,301,2,0,2,eneheuvel,26-09-11
2010,29UN00,302,3,1,4,eneheuvel,26-09-11
2010,29UN00,303,1,0,1,eneheuvel,26-09-11
2010,29UN00,304,5,1,6,eneheuvel,26-09-11
2010,29UN00,305,11,9,20,eneheuvel,26-09-11
2010,29UN00,306,6,6,12,eneheuvel,26-09-11
2010,29UN00,307,2,1,3,eneheuvel,26-09-11
2010,29UN00,308,2,1,3,eneheuvel,26-09-11
2010,29UN00,309,4,1,5,eneheuvel,26-09-11
2010,29UN00,310,1,0,1,eneheuvel,26-09-11
2010,29UN00,311,3,2,5,eneheuvel,26-09-11
2010,29UN00,312,1,2,3,eneheuvel,26-09-11
2010,29XC00,107,4,4,8,eneheuvel,26-09-11
2010,29XC00,202,0,1,1,eneheuvel,26-09-11
2010,29XC00,208,1,1,2,eneheuvel,26-09-11
2010,29XC00,213,0,2,2,eneheuvel,26-09-11
2010,29XC00,307,0,2,2,eneheuvel,26-09-11
2010,29XC00,401,2,1,3,eneheuvel,26-09-11
2010,29XC00,402,2,3,5,eneheuvel,26-09-11
2010,29XC00,403,1,1,2,eneheuvel,26-09-11
2010,29XT00,202,1,0,1,eneheuvel,26-09-11
2010,29XT00,203,2,1,3,eneheuvel,26-09-11
2010,29XT00,208,0,1,1,eneheuvel,26-09-11
2010,29XT00,211,1,0,1,eneheuvel,26-09-11
2010,29XT00,212,0,1,1,eneheuvel,26-09-11
2010,29XT00,214,9,3,12,eneheuvel,26-09-11
2010,29XT00,302,1,1,2,eneheuvel,26-09-11
2010,29XT00,304,2,2,4,eneheuvel,26-09-11
2010,29XT00,307,1,0,1,eneheuvel,26-09-11
2010,29XT00,311,2,0,2,eneheuvel,26-09-11
2010,29XT00,313,2,0,2,eneheuvel,26-09-11
2010,29XT00,401,23,10,33,eneheuvel,26-09-11
2010,29XT00,402,5,8,13,eneheuvel,26-09-11
2010,29XT00,403,10,2,12,eneheuvel,26-09-11
2010,29XT00,9999,3,1,4,eneheuvel,26-09-11
2010,29XU00,105,0,1,1,eneheuvel,26-09-11
2010,29XU00,204,1,0,1,eneheuvel,26-09-11
2010,29XU00,206,0,1,1,eneheuvel,26-09-11
2010,29XU00,211,0,1,1,eneheuvel,26-09-11
2010,29XU00,214,1,0,1,eneheuvel,26-09-11
2010,29XU00,302,1,1,2,eneheuvel,26-09-11
2010,29XU00,303,2,0,2,eneheuvel,26-09-11
2010,29XU00,401,18,8,26,eneheuvel,26-09-11
2010,29XU00,402,4,3,7,eneheuvel,26-09-11
2010,29XU00,403,2,3,5,eneheuvel,26-09-11
2010,29XU00,9999,1,2,3,eneheuvel,26-09-11
2010,29XX00,103,1,0,1,eneheuvel,26-09-11
2010,29XX00,109,2,0,2,eneheuvel,26-09-11
2010,29XX00,202,1,1,2,eneheuvel,26-09-11
2010,29XX00,203,0,3,3,eneheuvel,26-09-11
2010,29XX00,204,2,0,2,eneheuvel,26-09-11
2010,29XX00,205,0,1,1,eneheuvel,26-09-11
2010,29XX00,207,2,3,5,eneheuvel,26-09-11
2010,29XX00,208,3,7,10,eneheuvel,26-09-11
2010,29XX00,209,2,2,4,eneheuvel,26-09-11
2010,29XX00,210,1,2,3,eneheuvel,26-09-11
2010,29XX00,211,1,1,2,eneheuvel,26-09-11
2010,29XX00,212,4,5,9,eneheuvel,26-09-11
2010,29XX00,213,1,1,2,eneheuvel,26-09-11
2010,29XX00,214,7,10,17,eneheuvel,26-09-11
2010,29XX00,216,0,2,2,eneheuvel,26-09-11
2010,29XX00,302,4,3,7,eneheuvel,26-09-11
2010,29XX00,303,1,2,3,eneheuvel,26-09-11
2010,29XX00,305,2,0,2,eneheuvel,26-09-11
2010,29XX00,306,1,0,1,eneheuvel,26-09-11
2010,29XX00,307,1,1,2,eneheuvel,26-09-11
2010,29XX00,309,1,0,1,eneheuvel,26-09-11
2010,29XX00,311,4,2,6,eneheuvel,26-09-11
2010,29XX00,312,2,2,4,eneheuvel,26-09-11
2010,29XX00,313,1,2,3,eneheuvel,26-09-11
2010,29XX00,502,0,2,2,eneheuvel,26-09-11
2010,29XX00,9999,0,2,2,eneheuvel,26-09-11
2010,30AJ00,109,1,0,1,eneheuvel,26-09-11
2010,30AJ00,202,2,1,3,eneheuvel,26-09-11
2010,30AJ00,203,0,1,1,eneheuvel,26-09-11
2010,30AJ00,207,2,5,7,eneheuvel,26-09-11
2010,30AJ00,208,5,1,6,eneheuvel,26-09-11
2010,30AJ00,211,0,1,1,eneheuvel,26-09-11
2010,30AJ00,212,1,0,1,eneheuvel,26-09-11
2010,30AJ00,213,0,1,1,eneheuvel,26-09-11
2010,30AJ00,214,3,3,6,eneheuvel,26-09-11
2010,30AJ00,215,0,2,2,eneheuvel,26-09-11
2010,30AJ00,216,1,1,2,eneheuvel,26-09-11
2010,30AJ00,304,0,1,1,eneheuvel,26-09-11
2010,30AJ00,305,0,1,1,eneheuvel,26-09-11
2010,30AJ00,308,1,0,1,eneheuvel,26-09-11
2010,30AJ00,311,0,2,2,eneheuvel,26-09-11
2010,30AJ00,312,0,1,1,eneheuvel,26-09-11
2010,30AJ00,401,2,1,3,eneheuvel,26-09-11
2010,30AJ00,402,33,25,58,eneheuvel,26-09-11
2010,30AJ00,403,13,19,32,eneheuvel,26-09-11
2010,30AJ00,502,1,0,1,eneheuvel,26-09-11
2010,30AJ00,9999,2,2,4,eneheuvel,26-09-11
